uid,step,sample_idx,prompt,response,prompt_length,response_length,total_length,sequence_score,sequence_reward
d8ed4b7a-895b-4b0a-a294-799965d3c027,7,0,"[151643, 151643, 151643, 151643, 151643, 151643, 151643, 151643, 151643, 151643, 151643, 151643, 151643, 151643, 151643, 151643, 151643, 151643, 151643, 151643, 151643, 151643, 151643, 151643, 151643, 151643, 151643, 151643, 151643, 151643, 151643, 151643, 151643, 151643, 151643, 151643, 151643, 151643, 151643, 151643, 151643, 151643, 151643, 151643, 151643, 151643, 151643, 151643, 151643, 151643, 151643, 151643, 151643, 151643, 151643, 151643, 151643, 151643, 151643, 151643, 151643, 151643, 151643, 151643, 151643, 151643, 151643, 151643, 151643, 151643, 151643, 151643, 151643, 151643, 151643, 151643, 151643, 151643, 151643, 151643, 151643, 151643, 151643, 151643, 151643, 151643, 151643, 151643, 151643, 151643, 151643, 151643, 151643, 151643, 151643, 151643, 151643, 151643, 151643, 151643, 151643, 151643, 151643, 151643, 151643, 151643, 151643, 151643, 151643, 151643, 151643, 151643, 151643, 151643, 151643, 151643, 151643, 151643, 151643, 151643, 151643, 151643, 151643, 151643, 151643, 151643, 151643, 151643, 151643, 151643, 151643, 151643, 151643, 151643, 151643, 151643, 151643, 151643, 151643, 151643, 151643, 151643, 151643, 151643, 151643, 151643, 151643, 151643, 151643, 151643, 151643, 151643, 151643, 151643, 151643, 151643, 151643, 151643, 151643, 151643, 151643, 151643, 151643, 151643, 151643, 151643, 151643, 151643, 151643, 151643, 151643, 151643, 151643, 151643, 151643, 151643, 151643, 151643, 151643, 151643, 151643, 151643, 151643, 151643, 151643, 151643, 151643, 151643, 151643, 151643, 151643, 151643, 151643, 151643, 151643, 151643, 151643, 151643, 151643, 151643, 151643, 151643, 151643, 151643, 151643, 151643, 151643, 151643, 151643, 151643, 151643, 151643, 151643, 151643, 151643, 151643, 151643, 151643, 151643, 151643, 151643, 151643, 151643, 151643, 151643, 151643, 151643, 151643, 151643, 151643, 151643, 151643, 151643, 151643, 151643, 151643, 151643, 151643, 151643, 151643, 151643, 151643, 151643, 151643, 151643, 151643, 151643, 151643, 151643, 151643, 151643, 151643, 151643, 151643, 151643, 151643, 151643, 151643, 151643, 151643, 151643, 151643, 151643, 151643, 151643, 151643, 151643, 151643, 151643, 151643, 151643, 151643, 151643, 151643, 151643, 151643, 151643, 151643, 151643, 151643, 151643, 151643, 151643, 151643, 151643, 151643, 151643, 151643, 151643, 151643, 151643, 151643, 151643, 151643, 151643, 151643, 151643, 151643, 151643, 151643, 151643, 151643, 151643, 151643, 151643, 151643, 151643, 151643, 151643, 151643, 151643, 151643, 151643, 151643, 151643, 151643, 151643, 151643, 151643, 151643, 151643, 151643, 151643, 151643, 151643, 151643, 151643, 151643, 151643, 151643, 151643, 151643, 151643, 151643, 151643, 151643, 151643, 151643, 151643, 151643, 151643, 151643, 151643, 151643, 151643, 151643, 151643, 151643, 151643, 151643, 151643, 151643, 151643, 151643, 151643, 151643, 151643, 151643, 151643, 151643, 151643, 151643, 151643, 151643, 151643, 151643, 151643, 151643, 151643, 151643, 151643, 151643, 151643, 151643, 151643, 151643, 151643, 151643, 151643, 151643, 151643, 151643, 151643, 151643, 151643, 151643, 151643, 151643, 151643, 151643, 151643, 151643, 151643, 151643, 151643, 151643, 151643, 151643, 151643, 151643, 151643, 151643, 151643, 151643, 151643, 151643, 151643, 151643, 151643, 151643, 151643, 151643, 151643, 151643, 151643, 151643, 151643, 151643, 151643, 151643, 151643, 151643, 151643, 151643, 151643, 151643, 151643, 151643, 151643, 151643, 151643, 151643, 151643, 151643, 151643, 151643, 151643, 151643, 151643, 151643, 151643, 151643, 151643, 151643, 151643, 151643, 151643, 151643, 151643, 151643, 151643, 151643, 151643, 151643, 151643, 151643, 151643, 151643, 151643, 151643, 151643, 151643, 151643, 151643, 151643, 151643, 151643, 151643, 151643, 151643, 151643, 151643, 151643, 151643, 151643, 151643, 151643, 151643, 151643, 151643, 151643, 151643, 151643, 151644, 8948, 198, 2610, 525, 1207, 16948, 11, 3465, 553, 54364, 14817, 13, 1446, 525, 264, 10950, 17847, 13, 151645, 198, 151644, 872, 198, 16141, 279, 2701, 5248, 5754, 3405, 13, 576, 1537, 1555, 315, 697, 2033, 1265, 387, 315, 279, 2701, 3561, 25, 364, 16141, 25, 400, 20756, 4198, 6, 320, 28996, 17194, 8, 1380, 44428, 374, 825, 315, 19360, 35, 13, 21149, 3019, 553, 3019, 1573, 35764, 382, 23085, 315, 279, 2701, 9759, 646, 387, 16507, 448, 2176, 279, 18117, 7817, 46, 65325, 4439, 518, 279, 4270, 48821, 57874, 323, 279, 33411, 7012, 65325, 4439, 518, 279, 6569, 377, 57874, 30, 5209, 8300, 311, 279, 7746, 3685, 369, 803, 1995, 911, 279, 9282, 37170, 13, 1084, 1265, 387, 10342, 429, 448, 18117, 7817, 46, 11, 9759, 448, 9981, 647, 8455, 20590, 52557, 1091, 220, 16, 22, 4878, 646, 387, 13166, 11, 1393, 448, 33411, 7012, 11, 9759, 52557, 1091, 220, 16, 21, 647, 4878, 646, 387, 13166, 13, 1752, 279, 24483, 315, 38975, 11, 1077, 594, 57717, 279, 21633, 13388, 315, 279, 77413, 18523, 320, 20805, 438, 7192, 323, 8028, 11964, 804, 8, 438, 1632, 438, 279, 4797, 20590, 315, 279, 77413, 18523, 382, 24089, 510, 4272, 48821, 57874, 25, 3703, 1110, 268, 33366, 2659, 25502, 14, 4272, 48821, 2232, 4840, 5269, 198, 54, 13, 386, 13, 6569, 377, 57874, 25, 3703, 1110, 268, 33366, 2659, 25502, 22175, 1436, 44, 1436, 6608, 377, 2232, 4840, 5269, 1406, 12699, 16, 481, 28456, 284, 220, 16, 20, 5254, 323, 42817, 284, 481, 22, 20, 5254, 11, 10740, 647, 25621, 315, 220, 16, 20, 13, 20, 4878, 323, 7407, 518, 220, 16, 15, 13312, 6010, 504, 601, 382, 12699, 17, 481, 28456, 284, 220, 18, 15, 5254, 323, 42817, 284, 220, 20, 20, 5254, 11, 9981, 647, 25621, 315, 220, 16, 21, 13, 20, 4878, 323, 7407, 518, 220, 20, 13312, 6010, 504, 601, 382, 12699, 18, 481, 28456, 284, 220, 16, 16, 305, 323, 42817, 284, 220, 19, 23, 5254, 11, 9981, 647, 25621, 315, 220, 16, 20, 13, 20, 4878, 11, 468, 5349, 19625, 8, 284, 220, 15, 13, 21, 4878, 323, 7407, 518, 220, 16, 20, 13312, 6010, 504, 601, 13, 7036, 429, 279, 2790, 43125, 304, 279, 647, 7055, 374, 5435, 311, 279, 1894, 13623, 304, 425, 19625, 448, 264, 35606, 6144, 311, 220, 18, 13, 16, 382, 12699, 19, 481, 28456, 284, 220, 23, 20, 5254, 323, 42817, 284, 481, 19, 23, 5254, 11, 10740, 647, 25621, 315, 220, 16, 20, 13, 20, 4878, 11, 468, 5349, 19625, 8, 284, 220, 15, 13, 19, 4878, 323, 7407, 518, 220, 16, 15, 13312, 6010, 504, 601, 13, 7036, 429, 279, 2790, 43125, 304, 279, 647, 7055, 374, 5435, 311, 279, 1894, 13623, 304, 425, 19625, 448, 264, 35606, 6144, 311, 220, 18, 13, 16, 382, 12699, 20, 481, 28456, 284, 220, 16, 15, 305, 323, 42817, 284, 220, 21, 15, 5254, 11, 10740, 647, 25621, 315, 220, 16, 21, 13, 20, 4878, 323, 7407, 518, 220, 20, 13312, 6010, 504, 601, 382, 32, 8, 7679, 19, 323, 7679, 20, 198, 33, 8, 7679, 16, 323, 7679, 19, 198, 34, 8, 7679, 17, 323, 7679, 18, 198, 35, 8, 7679, 18, 323, 7679, 20, 151645, 198, 151644, 77091, 198]",,541,382,923,1.0,1.0
89fd3e39-03c3-4730-8fb8-5968cb8c64ac,7,1,"[151643, 151643, 151643, 151643, 151643, 151643, 151643, 151643, 151643, 151643, 151643, 151643, 151643, 151643, 151643, 151643, 151643, 151643, 151643, 151643, 151643, 151643, 151643, 151643, 151643, 151643, 151643, 151643, 151643, 151643, 151643, 151643, 151643, 151643, 151643, 151643, 151643, 151643, 151643, 151643, 151643, 151643, 151643, 151643, 151643, 151643, 151643, 151643, 151643, 151643, 151643, 151643, 151643, 151643, 151643, 151643, 151643, 151643, 151643, 151643, 151643, 151643, 151643, 151643, 151643, 151643, 151643, 151643, 151643, 151643, 151643, 151643, 151643, 151643, 151643, 151643, 151643, 151643, 151643, 151643, 151643, 151643, 151643, 151643, 151643, 151643, 151643, 151643, 151643, 151643, 151643, 151643, 151643, 151643, 151643, 151643, 151643, 151643, 151643, 151643, 151643, 151643, 151643, 151643, 151643, 151643, 151643, 151643, 151643, 151643, 151643, 151643, 151643, 151643, 151643, 151643, 151643, 151643, 151643, 151643, 151643, 151643, 151643, 151643, 151643, 151643, 151643, 151643, 151643, 151643, 151643, 151643, 151643, 151643, 151643, 151643, 151643, 151643, 151643, 151643, 151643, 151643, 151643, 151643, 151643, 151643, 151643, 151643, 151643, 151643, 151643, 151643, 151643, 151643, 151643, 151643, 151643, 151643, 151643, 151643, 151643, 151643, 151643, 151643, 151643, 151643, 151643, 151643, 151643, 151643, 151643, 151643, 151643, 151643, 151643, 151643, 151643, 151643, 151643, 151643, 151643, 151643, 151643, 151643, 151643, 151643, 151643, 151643, 151643, 151643, 151643, 151643, 151643, 151643, 151643, 151643, 151643, 151643, 151643, 151643, 151643, 151643, 151643, 151643, 151643, 151643, 151643, 151643, 151643, 151643, 151643, 151643, 151643, 151643, 151643, 151643, 151643, 151643, 151643, 151643, 151643, 151643, 151643, 151643, 151643, 151643, 151643, 151643, 151643, 151643, 151643, 151643, 151643, 151643, 151643, 151643, 151643, 151643, 151643, 151643, 151643, 151643, 151643, 151643, 151643, 151643, 151643, 151643, 151643, 151643, 151643, 151643, 151643, 151643, 151643, 151643, 151643, 151643, 151643, 151643, 151643, 151643, 151643, 151643, 151643, 151643, 151643, 151643, 151643, 151643, 151643, 151643, 151643, 151643, 151643, 151643, 151643, 151643, 151643, 151643, 151643, 151643, 151643, 151643, 151643, 151643, 151643, 151643, 151643, 151643, 151643, 151643, 151643, 151643, 151643, 151643, 151643, 151643, 151643, 151643, 151643, 151643, 151643, 151643, 151643, 151643, 151643, 151643, 151643, 151643, 151643, 151643, 151643, 151643, 151643, 151643, 151643, 151643, 151643, 151643, 151643, 151643, 151643, 151643, 151643, 151643, 151643, 151643, 151643, 151643, 151643, 151643, 151643, 151643, 151643, 151643, 151643, 151643, 151643, 151643, 151643, 151643, 151643, 151643, 151643, 151643, 151643, 151643, 151643, 151643, 151643, 151643, 151643, 151643, 151643, 151643, 151643, 151643, 151643, 151643, 151643, 151643, 151643, 151643, 151643, 151643, 151643, 151643, 151643, 151643, 151643, 151643, 151643, 151643, 151643, 151643, 151643, 151643, 151643, 151643, 151643, 151643, 151643, 151643, 151643, 151643, 151643, 151643, 151643, 151643, 151643, 151643, 151643, 151643, 151643, 151643, 151643, 151643, 151643, 151643, 151643, 151643, 151643, 151643, 151643, 151643, 151643, 151643, 151643, 151643, 151643, 151643, 151643, 151643, 151643, 151643, 151643, 151643, 151643, 151643, 151643, 151643, 151643, 151643, 151643, 151643, 151643, 151643, 151643, 151643, 151643, 151643, 151643, 151643, 151643, 151643, 151643, 151643, 151643, 151643, 151643, 151643, 151643, 151643, 151643, 151643, 151643, 151643, 151643, 151643, 151643, 151643, 151643, 151643, 151643, 151643, 151643, 151643, 151643, 151643, 151643, 151643, 151643, 151643, 151643, 151643, 151643, 151643, 151643, 151643, 151643, 151643, 151643, 151643, 151643, 151643, 151643, 151643, 151643, 151643, 151643, 151643, 151643, 151643, 151643, 151643, 151643, 151643, 151643, 151643, 151643, 151643, 151643, 151643, 151643, 151643, 151643, 151643, 151643, 151643, 151643, 151643, 151643, 151643, 151643, 151643, 151643, 151643, 151643, 151643, 151643, 151643, 151643, 151643, 151643, 151643, 151643, 151643, 151643, 151643, 151643, 151643, 151643, 151643, 151643, 151643, 151643, 151643, 151643, 151643, 151643, 151643, 151643, 151643, 151643, 151643, 151643, 151643, 151643, 151643, 151643, 151643, 151643, 151643, 151643, 151643, 151643, 151643, 151643, 151643, 151643, 151643, 151643, 151643, 151643, 151643, 151643, 151643, 151643, 151643, 151643, 151643, 151643, 151643, 151643, 151643, 151643, 151643, 151643, 151643, 151643, 151643, 151643, 151643, 151643, 151643, 151643, 151643, 151643, 151643, 151643, 151643, 151643, 151643, 151643, 151643, 151643, 151643, 151643, 151643, 151643, 151643, 151643, 151643, 151643, 151643, 151643, 151643, 151643, 151643, 151643, 151643, 151643, 151643, 151643, 151643, 151643, 151643, 151643, 151643, 151643, 151643, 151643, 151643, 151643, 151643, 151644, 8948, 198, 2610, 525, 1207, 16948, 11, 3465, 553, 54364, 14817, 13, 1446, 525, 264, 10950, 17847, 13, 151645, 198, 151644, 872, 198, 16141, 279, 2701, 5248, 5754, 3405, 13, 576, 1537, 1555, 315, 697, 2033, 1265, 387, 315, 279, 2701, 3561, 25, 364, 16141, 25, 400, 20756, 4198, 6, 320, 28996, 17194, 8, 1380, 44428, 374, 825, 315, 19360, 35, 13, 21149, 3019, 553, 3019, 1573, 35764, 382, 47866, 279, 34734, 3160, 1256, 315, 264, 30128, 22148, 5675, 57960, 4083, 90, 47, 31716, 369, 264, 11834, 263, 3156, 458, 24168, 5106, 57960, 4083, 91362, 31716, 20446, 304, 279, 856, 9141, 11031, 12159, 311, 279, 28724, 957, 400, 41715, 71, 2257, 14, 17, 12947, 16246, 279, 400, 55, 21389, 8571, 11, 400, 47, 3212, 3, 315, 279, 5675, 400, 47, 3, 438, 57960, 71, 2257, 14, 17, 3, 3039, 264, 220, 17, 553, 220, 17, 9334, 6172, 3432, 5424, 304, 279, 1156, 2802, 438, 4930, 15, 220, 16, 15087, 11, 323, 429, 304, 279, 2086, 2802, 438, 4930, 16, 11, 220, 15, 8, 12947, 576, 400, 56, 21389, 8571, 11, 400, 47, 4178, 3, 315, 279, 5675, 374, 2661, 553, 279, 1985, 315, 57960, 71, 2257, 14, 17, 3, 323, 264, 220, 17, 553, 220, 17, 9334, 6172, 3432, 5424, 304, 279, 1156, 2802, 438, 4930, 15, 11, 481, 72, 15087, 11, 323, 429, 304, 279, 2086, 2802, 438, 4930, 72, 11, 220, 15, 8, 12947, 17375, 11, 279, 400, 57, 21389, 8571, 11, 400, 47, 6415, 3, 315, 279, 5675, 374, 2661, 553, 279, 1985, 315, 57960, 71, 2257, 14, 17, 3, 220, 323, 2441, 220, 17, 553, 220, 17, 9334, 6172, 3432, 5424, 304, 279, 1156, 2802, 438, 4930, 16, 11, 220, 15, 15087, 11, 323, 429, 304, 279, 2086, 2802, 438, 4930, 15, 11, 481, 16, 8, 12947, 220, 3555, 525, 279, 5424, 315, 279, 29410, 34734, 3160, 1256, 1939, 32, 8, 19788, 26888, 90, 17, 14, 18, 11035, 71, 2257, 11, 1124, 26888, 90, 16, 14, 18, 11035, 71, 2257, 340, 33, 8, 19788, 9407, 11520, 15976, 14, 17, 701, 1124, 15940, 19788, 15976, 14, 17, 1171, 34, 8, 19788, 26888, 90, 17, 14, 18, 11035, 71, 2257, 1124, 9407, 11520, 15976, 14, 17, 701, 1124, 26888, 90, 16, 14, 18, 11035, 71, 2257, 1124, 15940, 19788, 15976, 14, 17, 1171, 35, 8, 19788, 9407, 11520, 15976, 701, 384, 47822, 72, 59, 16827, 11035, 15940, 19788, 15976, 593, 151645, 198, 151644, 77091, 198]",,408,624,1032,1.0,1.0
d6c2a8c9-67f4-41a5-814a-aa6bbc05ec65,7,2,"[151643, 151643, 151643, 151643, 151643, 151643, 151643, 151643, 151643, 151643, 151643, 151643, 151643, 151643, 151643, 151643, 151643, 151643, 151643, 151643, 151643, 151643, 151643, 151643, 151643, 151643, 151643, 151643, 151643, 151643, 151643, 151643, 151643, 151643, 151643, 151643, 151643, 151643, 151643, 151643, 151643, 151643, 151643, 151643, 151643, 151643, 151643, 151643, 151643, 151643, 151643, 151643, 151643, 151643, 151643, 151643, 151643, 151643, 151643, 151643, 151643, 151643, 151643, 151643, 151643, 151643, 151643, 151643, 151643, 151643, 151643, 151643, 151643, 151643, 151643, 151643, 151643, 151643, 151643, 151643, 151643, 151643, 151643, 151643, 151643, 151643, 151643, 151643, 151643, 151643, 151643, 151643, 151643, 151643, 151643, 151643, 151643, 151643, 151643, 151643, 151643, 151643, 151643, 151643, 151643, 151643, 151643, 151643, 151643, 151643, 151643, 151643, 151643, 151643, 151643, 151643, 151643, 151643, 151643, 151643, 151643, 151643, 151643, 151643, 151643, 151643, 151643, 151643, 151643, 151643, 151643, 151643, 151643, 151643, 151643, 151643, 151643, 151643, 151643, 151643, 151643, 151643, 151643, 151643, 151643, 151643, 151643, 151643, 151643, 151643, 151643, 151643, 151643, 151643, 151643, 151643, 151643, 151643, 151643, 151643, 151643, 151643, 151643, 151643, 151643, 151643, 151643, 151643, 151643, 151643, 151643, 151643, 151643, 151643, 151643, 151643, 151643, 151643, 151643, 151643, 151643, 151643, 151643, 151643, 151643, 151643, 151643, 151643, 151643, 151643, 151643, 151643, 151643, 151643, 151643, 151643, 151643, 151643, 151643, 151643, 151643, 151643, 151643, 151643, 151643, 151643, 151643, 151643, 151643, 151643, 151643, 151643, 151643, 151643, 151643, 151643, 151643, 151643, 151643, 151643, 151643, 151643, 151643, 151643, 151643, 151643, 151643, 151643, 151643, 151643, 151643, 151643, 151643, 151643, 151643, 151643, 151643, 151643, 151643, 151643, 151643, 151643, 151643, 151643, 151643, 151643, 151643, 151643, 151643, 151643, 151643, 151643, 151643, 151643, 151643, 151643, 151643, 151643, 151643, 151643, 151643, 151643, 151643, 151643, 151643, 151643, 151643, 151643, 151643, 151643, 151643, 151643, 151643, 151643, 151643, 151643, 151643, 151643, 151643, 151643, 151643, 151643, 151643, 151643, 151643, 151643, 151643, 151643, 151643, 151643, 151643, 151643, 151643, 151643, 151643, 151643, 151643, 151643, 151643, 151643, 151643, 151643, 151643, 151643, 151643, 151643, 151643, 151643, 151643, 151643, 151643, 151643, 151643, 151643, 151643, 151643, 151643, 151643, 151643, 151643, 151643, 151643, 151643, 151643, 151643, 151643, 151643, 151643, 151643, 151643, 151643, 151643, 151643, 151643, 151643, 151643, 151643, 151643, 151643, 151643, 151643, 151643, 151643, 151643, 151643, 151643, 151643, 151643, 151643, 151643, 151643, 151643, 151643, 151643, 151643, 151643, 151643, 151643, 151643, 151643, 151643, 151643, 151643, 151643, 151643, 151643, 151643, 151643, 151643, 151643, 151643, 151643, 151643, 151643, 151643, 151643, 151643, 151643, 151643, 151643, 151643, 151643, 151643, 151643, 151643, 151643, 151643, 151643, 151643, 151643, 151643, 151643, 151643, 151643, 151643, 151643, 151643, 151643, 151643, 151643, 151643, 151643, 151643, 151643, 151643, 151643, 151643, 151643, 151643, 151643, 151643, 151643, 151643, 151643, 151643, 151643, 151643, 151643, 151643, 151643, 151643, 151643, 151643, 151643, 151643, 151643, 151643, 151643, 151643, 151643, 151643, 151643, 151643, 151643, 151643, 151643, 151643, 151643, 151643, 151643, 151643, 151643, 151643, 151643, 151643, 151643, 151643, 151643, 151643, 151643, 151643, 151643, 151643, 151643, 151643, 151643, 151643, 151643, 151643, 151643, 151643, 151643, 151643, 151643, 151643, 151643, 151643, 151643, 151643, 151643, 151643, 151643, 151643, 151643, 151643, 151643, 151643, 151643, 151643, 151643, 151643, 151643, 151643, 151643, 151643, 151643, 151643, 151643, 151643, 151643, 151643, 151643, 151643, 151643, 151643, 151643, 151643, 151643, 151643, 151643, 151643, 151643, 151643, 151643, 151643, 151643, 151643, 151643, 151643, 151643, 151643, 151643, 151643, 151643, 151643, 151643, 151643, 151643, 151643, 151643, 151643, 151643, 151643, 151643, 151643, 151643, 151643, 151643, 151643, 151643, 151643, 151643, 151643, 151643, 151643, 151643, 151643, 151643, 151643, 151643, 151643, 151643, 151643, 151643, 151643, 151643, 151643, 151643, 151643, 151643, 151643, 151643, 151643, 151643, 151643, 151643, 151643, 151643, 151643, 151643, 151643, 151643, 151643, 151643, 151643, 151643, 151643, 151643, 151643, 151643, 151643, 151643, 151643, 151643, 151643, 151643, 151643, 151643, 151643, 151643, 151643, 151643, 151643, 151643, 151643, 151643, 151643, 151643, 151643, 151643, 151643, 151643, 151643, 151643, 151643, 151643, 151643, 151643, 151643, 151643, 151643, 151643, 151643, 151643, 151643, 151643, 151643, 151643, 151643, 151643, 151643, 151643, 151643, 151643, 151643, 151643, 151643, 151643, 151643, 151643, 151643, 151643, 151643, 151643, 151643, 151643, 151643, 151643, 151643, 151643, 151643, 151643, 151643, 151643, 151643, 151643, 151643, 151643, 151643, 151643, 151643, 151643, 151643, 151643, 151643, 151643, 151643, 151643, 151643, 151643, 151643, 151643, 151643, 151643, 151643, 151643, 151643, 151643, 151643, 151643, 151643, 151643, 151643, 151643, 151643, 151643, 151643, 151643, 151643, 151643, 151643, 151643, 151643, 151643, 151643, 151643, 151643, 151643, 151643, 151643, 151643, 151643, 151643, 151643, 151643, 151643, 151643, 151643, 151643, 151643, 151643, 151643, 151643, 151643, 151643, 151643, 151643, 151643, 151643, 151643, 151643, 151643, 151643, 151643, 151643, 151643, 151643, 151643, 151643, 151643, 151643, 151643, 151643, 151643, 151643, 151643, 151643, 151643, 151643, 151643, 151643, 151643, 151643, 151643, 151643, 151643, 151643, 151643, 151643, 151643, 151643, 151643, 151643, 151643, 151643, 151643, 151643, 151643, 151643, 151643, 151643, 151643, 151643, 151643, 151643, 151643, 151643, 151643, 151643, 151643, 151643, 151643, 151643, 151643, 151643, 151643, 151643, 151643, 151643, 151643, 151643, 151643, 151643, 151643, 151643, 151643, 151643, 151643, 151643, 151643, 151643, 151643, 151643, 151643, 151643, 151643, 151643, 151643, 151643, 151643, 151643, 151643, 151643, 151643, 151643, 151643, 151643, 151643, 151643, 151644, 8948, 198, 2610, 525, 1207, 16948, 11, 3465, 553, 54364, 14817, 13, 1446, 525, 264, 10950, 17847, 13, 151645, 198, 151644, 872, 198, 16141, 279, 2701, 5248, 5754, 3405, 13, 576, 1537, 1555, 315, 697, 2033, 1265, 387, 315, 279, 2701, 3561, 25, 364, 16141, 25, 400, 20756, 4198, 6, 320, 28996, 17194, 8, 1380, 44428, 374, 825, 315, 19360, 35, 13, 21149, 3019, 553, 3019, 1573, 35764, 382, 580, 5298, 13621, 374, 11758, 448, 93471, 482, 11, 4510, 1869, 482, 11, 323, 1613, 5298, 458, 8503, 67, 1399, 448, 23579, 11, 29064, 1985, 220, 16, 382, 16, 374, 31713, 448, 61672, 323, 264, 2613, 3311, 315, 71491, 292, 13621, 11, 29064, 1985, 220, 17, 382, 17, 374, 11758, 448, 38595, 57888, 577, 11, 29064, 1985, 220, 18, 382, 18, 374, 1221, 11758, 448, 13623, 38595, 6275, 67, 1399, 323, 220, 16, 11, 20, 1737, 579, 441, 453, 306, 2145, 11, 29064, 1590, 1985, 220, 19, 382, 5158, 1657, 12460, 34684, 17289, 686, 387, 39535, 304, 279, 220, 16, 39, 451, 18446, 19745, 315, 220, 19, 30, 320, 14689, 315, 1105, 7196, 1602, 3265, 304, 11483, 6407, 323, 8450, 537, 31267, 32037, 480, 11, 714, 279, 12685, 4226, 374, 279, 1372, 315, 8424, 2673, 12460, 16643, 58305, 692, 32, 8, 220, 16, 15, 198, 33, 8, 220, 20, 198, 34, 8, 220, 16, 17, 198, 35, 8, 220, 23, 151645, 198, 151644, 77091, 198]",,235,600,835,0.0,0.0
fc1cfc52-2988-46ba-912b-d9e209a4bbb1,7,3,"[151643, 151643, 151643, 151643, 151643, 151643, 151643, 151643, 151643, 151643, 151643, 151643, 151643, 151643, 151643, 151643, 151643, 151643, 151643, 151643, 151643, 151643, 151643, 151643, 151643, 151643, 151643, 151643, 151643, 151643, 151643, 151643, 151643, 151643, 151643, 151643, 151643, 151643, 151643, 151643, 151643, 151643, 151643, 151643, 151643, 151643, 151643, 151643, 151643, 151643, 151643, 151643, 151643, 151643, 151643, 151643, 151643, 151643, 151643, 151643, 151643, 151643, 151643, 151643, 151643, 151643, 151643, 151643, 151643, 151643, 151643, 151643, 151643, 151643, 151643, 151643, 151643, 151643, 151643, 151643, 151643, 151643, 151643, 151643, 151643, 151643, 151643, 151643, 151643, 151643, 151643, 151643, 151643, 151643, 151643, 151643, 151643, 151643, 151643, 151643, 151643, 151643, 151643, 151643, 151643, 151643, 151643, 151643, 151643, 151643, 151643, 151643, 151643, 151643, 151643, 151643, 151643, 151643, 151643, 151643, 151643, 151643, 151643, 151643, 151643, 151643, 151643, 151643, 151643, 151643, 151643, 151643, 151643, 151643, 151643, 151643, 151643, 151643, 151643, 151643, 151643, 151643, 151643, 151643, 151643, 151643, 151643, 151643, 151643, 151643, 151643, 151643, 151643, 151643, 151643, 151643, 151643, 151643, 151643, 151643, 151643, 151643, 151643, 151643, 151643, 151643, 151643, 151643, 151643, 151643, 151643, 151643, 151643, 151643, 151643, 151643, 151643, 151643, 151643, 151643, 151643, 151643, 151643, 151643, 151643, 151643, 151643, 151643, 151643, 151643, 151643, 151643, 151643, 151643, 151643, 151643, 151643, 151643, 151643, 151643, 151643, 151643, 151643, 151643, 151643, 151643, 151643, 151643, 151643, 151643, 151643, 151643, 151643, 151643, 151643, 151643, 151643, 151643, 151643, 151643, 151643, 151643, 151643, 151643, 151643, 151643, 151643, 151643, 151643, 151643, 151643, 151643, 151643, 151643, 151643, 151643, 151643, 151643, 151643, 151643, 151643, 151643, 151643, 151643, 151643, 151643, 151643, 151643, 151643, 151643, 151643, 151643, 151643, 151643, 151643, 151643, 151643, 151643, 151643, 151643, 151643, 151643, 151643, 151643, 151643, 151643, 151643, 151643, 151643, 151643, 151643, 151643, 151643, 151643, 151643, 151643, 151643, 151643, 151643, 151643, 151643, 151643, 151643, 151643, 151643, 151643, 151643, 151643, 151643, 151643, 151643, 151643, 151643, 151643, 151643, 151643, 151643, 151643, 151643, 151643, 151643, 151643, 151643, 151643, 151643, 151643, 151643, 151643, 151643, 151643, 151643, 151643, 151643, 151643, 151643, 151643, 151643, 151643, 151643, 151643, 151643, 151643, 151643, 151643, 151643, 151643, 151643, 151643, 151643, 151643, 151643, 151643, 151643, 151643, 151643, 151643, 151643, 151643, 151643, 151643, 151643, 151643, 151643, 151643, 151643, 151643, 151643, 151643, 151643, 151643, 151643, 151643, 151643, 151643, 151643, 151643, 151643, 151643, 151643, 151643, 151643, 151643, 151643, 151643, 151643, 151643, 151643, 151643, 151643, 151643, 151643, 151643, 151643, 151643, 151643, 151643, 151643, 151643, 151643, 151643, 151643, 151643, 151643, 151643, 151643, 151643, 151643, 151643, 151643, 151643, 151643, 151643, 151643, 151643, 151643, 151643, 151643, 151643, 151643, 151643, 151643, 151643, 151643, 151643, 151643, 151643, 151643, 151643, 151643, 151643, 151643, 151643, 151643, 151643, 151643, 151643, 151643, 151643, 151643, 151643, 151643, 151643, 151643, 151643, 151643, 151643, 151643, 151643, 151643, 151643, 151643, 151643, 151643, 151643, 151643, 151643, 151643, 151643, 151643, 151643, 151643, 151643, 151643, 151643, 151643, 151643, 151643, 151643, 151643, 151643, 151643, 151643, 151643, 151643, 151643, 151643, 151643, 151643, 151643, 151643, 151643, 151643, 151643, 151643, 151643, 151643, 151643, 151643, 151643, 151643, 151643, 151643, 151643, 151643, 151643, 151643, 151643, 151643, 151643, 151643, 151643, 151643, 151643, 151643, 151643, 151643, 151643, 151643, 151643, 151643, 151643, 151643, 151643, 151643, 151643, 151643, 151643, 151643, 151643, 151643, 151643, 151643, 151643, 151643, 151643, 151643, 151643, 151643, 151643, 151643, 151643, 151643, 151643, 151643, 151643, 151643, 151643, 151643, 151643, 151643, 151643, 151643, 151643, 151643, 151643, 151643, 151643, 151643, 151643, 151643, 151643, 151643, 151643, 151643, 151643, 151643, 151643, 151643, 151643, 151643, 151643, 151643, 151643, 151643, 151643, 151643, 151643, 151643, 151643, 151643, 151643, 151643, 151643, 151643, 151643, 151643, 151643, 151643, 151643, 151643, 151643, 151643, 151643, 151643, 151643, 151643, 151643, 151643, 151643, 151643, 151643, 151643, 151643, 151643, 151643, 151643, 151643, 151643, 151643, 151643, 151643, 151643, 151643, 151643, 151643, 151643, 151643, 151643, 151643, 151643, 151643, 151643, 151643, 151643, 151643, 151643, 151643, 151643, 151643, 151643, 151643, 151643, 151643, 151643, 151643, 151643, 151643, 151643, 151643, 151643, 151643, 151643, 151643, 151643, 151643, 151643, 151643, 151643, 151643, 151643, 151643, 151643, 151643, 151643, 151643, 151643, 151643, 151643, 151643, 151643, 151643, 151643, 151643, 151643, 151643, 151643, 151643, 151643, 151643, 151643, 151643, 151643, 151643, 151643, 151643, 151643, 151643, 151643, 151643, 151643, 151643, 151643, 151643, 151643, 151643, 151643, 151643, 151643, 151643, 151643, 151643, 151643, 151643, 151643, 151643, 151643, 151643, 151643, 151643, 151643, 151643, 151643, 151643, 151643, 151643, 151643, 151643, 151643, 151643, 151643, 151643, 151643, 151643, 151643, 151643, 151643, 151643, 151643, 151643, 151643, 151643, 151643, 151643, 151643, 151643, 151644, 8948, 198, 2610, 525, 1207, 16948, 11, 3465, 553, 54364, 14817, 13, 1446, 525, 264, 10950, 17847, 13, 151645, 198, 151644, 872, 198, 16141, 279, 2701, 5248, 5754, 3405, 13, 576, 1537, 1555, 315, 697, 2033, 1265, 387, 315, 279, 2701, 3561, 25, 364, 16141, 25, 400, 20756, 4198, 6, 320, 28996, 17194, 8, 1380, 44428, 374, 825, 315, 19360, 35, 13, 21149, 3019, 553, 3019, 1573, 35764, 382, 1702, 19991, 24473, 2924, 30384, 97535, 292, 93650, 11, 4045, 21990, 321, 292, 37214, 11, 323, 279, 9756, 41625, 315, 14246, 264, 1065, 288, 448, 34772, 3549, 75, 31146, 311, 6923, 81852, 1543, 13, 2925, 19991, 24473, 525, 5390, 12538, 369, 6825, 6351, 31146, 448, 5189, 15629, 5203, 323, 37952, 51655, 624, 44, 2939, 279, 1985, 315, 279, 2701, 12720, 320, 33, 8, 323, 3293, 279, 4396, 8500, 315, 279, 312, 54875, 4092, 311, 279, 12720, 7354, 320, 32, 4292, 10722, 7287, 45, 1448, 41872, 11250, 8013, 45125, 276, 12, 17, 12, 3923, 307, 1952, 8, 769, 276, 8608, 2356, 488, 362, 69726, 425, 271, 32, 8, 320, 72, 8, 444, 6352, 11, 422, 7462, 320, 3808, 8, 6826, 18, 2149, 17, 40, 320, 34594, 8, 472, 18, 46, 10, 425, 284, 20189, 276, 12, 17, 18589, 488, 451, 22037, 1737, 318, 769, 967, 53795, 19991, 198, 33, 8, 362, 284, 320, 72, 8, 444, 6352, 11, 422, 7462, 320, 3808, 8, 6826, 18, 2149, 17, 40, 320, 34594, 8, 472, 18, 46, 10, 425, 284, 566, 417, 276, 12, 19, 18589, 198, 34, 8, 320, 72, 8, 444, 6352, 320, 3808, 8, 422, 7462, 11, 6826, 18, 2149, 17, 40, 11, 472, 18, 46, 44662, 425, 284, 566, 417, 276, 12, 19, 18589, 198, 35, 8, 320, 72, 8, 444, 6352, 320, 3808, 8, 422, 7462, 11, 6826, 18, 2149, 17, 40, 11, 472, 18, 46, 44662, 425, 284, 20189, 276, 12, 17, 18589, 488, 451, 22037, 1737, 318, 769, 967, 53795, 19991, 151645, 198, 151644, 77091, 198]",,329,572,901,0.0,0.0
0871bd02-10e1-4f08-85f5-4c85036368ca,7,4,"[151643, 151643, 151643, 151643, 151643, 151643, 151643, 151643, 151643, 151643, 151643, 151643, 151643, 151643, 151643, 151643, 151643, 151643, 151643, 151643, 151643, 151643, 151643, 151643, 151643, 151643, 151643, 151643, 151643, 151643, 151643, 151643, 151643, 151643, 151643, 151643, 151643, 151643, 151643, 151643, 151643, 151643, 151643, 151643, 151643, 151643, 151643, 151643, 151643, 151643, 151643, 151643, 151643, 151643, 151643, 151643, 151643, 151643, 151643, 151643, 151643, 151643, 151643, 151643, 151643, 151643, 151643, 151643, 151643, 151643, 151643, 151643, 151643, 151643, 151643, 151643, 151643, 151643, 151643, 151643, 151643, 151643, 151643, 151643, 151643, 151643, 151643, 151643, 151643, 151643, 151643, 151643, 151643, 151643, 151643, 151643, 151643, 151643, 151643, 151643, 151643, 151643, 151643, 151643, 151643, 151643, 151643, 151643, 151643, 151643, 151643, 151643, 151643, 151643, 151643, 151643, 151643, 151643, 151643, 151643, 151643, 151643, 151643, 151643, 151643, 151643, 151643, 151643, 151643, 151643, 151643, 151643, 151643, 151643, 151643, 151643, 151643, 151643, 151643, 151643, 151643, 151643, 151643, 151643, 151643, 151643, 151643, 151643, 151643, 151643, 151643, 151643, 151643, 151643, 151643, 151643, 151643, 151643, 151643, 151643, 151643, 151643, 151643, 151643, 151643, 151643, 151643, 151643, 151643, 151643, 151643, 151643, 151643, 151643, 151643, 151643, 151643, 151643, 151643, 151643, 151643, 151643, 151643, 151643, 151643, 151643, 151643, 151643, 151643, 151643, 151643, 151643, 151643, 151643, 151643, 151643, 151643, 151643, 151643, 151643, 151643, 151643, 151643, 151643, 151643, 151643, 151643, 151643, 151643, 151643, 151643, 151643, 151643, 151643, 151643, 151643, 151643, 151643, 151643, 151643, 151643, 151643, 151643, 151643, 151643, 151643, 151643, 151643, 151643, 151643, 151643, 151643, 151643, 151643, 151643, 151643, 151643, 151643, 151643, 151643, 151643, 151643, 151643, 151643, 151643, 151643, 151643, 151643, 151643, 151643, 151643, 151643, 151643, 151643, 151643, 151643, 151643, 151643, 151643, 151643, 151643, 151643, 151643, 151643, 151643, 151643, 151643, 151643, 151643, 151643, 151643, 151643, 151643, 151643, 151643, 151643, 151643, 151643, 151643, 151643, 151643, 151643, 151643, 151643, 151643, 151643, 151643, 151643, 151643, 151643, 151643, 151643, 151643, 151643, 151643, 151643, 151643, 151643, 151643, 151643, 151643, 151643, 151643, 151643, 151643, 151643, 151643, 151643, 151643, 151643, 151643, 151643, 151643, 151643, 151643, 151643, 151643, 151643, 151643, 151643, 151643, 151643, 151643, 151643, 151643, 151643, 151643, 151643, 151643, 151643, 151643, 151643, 151643, 151643, 151643, 151643, 151643, 151643, 151643, 151643, 151643, 151643, 151643, 151643, 151643, 151643, 151643, 151643, 151643, 151643, 151643, 151643, 151643, 151643, 151643, 151643, 151643, 151643, 151643, 151643, 151643, 151643, 151643, 151643, 151643, 151643, 151643, 151643, 151643, 151643, 151643, 151643, 151643, 151643, 151643, 151643, 151643, 151643, 151643, 151643, 151643, 151643, 151643, 151643, 151643, 151643, 151643, 151643, 151643, 151643, 151643, 151643, 151643, 151643, 151643, 151643, 151643, 151643, 151643, 151643, 151643, 151643, 151643, 151643, 151643, 151643, 151643, 151643, 151643, 151643, 151643, 151643, 151643, 151643, 151643, 151643, 151643, 151643, 151643, 151643, 151643, 151643, 151643, 151643, 151643, 151643, 151643, 151643, 151643, 151643, 151643, 151643, 151643, 151643, 151643, 151643, 151643, 151643, 151643, 151643, 151643, 151643, 151643, 151643, 151643, 151643, 151643, 151643, 151643, 151643, 151643, 151643, 151643, 151643, 151643, 151643, 151643, 151643, 151643, 151643, 151643, 151643, 151643, 151643, 151643, 151643, 151643, 151643, 151643, 151643, 151643, 151643, 151643, 151643, 151643, 151643, 151643, 151643, 151643, 151643, 151643, 151643, 151643, 151643, 151643, 151643, 151643, 151643, 151643, 151643, 151643, 151643, 151643, 151643, 151643, 151643, 151643, 151643, 151643, 151643, 151643, 151643, 151643, 151643, 151643, 151643, 151643, 151643, 151643, 151643, 151643, 151643, 151643, 151643, 151643, 151643, 151643, 151643, 151643, 151643, 151643, 151643, 151643, 151643, 151643, 151643, 151643, 151643, 151643, 151643, 151643, 151643, 151643, 151643, 151643, 151643, 151643, 151643, 151643, 151643, 151643, 151643, 151643, 151643, 151643, 151643, 151643, 151643, 151643, 151643, 151643, 151643, 151643, 151643, 151643, 151643, 151643, 151643, 151643, 151643, 151643, 151643, 151643, 151643, 151643, 151643, 151643, 151643, 151643, 151643, 151643, 151643, 151643, 151643, 151643, 151643, 151643, 151643, 151643, 151643, 151643, 151643, 151643, 151643, 151643, 151643, 151643, 151643, 151643, 151643, 151643, 151643, 151643, 151643, 151643, 151643, 151643, 151643, 151643, 151643, 151643, 151643, 151643, 151643, 151643, 151643, 151643, 151643, 151643, 151643, 151643, 151643, 151643, 151643, 151643, 151643, 151643, 151643, 151643, 151643, 151643, 151643, 151643, 151643, 151643, 151643, 151643, 151643, 151643, 151643, 151643, 151643, 151643, 151643, 151643, 151643, 151643, 151643, 151643, 151643, 151643, 151643, 151643, 151643, 151643, 151643, 151643, 151643, 151643, 151643, 151643, 151643, 151643, 151643, 151643, 151643, 151643, 151643, 151643, 151643, 151643, 151643, 151643, 151643, 151643, 151643, 151643, 151643, 151643, 151643, 151643, 151643, 151643, 151643, 151643, 151643, 151643, 151643, 151643, 151643, 151643, 151643, 151643, 151643, 151643, 151643, 151643, 151643, 151643, 151643, 151643, 151643, 151643, 151643, 151643, 151643, 151643, 151643, 151643, 151643, 151643, 151643, 151643, 151643, 151643, 151643, 151643, 151643, 151643, 151643, 151643, 151643, 151643, 151643, 151643, 151643, 151643, 151643, 151643, 151643, 151643, 151644, 8948, 198, 2610, 525, 1207, 16948, 11, 3465, 553, 54364, 14817, 13, 1446, 525, 264, 10950, 17847, 13, 151645, 198, 151644, 872, 198, 16141, 279, 2701, 5248, 5754, 3405, 13, 576, 1537, 1555, 315, 697, 2033, 1265, 387, 315, 279, 2701, 3561, 25, 364, 16141, 25, 400, 20756, 4198, 6, 320, 28996, 17194, 8, 1380, 44428, 374, 825, 315, 19360, 35, 13, 21149, 3019, 553, 3019, 1573, 35764, 382, 13552, 3095, 429, 614, 279, 1852, 30106, 14806, 714, 525, 2155, 304, 862, 23759, 26112, 525, 3881, 438, 374, 68538, 13, 2160, 68538, 614, 1378, 4494, 11, 24526, 374, 68538, 323, 22646, 29048, 68538, 13, 62185, 374, 68538, 614, 279, 1852, 30106, 14806, 714, 1745, 304, 862, 14389, 13, 758, 22646, 29048, 68538, 11, 34615, 525, 8433, 304, 279, 1852, 1616, 11, 714, 862, 27804, 304, 3550, 525, 2155, 624, 33610, 279, 2661, 31146, 320, 7964, 12738, 35344, 603, 609, 43348, 385, 17308, 2145, 12, 16, 11, 18, 11, 20, 10188, 6339, 8, 279, 23628, 429, 1558, 537, 1473, 259, 2717, 25359, 2142, 320, 32, 8, 323, 4221, 78474, 220, 17, 2832, 67007, 4130, 776, 848, 78, 349, 323, 5103, 41872, 282, 30867, 349, 892, 825, 686, 1473, 28293, 374, 25359, 2142, 320, 33, 3593, 32, 8, 362, 284, 3318, 12738, 35344, 603, 11, 425, 284, 5103, 41872, 282, 30867, 349, 198, 33, 8, 362, 284, 3318, 12738, 35344, 603, 11, 425, 284, 78474, 220, 17, 2832, 67007, 4130, 776, 848, 78, 349, 198, 34, 8, 362, 284, 43348, 385, 17308, 2145, 12, 16, 11, 18, 11, 20, 10188, 6339, 11, 425, 284, 78474, 220, 17, 2832, 67007, 4130, 776, 848, 78, 349, 198, 35, 8, 362, 284, 43348, 385, 17308, 2145, 12, 16, 11, 18, 11, 20, 10188, 6339, 11, 425, 284, 5103, 41872, 282, 30867, 349, 151645, 198, 151644, 77091, 198]",,303,479,782,1.0,1.0
0b70b55a-6d2f-4e92-8579-6cb3dc06cee2,7,5,"[151643, 151643, 151643, 151643, 151643, 151643, 151643, 151643, 151643, 151643, 151643, 151643, 151643, 151643, 151643, 151643, 151643, 151643, 151643, 151643, 151643, 151643, 151643, 151643, 151643, 151643, 151643, 151643, 151643, 151643, 151643, 151643, 151643, 151643, 151643, 151643, 151643, 151643, 151643, 151643, 151643, 151643, 151643, 151643, 151643, 151643, 151643, 151643, 151643, 151643, 151643, 151643, 151643, 151643, 151643, 151643, 151643, 151643, 151643, 151643, 151643, 151643, 151643, 151643, 151643, 151643, 151643, 151643, 151643, 151643, 151643, 151643, 151643, 151643, 151643, 151643, 151643, 151643, 151643, 151643, 151643, 151643, 151643, 151643, 151643, 151643, 151643, 151643, 151643, 151643, 151643, 151643, 151643, 151643, 151643, 151643, 151643, 151643, 151643, 151643, 151643, 151643, 151643, 151643, 151643, 151643, 151643, 151643, 151643, 151643, 151643, 151643, 151643, 151643, 151643, 151643, 151643, 151643, 151643, 151643, 151643, 151643, 151643, 151643, 151643, 151643, 151643, 151643, 151643, 151643, 151643, 151643, 151643, 151643, 151643, 151643, 151643, 151643, 151643, 151643, 151643, 151643, 151643, 151643, 151643, 151643, 151643, 151643, 151643, 151643, 151643, 151643, 151643, 151643, 151643, 151643, 151643, 151643, 151643, 151643, 151643, 151643, 151643, 151643, 151643, 151643, 151643, 151643, 151643, 151643, 151643, 151643, 151643, 151643, 151643, 151643, 151643, 151643, 151643, 151643, 151643, 151643, 151643, 151643, 151643, 151643, 151643, 151643, 151643, 151643, 151643, 151643, 151643, 151643, 151643, 151643, 151643, 151643, 151643, 151643, 151643, 151643, 151643, 151643, 151643, 151643, 151643, 151643, 151643, 151643, 151643, 151643, 151643, 151643, 151643, 151643, 151643, 151643, 151643, 151643, 151643, 151643, 151643, 151643, 151643, 151643, 151643, 151643, 151643, 151643, 151643, 151643, 151643, 151643, 151643, 151643, 151643, 151643, 151643, 151643, 151643, 151643, 151643, 151643, 151643, 151643, 151643, 151643, 151643, 151643, 151643, 151643, 151643, 151643, 151643, 151643, 151643, 151643, 151643, 151643, 151643, 151643, 151643, 151643, 151643, 151643, 151643, 151643, 151643, 151643, 151643, 151643, 151643, 151643, 151643, 151643, 151643, 151643, 151643, 151643, 151643, 151643, 151643, 151643, 151643, 151643, 151643, 151643, 151643, 151643, 151643, 151643, 151643, 151643, 151643, 151643, 151643, 151643, 151643, 151643, 151643, 151643, 151643, 151643, 151643, 151643, 151643, 151643, 151643, 151643, 151643, 151643, 151643, 151643, 151643, 151643, 151643, 151643, 151643, 151643, 151643, 151643, 151643, 151643, 151643, 151643, 151643, 151643, 151643, 151643, 151643, 151643, 151643, 151643, 151643, 151643, 151643, 151643, 151643, 151643, 151643, 151643, 151643, 151643, 151643, 151643, 151643, 151643, 151643, 151643, 151643, 151643, 151643, 151643, 151643, 151643, 151643, 151643, 151643, 151643, 151643, 151643, 151643, 151643, 151643, 151643, 151643, 151643, 151643, 151643, 151643, 151643, 151643, 151643, 151643, 151643, 151643, 151643, 151643, 151643, 151643, 151643, 151643, 151643, 151643, 151643, 151643, 151643, 151643, 151643, 151643, 151643, 151643, 151643, 151643, 151643, 151643, 151643, 151643, 151643, 151643, 151643, 151643, 151643, 151643, 151643, 151643, 151643, 151643, 151643, 151643, 151643, 151643, 151643, 151643, 151643, 151643, 151643, 151643, 151643, 151643, 151643, 151643, 151643, 151643, 151643, 151643, 151643, 151643, 151643, 151643, 151643, 151643, 151643, 151643, 151643, 151643, 151643, 151643, 151643, 151643, 151643, 151643, 151643, 151643, 151643, 151643, 151643, 151643, 151643, 151643, 151643, 151643, 151643, 151643, 151643, 151643, 151643, 151643, 151643, 151643, 151643, 151643, 151643, 151643, 151643, 151643, 151643, 151643, 151643, 151643, 151643, 151643, 151643, 151643, 151643, 151643, 151643, 151643, 151643, 151643, 151643, 151643, 151643, 151643, 151643, 151643, 151643, 151643, 151643, 151643, 151643, 151643, 151643, 151643, 151643, 151643, 151643, 151643, 151643, 151643, 151643, 151643, 151643, 151643, 151643, 151643, 151643, 151643, 151643, 151643, 151643, 151643, 151643, 151643, 151643, 151643, 151643, 151643, 151643, 151643, 151643, 151643, 151643, 151643, 151643, 151643, 151643, 151643, 151643, 151643, 151643, 151643, 151643, 151643, 151643, 151643, 151643, 151643, 151643, 151643, 151643, 151643, 151643, 151643, 151643, 151643, 151643, 151643, 151643, 151643, 151643, 151643, 151643, 151643, 151643, 151643, 151643, 151643, 151643, 151643, 151643, 151643, 151643, 151643, 151643, 151643, 151643, 151643, 151643, 151643, 151643, 151643, 151643, 151643, 151643, 151643, 151643, 151643, 151643, 151643, 151643, 151643, 151643, 151643, 151643, 151643, 151643, 151643, 151643, 151643, 151643, 151643, 151643, 151643, 151643, 151643, 151643, 151643, 151643, 151643, 151643, 151643, 151643, 151643, 151643, 151643, 151643, 151643, 151643, 151643, 151643, 151643, 151643, 151643, 151643, 151643, 151643, 151643, 151643, 151643, 151643, 151643, 151643, 151643, 151643, 151643, 151643, 151643, 151643, 151643, 151643, 151643, 151643, 151643, 151643, 151643, 151643, 151643, 151643, 151643, 151643, 151643, 151643, 151643, 151643, 151643, 151643, 151643, 151643, 151643, 151643, 151643, 151643, 151643, 151643, 151643, 151643, 151643, 151643, 151643, 151643, 151643, 151643, 151643, 151643, 151643, 151643, 151643, 151643, 151643, 151643, 151643, 151643, 151643, 151643, 151643, 151643, 151643, 151643, 151643, 151643, 151643, 151643, 151643, 151643, 151643, 151643, 151643, 151643, 151643, 151643, 151643, 151643, 151643, 151643, 151643, 151643, 151643, 151643, 151643, 151643, 151643, 151643, 151643, 151643, 151643, 151643, 151643, 151643, 151643, 151643, 151643, 151643, 151643, 151643, 151643, 151643, 151643, 151643, 151643, 151643, 151643, 151643, 151643, 151643, 151643, 151643, 151643, 151643, 151643, 151643, 151644, 8948, 198, 2610, 525, 1207, 16948, 11, 3465, 553, 54364, 14817, 13, 1446, 525, 264, 10950, 17847, 13, 151645, 198, 151644, 872, 198, 16141, 279, 2701, 5248, 5754, 3405, 13, 576, 1537, 1555, 315, 697, 2033, 1265, 387, 315, 279, 2701, 3561, 25, 364, 16141, 25, 400, 20756, 4198, 6, 320, 28996, 17194, 8, 1380, 44428, 374, 825, 315, 19360, 35, 13, 21149, 3019, 553, 3019, 1573, 35764, 382, 32, 8424, 380, 26674, 1378, 24473, 1447, 87236, 220, 16, 25, 320, 36, 7287, 41692, 12, 19, 12, 1952, 374, 11758, 448, 825, 68458, 13, 315, 296, 7123, 7064, 11, 8110, 553, 65200, 782, 13621, 13, 4710, 87236, 220, 17, 25, 320, 57, 7287, 41692, 12, 19, 12, 1952, 374, 11758, 448, 825, 68458, 13, 315, 296, 7123, 7064, 11, 8110, 553, 65200, 782, 13621, 382, 20629, 24473, 728, 311, 220, 16, 15, 15, 4, 9755, 13, 576, 8424, 380, 32411, 279, 3871, 315, 2176, 24473, 11, 323, 1221, 8473, 279, 1985, 20980, 389, 2176, 264, 5297, 320, 610, 36378, 8, 9931, 81610, 472, 2916, 34, 3250, 323, 264, 521, 36378, 472, 2916, 34, 3250, 382, 5615, 29489, 429, 279, 97184, 12679, 10935, 374, 438, 1550, 438, 62134, 3204, 304, 2176, 5048, 11, 1128, 1558, 279, 8424, 380, 22986, 304, 1817, 315, 1493, 97184, 55385, 1939, 32, 8, 220, 17, 38935, 304, 5297, 472, 2916, 34, 323, 220, 18, 38935, 304, 521, 36378, 472, 2916, 34, 198, 33, 8, 220, 19, 38935, 304, 2176, 5297, 323, 521, 36378, 472, 2916, 34, 198, 34, 8, 220, 17, 38935, 304, 2176, 5297, 323, 521, 36378, 472, 2916, 34, 198, 35, 8, 220, 18, 38935, 304, 5297, 472, 2916, 34, 323, 220, 19, 38935, 304, 521, 36378, 472, 2916, 34, 151645, 198, 151644, 77091, 198]",,292,478,770,0.0,0.0
7731fcec-66a4-417a-95fd-4e093470c1ba,7,6,"[151643, 151643, 151643, 151643, 151643, 151643, 151643, 151643, 151643, 151643, 151643, 151643, 151643, 151643, 151643, 151643, 151643, 151643, 151643, 151643, 151643, 151643, 151643, 151643, 151643, 151643, 151643, 151643, 151643, 151643, 151643, 151643, 151643, 151643, 151643, 151643, 151643, 151643, 151643, 151643, 151643, 151643, 151643, 151643, 151643, 151643, 151643, 151643, 151643, 151643, 151643, 151643, 151643, 151643, 151643, 151643, 151643, 151643, 151643, 151643, 151643, 151643, 151643, 151643, 151643, 151643, 151643, 151643, 151643, 151643, 151643, 151643, 151643, 151643, 151643, 151643, 151643, 151643, 151643, 151643, 151643, 151643, 151643, 151643, 151643, 151643, 151643, 151643, 151643, 151643, 151643, 151643, 151643, 151643, 151643, 151643, 151643, 151643, 151643, 151643, 151643, 151643, 151643, 151643, 151643, 151643, 151643, 151643, 151643, 151643, 151643, 151643, 151643, 151643, 151643, 151643, 151643, 151643, 151643, 151643, 151643, 151643, 151643, 151643, 151643, 151643, 151643, 151643, 151643, 151643, 151643, 151643, 151643, 151643, 151643, 151643, 151643, 151643, 151643, 151643, 151643, 151643, 151643, 151643, 151643, 151643, 151643, 151643, 151643, 151643, 151643, 151643, 151643, 151643, 151643, 151643, 151643, 151643, 151643, 151643, 151643, 151643, 151643, 151643, 151643, 151643, 151643, 151643, 151643, 151643, 151643, 151643, 151643, 151643, 151643, 151643, 151643, 151643, 151643, 151643, 151643, 151643, 151643, 151643, 151643, 151643, 151643, 151643, 151643, 151643, 151643, 151643, 151643, 151643, 151643, 151643, 151643, 151643, 151643, 151643, 151643, 151643, 151643, 151643, 151643, 151643, 151643, 151643, 151643, 151643, 151643, 151643, 151643, 151643, 151643, 151643, 151643, 151643, 151643, 151643, 151643, 151643, 151643, 151643, 151643, 151643, 151643, 151643, 151643, 151643, 151643, 151643, 151643, 151643, 151643, 151643, 151643, 151643, 151643, 151643, 151643, 151643, 151643, 151643, 151643, 151643, 151643, 151643, 151643, 151643, 151643, 151643, 151643, 151643, 151643, 151643, 151643, 151643, 151643, 151643, 151643, 151643, 151643, 151643, 151643, 151643, 151643, 151643, 151643, 151643, 151643, 151643, 151643, 151643, 151643, 151643, 151643, 151643, 151643, 151643, 151643, 151643, 151643, 151643, 151643, 151643, 151643, 151643, 151643, 151643, 151643, 151643, 151643, 151643, 151643, 151643, 151643, 151643, 151643, 151643, 151643, 151643, 151643, 151643, 151643, 151643, 151643, 151643, 151643, 151643, 151643, 151643, 151643, 151643, 151643, 151643, 151643, 151643, 151643, 151643, 151643, 151643, 151643, 151643, 151643, 151643, 151643, 151643, 151643, 151643, 151643, 151643, 151643, 151643, 151643, 151643, 151643, 151643, 151643, 151643, 151643, 151643, 151643, 151643, 151643, 151643, 151643, 151643, 151643, 151643, 151643, 151643, 151643, 151643, 151643, 151643, 151643, 151643, 151643, 151643, 151643, 151643, 151643, 151643, 151643, 151643, 151643, 151643, 151643, 151643, 151643, 151643, 151643, 151643, 151643, 151643, 151643, 151643, 151643, 151643, 151643, 151643, 151643, 151643, 151643, 151643, 151643, 151643, 151643, 151643, 151643, 151643, 151643, 151643, 151643, 151643, 151643, 151643, 151643, 151643, 151643, 151643, 151643, 151643, 151643, 151643, 151643, 151643, 151643, 151643, 151643, 151643, 151643, 151643, 151643, 151643, 151643, 151643, 151643, 151643, 151643, 151643, 151643, 151643, 151643, 151643, 151643, 151643, 151643, 151643, 151643, 151643, 151643, 151643, 151643, 151643, 151643, 151643, 151643, 151643, 151643, 151643, 151643, 151643, 151643, 151643, 151643, 151643, 151643, 151643, 151643, 151643, 151643, 151643, 151643, 151643, 151643, 151643, 151643, 151643, 151643, 151643, 151643, 151643, 151643, 151643, 151643, 151643, 151643, 151643, 151643, 151643, 151643, 151643, 151643, 151643, 151643, 151643, 151643, 151643, 151643, 151643, 151643, 151643, 151643, 151643, 151643, 151643, 151643, 151643, 151643, 151643, 151643, 151643, 151643, 151643, 151643, 151643, 151643, 151643, 151643, 151643, 151643, 151643, 151643, 151643, 151643, 151643, 151643, 151643, 151643, 151643, 151643, 151643, 151643, 151643, 151643, 151643, 151643, 151643, 151643, 151643, 151643, 151643, 151643, 151643, 151643, 151643, 151643, 151643, 151643, 151643, 151643, 151643, 151643, 151643, 151643, 151643, 151643, 151643, 151643, 151643, 151643, 151643, 151643, 151643, 151643, 151643, 151643, 151643, 151643, 151643, 151643, 151643, 151643, 151643, 151643, 151643, 151643, 151643, 151643, 151643, 151643, 151643, 151643, 151643, 151643, 151643, 151643, 151643, 151643, 151643, 151643, 151643, 151643, 151643, 151643, 151643, 151643, 151643, 151643, 151643, 151643, 151643, 151643, 151643, 151643, 151643, 151643, 151643, 151643, 151643, 151643, 151643, 151643, 151643, 151643, 151643, 151643, 151643, 151643, 151643, 151643, 151643, 151643, 151643, 151643, 151643, 151643, 151643, 151643, 151643, 151643, 151643, 151643, 151643, 151643, 151643, 151643, 151643, 151643, 151643, 151643, 151643, 151643, 151643, 151643, 151643, 151643, 151643, 151643, 151643, 151643, 151643, 151643, 151643, 151643, 151643, 151643, 151643, 151643, 151643, 151643, 151643, 151643, 151643, 151643, 151643, 151643, 151643, 151643, 151643, 151643, 151643, 151643, 151643, 151643, 151643, 151643, 151643, 151643, 151643, 151643, 151643, 151643, 151643, 151643, 151643, 151643, 151643, 151643, 151643, 151643, 151643, 151643, 151643, 151643, 151643, 151643, 151643, 151643, 151643, 151643, 151643, 151643, 151643, 151643, 151643, 151643, 151643, 151643, 151643, 151643, 151643, 151643, 151643, 151643, 151643, 151643, 151643, 151643, 151643, 151643, 151643, 151643, 151643, 151643, 151643, 151643, 151643, 151643, 151643, 151643, 151643, 151643, 151643, 151643, 151643, 151643, 151643, 151643, 151643, 151643, 151643, 151643, 151643, 151643, 151643, 151643, 151643, 151643, 151643, 151643, 151643, 151643, 151643, 151643, 151643, 151643, 151643, 151643, 151643, 151643, 151643, 151643, 151643, 151643, 151643, 151643, 151643, 151643, 151643, 151643, 151643, 151643, 151643, 151643, 151643, 151643, 151643, 151643, 151643, 151643, 151643, 151643, 151643, 151643, 151643, 151643, 151643, 151643, 151643, 151643, 151643, 151643, 151643, 151643, 151643, 151643, 151643, 151643, 151643, 151643, 151643, 151643, 151643, 151643, 151643, 151643, 151643, 151643, 151643, 151643, 151643, 151643, 151643, 151643, 151643, 151643, 151643, 151643, 151643, 151643, 151643, 151643, 151643, 151643, 151643, 151643, 151643, 151643, 151643, 151643, 151643, 151643, 151643, 151643, 151643, 151643, 151643, 151643, 151643, 151643, 151643, 151643, 151643, 151643, 151643, 151643, 151643, 151643, 151643, 151643, 151643, 151643, 151643, 151643, 151643, 151643, 151643, 151643, 151643, 151643, 151643, 151643, 151643, 151643, 151643, 151643, 151643, 151643, 151643, 151643, 151643, 151643, 151643, 151643, 151643, 151643, 151643, 151643, 151643, 151643, 151643, 151643, 151643, 151643, 151643, 151643, 151643, 151643, 151643, 151643, 151643, 151643, 151643, 151643, 151643, 151643, 151643, 151643, 151643, 151643, 151643, 151643, 151643, 151643, 151643, 151643, 151643, 151643, 151643, 151643, 151643, 151643, 151643, 151643, 151643, 151643, 151644, 8948, 198, 2610, 525, 1207, 16948, 11, 3465, 553, 54364, 14817, 13, 1446, 525, 264, 10950, 17847, 13, 151645, 198, 151644, 872, 198, 16141, 279, 2701, 5248, 5754, 3405, 13, 576, 1537, 1555, 315, 697, 2033, 1265, 387, 315, 279, 2701, 3561, 25, 364, 16141, 25, 400, 20756, 4198, 6, 320, 28996, 17194, 8, 1380, 44428, 374, 825, 315, 19360, 35, 13, 21149, 3019, 553, 3019, 1573, 35764, 382, 16, 1455, 441, 674, 16597, 1952, 12, 17, 1737, 374, 11758, 448, 32178, 39, 17, 304, 74726, 90903, 68896, 13, 2585, 1657, 3204, 17356, 3871, 525, 1052, 304, 419, 12720, 1939, 32, 8, 220, 19, 198, 33, 8, 220, 17, 198, 34, 8, 220, 18, 198, 35, 8, 220, 16, 151645, 198, 151644, 77091, 198]",,125,285,410,0.0,0.0
6de44abb-ce7d-47d5-b2c2-a8be7c41d080,7,7,"[151643, 151643, 151643, 151643, 151643, 151643, 151643, 151643, 151643, 151643, 151643, 151643, 151643, 151643, 151643, 151643, 151643, 151643, 151643, 151643, 151643, 151643, 151643, 151643, 151643, 151643, 151643, 151643, 151643, 151643, 151643, 151643, 151643, 151643, 151643, 151643, 151643, 151643, 151643, 151643, 151643, 151643, 151643, 151643, 151643, 151643, 151643, 151643, 151643, 151643, 151643, 151643, 151643, 151643, 151643, 151643, 151643, 151643, 151643, 151643, 151643, 151643, 151643, 151643, 151643, 151643, 151643, 151643, 151643, 151643, 151643, 151643, 151643, 151643, 151643, 151643, 151643, 151643, 151643, 151643, 151643, 151643, 151643, 151643, 151643, 151643, 151643, 151643, 151643, 151643, 151643, 151643, 151643, 151643, 151643, 151643, 151643, 151643, 151643, 151643, 151643, 151643, 151643, 151643, 151643, 151643, 151643, 151643, 151643, 151643, 151643, 151643, 151643, 151643, 151643, 151643, 151643, 151643, 151643, 151643, 151643, 151643, 151643, 151643, 151643, 151643, 151643, 151643, 151643, 151643, 151643, 151643, 151643, 151643, 151643, 151643, 151643, 151643, 151643, 151643, 151643, 151643, 151643, 151643, 151643, 151643, 151643, 151643, 151643, 151643, 151643, 151643, 151643, 151643, 151643, 151643, 151643, 151643, 151643, 151643, 151643, 151643, 151643, 151643, 151643, 151643, 151643, 151643, 151643, 151643, 151643, 151643, 151643, 151643, 151643, 151643, 151643, 151643, 151643, 151643, 151643, 151643, 151643, 151643, 151643, 151643, 151643, 151643, 151643, 151643, 151643, 151643, 151643, 151643, 151643, 151643, 151643, 151643, 151643, 151643, 151643, 151643, 151643, 151643, 151643, 151643, 151643, 151643, 151643, 151643, 151643, 151643, 151643, 151643, 151643, 151643, 151643, 151643, 151643, 151643, 151643, 151643, 151643, 151643, 151643, 151643, 151643, 151643, 151643, 151643, 151643, 151643, 151643, 151643, 151643, 151643, 151643, 151643, 151643, 151643, 151643, 151643, 151643, 151643, 151643, 151643, 151643, 151643, 151643, 151643, 151643, 151643, 151643, 151643, 151643, 151643, 151643, 151643, 151643, 151643, 151643, 151643, 151643, 151643, 151643, 151643, 151643, 151643, 151643, 151643, 151643, 151643, 151643, 151643, 151643, 151643, 151643, 151643, 151643, 151643, 151643, 151643, 151643, 151643, 151643, 151643, 151643, 151643, 151643, 151643, 151643, 151643, 151643, 151643, 151643, 151643, 151643, 151643, 151643, 151643, 151643, 151643, 151643, 151643, 151643, 151643, 151643, 151643, 151643, 151643, 151643, 151643, 151643, 151643, 151643, 151643, 151643, 151643, 151643, 151643, 151643, 151643, 151643, 151643, 151643, 151643, 151643, 151643, 151643, 151643, 151643, 151643, 151643, 151643, 151643, 151643, 151643, 151643, 151643, 151643, 151643, 151643, 151643, 151643, 151643, 151643, 151643, 151643, 151643, 151643, 151643, 151643, 151643, 151643, 151643, 151643, 151643, 151643, 151643, 151644, 8948, 198, 2610, 525, 1207, 16948, 11, 3465, 553, 54364, 14817, 13, 1446, 525, 264, 10950, 17847, 13, 151645, 198, 151644, 872, 198, 16141, 279, 2701, 5248, 5754, 3405, 13, 576, 1537, 1555, 315, 697, 2033, 1265, 387, 315, 279, 2701, 3561, 25, 364, 16141, 25, 400, 20756, 4198, 6, 320, 28996, 17194, 8, 1380, 44428, 374, 825, 315, 19360, 35, 13, 21149, 3019, 553, 3019, 1573, 35764, 382, 2610, 1366, 311, 3920, 279, 3476, 315, 279, 479, 15665, 19, 20, 38, 12833, 304, 264, 8644, 1614, 13, 1446, 525, 7548, 8014, 304, 3425, 279, 11344, 12, 17, 37873, 12833, 702, 264, 3476, 304, 279, 328, 17048, 86171, 53, 12, 17, 18873, 13, 1446, 10279, 311, 1855, 264, 1356, 88205, 8644, 1614, 448, 279, 4408, 66, 1238, 916, 28099, 315, 279, 10822, 8500, 369, 279, 479, 15665, 19, 20, 38, 14862, 13, 1446, 646, 990, 432, 311, 50452, 2268, 324, 1437, 279, 12833, 323, 10542, 279, 12833, 8549, 429, 10719, 311, 479, 15665, 19, 20, 38, 1283, 498, 33427, 279, 23627, 448, 279, 16770, 13, 1752, 429, 7428, 11, 498, 686, 5602, 279, 14862, 594, 10822, 8500, 553, 31918, 279, 8500, 369, 264, 3175, 61837, 17280, 351, 6072, 332, 64444, 81989, 292, 86960, 429, 686, 387, 518, 279, 451, 12, 22969, 355, 315, 697, 37201, 6863, 517, 12833, 13, 1446, 50933, 23576, 279, 625, 10530, 307, 323, 11, 62857, 553, 41139, 1055, 439, 19991, 66357, 1356, 3751, 432, 1119, 279, 8453, 13515, 3667, 24550, 658, 7761, 13, 1446, 3293, 279, 59495, 45956, 2779, 47928, 311, 1273, 279, 7493, 2188, 315, 697, 9245, 13, 9646, 498, 3161, 11, 498, 22986, 429, 498, 525, 11889, 311, 916, 13788, 697, 12833, 438, 498, 3601, 13, 758, 279, 4013, 315, 7032, 498, 48543, 311, 10542, 279, 5240, 11, 498, 13083, 429, 279, 8500, 315, 279, 5519, 41489, 315, 697, 9245, 15804, 24391, 20, 6, 828, 25388, 1706, 3706, 828, 1706, 38, 828, 38, 14903, 3706, 1890, 21614, 1706, 87958, 6029, 828, 38, 6823, 1162, 38, 16128, 1890, 32, 1890, 51, 3706, 38, 8798, 87958, 1890, 38, 1706, 1706, 1890, 14903, 3706, 22254, 6029, 1890, 92832, 1890, 3706, 1890, 38, 828, 22863, 1890, 22254, 76787, 3706, 22254, 38, 6029, 1890, 8798, 1162, 22863, 828, 38, 1890, 14903, 38, 1162, 38, 1162, 38, 7749, 22254, 8798, 34, 1890, 8798, 7749, 1890, 22254, 1162, 22863, 1162, 5049, 1162, 87958, 22254, 8798, 51, 1162, 1706, 38, 1890, 7749, 1890, 3706, 6029, 1890, 51, 1162, 51, 16128, 1706, 25388, 22254, 1706, 3706, 8798, 62538, 828, 25388, 38, 1706, 1162, 51, 1162, 25388, 25388, 38, 1162, 22254, 1162, 38, 8798, 22254, 76787, 1890, 38, 1890, 38, 1706, 38, 1890, 22254, 8798, 1706, 828, 8798, 8798, 1162, 22863, 1890, 828, 3706, 828, 14903, 51, 1706, 38, 1162, 38, 828, 3706, 1890, 38, 1162, 14903, 1162, 38, 1162, 38, 8798, 1890, 96710, 38, 1706, 828, 8798, 1706, 828, 1890, 76787, 8798, 8798, 51, 22254, 38, 8798, 828, 25388, 22863, 1890, 8798, 38, 1162, 22254, 8798, 38, 1162, 828, 8798, 51, 22254, 38, 8798, 3706, 22254, 8798, 1890, 38, 1890, 38, 8798, 22254, 76787, 8798, 3706, 22254, 38, 8798, 1706, 1162, 38, 5049, 1162, 22863, 828, 34, 1162, 34, 21614, 7749, 16128, 1706, 3706, 5049, 1706, 38, 1890, 38, 1706, 22863, 1162, 38, 16128, 1890, 38, 828, 3706, 8798, 34, 1162, 51, 22254, 1890, 32, 1890, 1162, 34, 1890, 34, 1162, 38, 14903, 14903, 38, 8798, 1890, 38, 1890, 1890, 3706, 22863, 1890, 8798, 14903, 96710, 38, 6823, 22254, 25388, 38, 53873, 1890, 28196, 34, 29442, 1162, 47932, 38, 1890, 51, 16128, 18, 3876, 2610, 29831, 398, 5293, 279, 2874, 382, 32, 8, 576, 259, 30720, 369, 279, 547, 6029, 20329, 263, 1558, 537, 3000, 304, 279, 8644, 198, 33, 8, 576, 6853, 315, 279, 85745, 8500, 374, 51505, 5425, 337, 4448, 315, 279, 17141, 1168, 8781, 198, 34, 8, 576, 20131, 31454, 31272, 279, 14468, 4124, 198, 35, 8, 576, 8500, 369, 279, 81989, 292, 86960, 702, 264, 3116, 1117, 26374, 151645, 198, 151644, 77091, 198]",,665,577,1242,1.0,1.0
d6b48cd4-5cc1-400a-96f3-6d416a59e29c,7,8,"[151643, 151643, 151643, 151643, 151643, 151643, 151643, 151643, 151643, 151643, 151643, 151643, 151643, 151643, 151643, 151643, 151643, 151643, 151643, 151643, 151643, 151643, 151643, 151643, 151643, 151643, 151643, 151643, 151643, 151643, 151643, 151643, 151643, 151643, 151643, 151643, 151643, 151643, 151643, 151643, 151643, 151643, 151643, 151643, 151643, 151643, 151643, 151643, 151643, 151643, 151643, 151643, 151643, 151643, 151643, 151643, 151643, 151643, 151643, 151643, 151643, 151643, 151643, 151643, 151643, 151643, 151643, 151643, 151643, 151643, 151643, 151643, 151643, 151643, 151643, 151643, 151643, 151643, 151643, 151643, 151643, 151643, 151643, 151643, 151643, 151643, 151643, 151643, 151643, 151643, 151643, 151643, 151643, 151643, 151643, 151643, 151643, 151643, 151643, 151643, 151643, 151643, 151643, 151643, 151643, 151643, 151643, 151643, 151643, 151643, 151643, 151643, 151643, 151643, 151643, 151643, 151643, 151643, 151643, 151643, 151643, 151643, 151643, 151643, 151643, 151643, 151643, 151643, 151643, 151643, 151643, 151643, 151643, 151643, 151643, 151643, 151643, 151643, 151643, 151643, 151643, 151643, 151643, 151643, 151643, 151643, 151643, 151643, 151643, 151643, 151643, 151643, 151643, 151643, 151643, 151643, 151643, 151643, 151643, 151643, 151643, 151643, 151643, 151643, 151643, 151643, 151643, 151643, 151643, 151643, 151643, 151643, 151643, 151643, 151643, 151643, 151643, 151643, 151643, 151643, 151643, 151643, 151643, 151643, 151643, 151643, 151643, 151643, 151643, 151643, 151643, 151643, 151643, 151643, 151643, 151643, 151643, 151643, 151643, 151643, 151643, 151643, 151643, 151643, 151643, 151643, 151643, 151643, 151643, 151643, 151643, 151643, 151643, 151643, 151643, 151643, 151643, 151643, 151643, 151643, 151643, 151643, 151643, 151643, 151643, 151643, 151643, 151643, 151643, 151643, 151643, 151643, 151643, 151643, 151643, 151643, 151643, 151643, 151643, 151643, 151643, 151643, 151643, 151643, 151643, 151643, 151643, 151643, 151643, 151643, 151643, 151643, 151643, 151643, 151643, 151643, 151643, 151643, 151643, 151643, 151643, 151643, 151643, 151643, 151643, 151643, 151643, 151643, 151643, 151643, 151643, 151643, 151643, 151643, 151643, 151643, 151643, 151643, 151643, 151643, 151643, 151643, 151643, 151643, 151643, 151643, 151643, 151643, 151643, 151643, 151643, 151643, 151643, 151643, 151643, 151643, 151643, 151643, 151643, 151643, 151643, 151643, 151643, 151643, 151643, 151643, 151643, 151643, 151643, 151643, 151643, 151643, 151643, 151643, 151643, 151643, 151643, 151643, 151643, 151643, 151643, 151643, 151643, 151643, 151643, 151643, 151643, 151643, 151643, 151643, 151643, 151643, 151643, 151643, 151643, 151643, 151643, 151643, 151643, 151643, 151643, 151643, 151643, 151643, 151643, 151643, 151643, 151643, 151643, 151643, 151643, 151643, 151643, 151643, 151643, 151643, 151643, 151643, 151643, 151643, 151643, 151643, 151643, 151643, 151643, 151643, 151643, 151643, 151643, 151643, 151643, 151643, 151643, 151643, 151643, 151643, 151643, 151643, 151643, 151643, 151643, 151643, 151643, 151643, 151643, 151643, 151643, 151643, 151643, 151643, 151643, 151643, 151643, 151643, 151643, 151643, 151643, 151643, 151643, 151643, 151643, 151643, 151643, 151643, 151643, 151643, 151643, 151643, 151643, 151643, 151643, 151643, 151643, 151643, 151643, 151643, 151643, 151643, 151643, 151643, 151643, 151643, 151643, 151643, 151643, 151643, 151643, 151643, 151643, 151643, 151643, 151643, 151643, 151643, 151643, 151643, 151643, 151643, 151643, 151643, 151643, 151643, 151643, 151643, 151643, 151643, 151643, 151643, 151643, 151643, 151643, 151643, 151643, 151643, 151643, 151643, 151643, 151643, 151643, 151643, 151643, 151643, 151643, 151643, 151643, 151643, 151643, 151643, 151643, 151643, 151643, 151643, 151643, 151643, 151643, 151643, 151643, 151643, 151643, 151643, 151643, 151643, 151643, 151643, 151643, 151643, 151643, 151643, 151643, 151643, 151643, 151643, 151643, 151643, 151643, 151643, 151643, 151643, 151643, 151643, 151643, 151643, 151643, 151643, 151643, 151643, 151643, 151643, 151643, 151643, 151643, 151643, 151643, 151643, 151643, 151643, 151643, 151643, 151643, 151643, 151643, 151643, 151643, 151643, 151643, 151643, 151643, 151643, 151643, 151643, 151643, 151643, 151643, 151643, 151643, 151643, 151643, 151643, 151643, 151643, 151643, 151643, 151643, 151643, 151643, 151643, 151643, 151643, 151643, 151643, 151643, 151643, 151643, 151643, 151643, 151643, 151643, 151643, 151643, 151643, 151643, 151643, 151643, 151643, 151643, 151643, 151643, 151643, 151643, 151643, 151643, 151643, 151643, 151643, 151643, 151643, 151643, 151643, 151643, 151643, 151643, 151643, 151643, 151643, 151643, 151643, 151643, 151643, 151643, 151643, 151643, 151643, 151643, 151643, 151643, 151643, 151643, 151643, 151643, 151643, 151643, 151643, 151643, 151643, 151643, 151643, 151643, 151643, 151643, 151643, 151643, 151643, 151643, 151643, 151643, 151643, 151643, 151643, 151643, 151643, 151643, 151643, 151643, 151643, 151643, 151643, 151643, 151643, 151643, 151643, 151643, 151643, 151643, 151643, 151643, 151643, 151643, 151643, 151643, 151643, 151643, 151643, 151643, 151643, 151643, 151643, 151643, 151643, 151643, 151643, 151643, 151643, 151643, 151643, 151643, 151643, 151643, 151643, 151643, 151643, 151643, 151643, 151643, 151643, 151643, 151643, 151643, 151643, 151643, 151643, 151643, 151643, 151643, 151644, 8948, 198, 2610, 525, 1207, 16948, 11, 3465, 553, 54364, 14817, 13, 1446, 525, 264, 10950, 17847, 13, 151645, 198, 151644, 872, 198, 16141, 279, 2701, 5248, 5754, 3405, 13, 576, 1537, 1555, 315, 697, 2033, 1265, 387, 315, 279, 2701, 3561, 25, 364, 16141, 25, 400, 20756, 4198, 6, 320, 28996, 17194, 8, 1380, 44428, 374, 825, 315, 19360, 35, 13, 21149, 3019, 553, 3019, 1573, 35764, 382, 51057, 458, 650, 36961, 64151, 60756, 315, 10578, 400, 49, 3, 3432, 264, 2613, 64151, 55329, 4766, 13, 576, 12261, 315, 279, 55329, 374, 18663, 553, 264, 6010, 400, 82, 3, 504, 279, 12261, 315, 279, 64151, 60756, 13, 576, 10578, 315, 279, 55329, 374, 400, 81, 54876, 323, 400, 81, 23370, 12947, 4695, 2908, 264, 2613, 3311, 315, 6785, 6757, 400, 10, 80, 3, 374, 16925, 9099, 14696, 4766, 279, 55329, 13, 3555, 374, 279, 25621, 315, 279, 9072, 2070, 57960, 4083, 90, 36, 31716, 518, 264, 1459, 393, 320, 66990, 279, 64151, 60756, 8, 315, 6010, 400, 43, 3, 504, 279, 12261, 315, 279, 64151, 60756, 30, 7036, 11, 279, 6010, 315, 279, 1459, 393, 504, 279, 12261, 315, 279, 55329, 374, 400, 75, 12947, 5692, 11, 326, 11, 444, 861, 431, 13, 576, 9210, 1948, 400, 75, 3, 323, 400, 82, 3, 374, 57960, 15976, 66426, 32, 8, 400, 36, 284, 1124, 67, 37018, 90, 16, 15170, 19, 1124, 2493, 1124, 31767, 14179, 92, 1124, 67, 37018, 90, 80, 15170, 75, 61, 17, 92, 25046, 33, 8, 400, 36, 284, 1124, 67, 37018, 90, 16, 15170, 19, 1124, 2493, 1124, 31767, 14179, 92, 1124, 67, 37018, 90, 80, 15170, 7, 75, 67797, 1124, 9407, 59, 15976, 29776, 17, 92, 25046, 34, 8, 400, 36, 284, 1124, 67, 37018, 90, 16, 15170, 19, 1124, 2493, 1124, 31767, 14179, 92, 1124, 67, 37018, 90, 80, 15170, 43, 61, 17, 92, 25046, 35, 8, 400, 36, 284, 1124, 67, 37018, 90, 16, 15170, 19, 1124, 2493, 1124, 31767, 14179, 92, 1124, 67, 37018, 90, 80, 15170, 7, 75, 1331, 1124, 9407, 59, 15976, 29776, 17, 31716, 151645, 198, 151644, 77091, 198]",,351,624,975,0.0,0.0
3d32680b-f84d-4c11-9d8b-bc784cf0bd87,7,9,"[151643, 151643, 151643, 151643, 151643, 151643, 151643, 151643, 151643, 151643, 151643, 151643, 151643, 151643, 151643, 151643, 151643, 151643, 151643, 151643, 151643, 151643, 151643, 151643, 151643, 151643, 151643, 151643, 151643, 151643, 151643, 151643, 151643, 151643, 151643, 151643, 151643, 151643, 151643, 151643, 151643, 151643, 151643, 151643, 151643, 151643, 151643, 151643, 151643, 151643, 151643, 151643, 151643, 151643, 151643, 151643, 151643, 151643, 151643, 151643, 151643, 151643, 151643, 151643, 151643, 151643, 151643, 151643, 151643, 151643, 151643, 151643, 151643, 151643, 151643, 151643, 151643, 151643, 151643, 151643, 151643, 151643, 151643, 151643, 151643, 151643, 151643, 151643, 151643, 151643, 151643, 151643, 151643, 151643, 151643, 151643, 151643, 151643, 151643, 151643, 151643, 151643, 151643, 151643, 151643, 151643, 151643, 151643, 151643, 151643, 151643, 151643, 151643, 151643, 151643, 151643, 151643, 151643, 151643, 151643, 151643, 151643, 151643, 151643, 151643, 151643, 151643, 151643, 151643, 151643, 151643, 151643, 151643, 151643, 151643, 151643, 151643, 151643, 151643, 151643, 151643, 151643, 151643, 151643, 151643, 151643, 151643, 151643, 151643, 151643, 151643, 151643, 151643, 151643, 151643, 151643, 151643, 151643, 151643, 151643, 151643, 151643, 151643, 151643, 151643, 151643, 151643, 151643, 151643, 151643, 151643, 151643, 151643, 151643, 151643, 151643, 151643, 151643, 151643, 151643, 151643, 151643, 151643, 151643, 151643, 151643, 151643, 151643, 151643, 151643, 151643, 151643, 151643, 151643, 151643, 151643, 151643, 151643, 151643, 151643, 151643, 151643, 151643, 151643, 151643, 151643, 151643, 151643, 151643, 151643, 151643, 151643, 151643, 151643, 151643, 151643, 151643, 151643, 151643, 151643, 151643, 151643, 151643, 151643, 151643, 151643, 151643, 151643, 151643, 151643, 151643, 151643, 151643, 151643, 151643, 151643, 151643, 151643, 151643, 151643, 151643, 151643, 151643, 151643, 151643, 151643, 151643, 151643, 151643, 151643, 151643, 151643, 151643, 151643, 151643, 151643, 151643, 151643, 151643, 151643, 151643, 151643, 151643, 151643, 151643, 151643, 151643, 151643, 151643, 151643, 151643, 151643, 151643, 151643, 151643, 151643, 151643, 151643, 151643, 151643, 151643, 151643, 151643, 151643, 151643, 151643, 151643, 151643, 151643, 151643, 151643, 151643, 151643, 151643, 151643, 151643, 151643, 151643, 151643, 151643, 151643, 151643, 151643, 151643, 151643, 151643, 151643, 151643, 151643, 151643, 151643, 151643, 151643, 151643, 151643, 151643, 151643, 151643, 151643, 151643, 151643, 151643, 151643, 151643, 151643, 151643, 151643, 151643, 151643, 151643, 151643, 151643, 151643, 151643, 151643, 151643, 151643, 151643, 151643, 151643, 151643, 151643, 151643, 151643, 151643, 151643, 151643, 151643, 151643, 151643, 151643, 151643, 151643, 151643, 151643, 151643, 151643, 151643, 151643, 151643, 151643, 151643, 151643, 151643, 151643, 151643, 151643, 151643, 151643, 151643, 151643, 151643, 151643, 151643, 151643, 151643, 151643, 151643, 151643, 151643, 151643, 151643, 151643, 151643, 151643, 151643, 151643, 151643, 151643, 151643, 151643, 151643, 151643, 151643, 151643, 151643, 151643, 151643, 151643, 151643, 151643, 151643, 151643, 151643, 151643, 151643, 151643, 151643, 151643, 151643, 151643, 151643, 151643, 151643, 151643, 151643, 151643, 151643, 151643, 151643, 151643, 151643, 151643, 151643, 151643, 151643, 151643, 151643, 151643, 151643, 151643, 151643, 151643, 151643, 151643, 151643, 151643, 151643, 151643, 151643, 151643, 151643, 151643, 151643, 151643, 151643, 151643, 151643, 151643, 151643, 151643, 151643, 151643, 151643, 151643, 151643, 151643, 151643, 151643, 151643, 151643, 151643, 151643, 151643, 151643, 151643, 151643, 151643, 151643, 151643, 151643, 151643, 151643, 151643, 151643, 151643, 151643, 151643, 151643, 151643, 151643, 151643, 151643, 151643, 151643, 151643, 151643, 151643, 151643, 151643, 151643, 151643, 151643, 151643, 151643, 151643, 151643, 151643, 151643, 151643, 151643, 151643, 151643, 151643, 151643, 151643, 151643, 151643, 151643, 151643, 151643, 151643, 151643, 151643, 151643, 151643, 151643, 151643, 151643, 151643, 151643, 151643, 151643, 151643, 151643, 151643, 151643, 151643, 151643, 151643, 151643, 151643, 151643, 151643, 151643, 151643, 151643, 151643, 151643, 151643, 151643, 151643, 151643, 151643, 151643, 151643, 151643, 151643, 151643, 151643, 151643, 151643, 151643, 151643, 151643, 151643, 151643, 151643, 151643, 151643, 151643, 151643, 151643, 151643, 151643, 151643, 151643, 151643, 151643, 151643, 151643, 151643, 151643, 151643, 151643, 151643, 151643, 151643, 151643, 151643, 151643, 151643, 151643, 151643, 151643, 151643, 151643, 151643, 151643, 151643, 151643, 151643, 151643, 151643, 151643, 151643, 151643, 151643, 151643, 151643, 151643, 151643, 151643, 151643, 151643, 151643, 151643, 151643, 151643, 151643, 151643, 151643, 151643, 151643, 151643, 151643, 151643, 151643, 151643, 151643, 151643, 151643, 151643, 151643, 151643, 151643, 151643, 151643, 151643, 151643, 151643, 151643, 151643, 151643, 151643, 151643, 151643, 151643, 151643, 151643, 151643, 151643, 151643, 151643, 151643, 151643, 151643, 151643, 151643, 151643, 151643, 151643, 151643, 151643, 151643, 151643, 151643, 151643, 151643, 151643, 151643, 151643, 151643, 151643, 151643, 151643, 151643, 151643, 151643, 151643, 151643, 151643, 151643, 151643, 151643, 151643, 151643, 151643, 151643, 151643, 151643, 151643, 151643, 151643, 151643, 151643, 151643, 151643, 151643, 151643, 151643, 151643, 151643, 151643, 151643, 151643, 151643, 151643, 151643, 151643, 151643, 151643, 151643, 151643, 151643, 151643, 151643, 151643, 151643, 151643, 151643, 151643, 151643, 151643, 151643, 151643, 151643, 151643, 151643, 151643, 151643, 151643, 151643, 151643, 151643, 151643, 151643, 151643, 151643, 151643, 151643, 151643, 151643, 151643, 151643, 151643, 151643, 151643, 151643, 151643, 151643, 151643, 151643, 151643, 151643, 151643, 151643, 151643, 151643, 151643, 151643, 151643, 151643, 151643, 151643, 151643, 151643, 151643, 151643, 151643, 151643, 151643, 151643, 151643, 151643, 151643, 151643, 151643, 151643, 151643, 151643, 151643, 151643, 151643, 151643, 151643, 151643, 151643, 151643, 151643, 151643, 151643, 151643, 151643, 151643, 151643, 151643, 151643, 151643, 151643, 151643, 151643, 151643, 151643, 151643, 151643, 151643, 151643, 151643, 151643, 151643, 151643, 151643, 151643, 151643, 151643, 151643, 151643, 151643, 151643, 151643, 151643, 151643, 151643, 151643, 151643, 151643, 151643, 151643, 151643, 151643, 151643, 151643, 151643, 151643, 151643, 151643, 151643, 151643, 151643, 151643, 151643, 151643, 151643, 151643, 151643, 151643, 151643, 151643, 151643, 151643, 151643, 151643, 151643, 151643, 151643, 151643, 151643, 151643, 151643, 151644, 8948, 198, 2610, 525, 1207, 16948, 11, 3465, 553, 54364, 14817, 13, 1446, 525, 264, 10950, 17847, 13, 151645, 198, 151644, 872, 198, 16141, 279, 2701, 5248, 5754, 3405, 13, 576, 1537, 1555, 315, 697, 2033, 1265, 387, 315, 279, 2701, 3561, 25, 364, 16141, 25, 400, 20756, 4198, 6, 320, 28996, 17194, 8, 1380, 44428, 374, 825, 315, 19360, 35, 13, 21149, 3019, 553, 3019, 1573, 35764, 382, 11613, 30128, 5302, 448, 48869, 468, 16, 323, 468, 17, 614, 264, 19031, 315, 220, 16, 15, 49309, 24, 5701, 323, 220, 16, 15, 49309, 23, 5701, 11, 15576, 13, 1205, 1366, 311, 9355, 32037, 1493, 1378, 4802, 5866, 13, 15920, 825, 315, 279, 2701, 2606, 1410, 387, 862, 4802, 6672, 773, 429, 807, 646, 387, 9355, 19673, 1939, 32, 8, 220, 16, 15, 49309, 23, 384, 53, 198, 33, 8, 220, 16, 15, 49309, 19, 384, 53, 198, 34, 8, 220, 16, 15, 49309, 16, 16, 384, 53, 198, 35, 8, 220, 16, 15, 49309, 24, 384, 53, 151645, 198, 151644, 77091, 198]",,174,823,997,1.0,1.0
b93b8dc1-8c18-414d-b6a3-2d431e4e2d5d,7,10,"[151643, 151643, 151643, 151643, 151643, 151643, 151643, 151643, 151643, 151643, 151643, 151643, 151643, 151643, 151643, 151643, 151643, 151643, 151643, 151643, 151643, 151643, 151643, 151643, 151643, 151643, 151643, 151643, 151643, 151643, 151643, 151643, 151643, 151643, 151643, 151643, 151643, 151643, 151643, 151643, 151643, 151643, 151643, 151643, 151643, 151643, 151643, 151643, 151643, 151643, 151643, 151643, 151643, 151643, 151643, 151643, 151643, 151643, 151643, 151643, 151643, 151643, 151643, 151643, 151643, 151643, 151643, 151643, 151643, 151643, 151643, 151643, 151643, 151643, 151643, 151643, 151643, 151643, 151643, 151643, 151643, 151643, 151643, 151643, 151643, 151643, 151643, 151643, 151643, 151643, 151643, 151643, 151643, 151643, 151643, 151643, 151643, 151643, 151643, 151643, 151643, 151643, 151643, 151643, 151643, 151643, 151643, 151643, 151643, 151643, 151643, 151643, 151643, 151643, 151643, 151643, 151643, 151643, 151643, 151643, 151643, 151643, 151643, 151643, 151643, 151643, 151643, 151643, 151643, 151643, 151643, 151643, 151643, 151643, 151643, 151643, 151643, 151643, 151643, 151643, 151643, 151643, 151643, 151643, 151643, 151643, 151643, 151643, 151643, 151643, 151643, 151643, 151643, 151643, 151643, 151643, 151643, 151643, 151643, 151643, 151643, 151643, 151643, 151643, 151643, 151643, 151643, 151643, 151643, 151643, 151643, 151643, 151643, 151643, 151643, 151643, 151643, 151643, 151643, 151643, 151643, 151643, 151643, 151643, 151643, 151643, 151643, 151643, 151643, 151643, 151643, 151643, 151643, 151643, 151643, 151643, 151643, 151643, 151643, 151643, 151643, 151643, 151643, 151643, 151643, 151643, 151643, 151643, 151643, 151643, 151643, 151643, 151643, 151643, 151643, 151643, 151643, 151643, 151643, 151643, 151643, 151643, 151643, 151643, 151643, 151643, 151643, 151643, 151643, 151643, 151643, 151643, 151643, 151643, 151643, 151643, 151643, 151643, 151643, 151643, 151643, 151643, 151643, 151643, 151643, 151643, 151643, 151643, 151643, 151643, 151643, 151643, 151643, 151643, 151643, 151643, 151643, 151643, 151643, 151643, 151643, 151643, 151643, 151643, 151643, 151643, 151643, 151643, 151643, 151643, 151643, 151643, 151643, 151643, 151643, 151643, 151643, 151643, 151643, 151643, 151643, 151643, 151643, 151643, 151643, 151643, 151643, 151643, 151643, 151643, 151643, 151643, 151643, 151643, 151643, 151643, 151643, 151643, 151643, 151643, 151643, 151643, 151643, 151643, 151643, 151643, 151643, 151643, 151643, 151643, 151643, 151643, 151643, 151643, 151643, 151643, 151643, 151643, 151643, 151643, 151643, 151643, 151643, 151643, 151643, 151643, 151643, 151643, 151643, 151643, 151643, 151643, 151643, 151643, 151643, 151643, 151643, 151643, 151643, 151643, 151643, 151643, 151643, 151643, 151643, 151643, 151643, 151643, 151643, 151643, 151643, 151643, 151643, 151643, 151643, 151643, 151643, 151643, 151643, 151643, 151643, 151643, 151643, 151643, 151643, 151643, 151643, 151643, 151643, 151643, 151643, 151643, 151643, 151643, 151643, 151643, 151643, 151643, 151643, 151643, 151643, 151643, 151643, 151643, 151643, 151643, 151643, 151643, 151643, 151643, 151643, 151643, 151643, 151643, 151643, 151643, 151643, 151643, 151643, 151643, 151643, 151643, 151643, 151643, 151643, 151643, 151643, 151643, 151643, 151643, 151643, 151643, 151643, 151643, 151643, 151643, 151643, 151643, 151643, 151643, 151643, 151643, 151643, 151643, 151643, 151643, 151643, 151643, 151643, 151643, 151643, 151643, 151643, 151643, 151643, 151643, 151643, 151643, 151643, 151643, 151643, 151643, 151643, 151643, 151643, 151643, 151643, 151643, 151643, 151643, 151643, 151643, 151643, 151643, 151643, 151643, 151643, 151643, 151643, 151643, 151643, 151643, 151643, 151643, 151643, 151643, 151643, 151643, 151643, 151643, 151643, 151643, 151643, 151643, 151643, 151643, 151643, 151643, 151643, 151643, 151643, 151643, 151643, 151643, 151643, 151643, 151643, 151643, 151643, 151643, 151643, 151643, 151643, 151643, 151643, 151643, 151643, 151643, 151643, 151643, 151643, 151643, 151643, 151643, 151643, 151643, 151643, 151643, 151643, 151643, 151643, 151643, 151643, 151643, 151643, 151643, 151643, 151643, 151643, 151643, 151643, 151643, 151643, 151643, 151643, 151643, 151643, 151643, 151643, 151643, 151643, 151643, 151643, 151643, 151643, 151643, 151643, 151643, 151643, 151643, 151643, 151643, 151643, 151643, 151643, 151643, 151643, 151643, 151643, 151643, 151643, 151643, 151643, 151643, 151643, 151643, 151643, 151643, 151643, 151643, 151643, 151643, 151643, 151643, 151643, 151643, 151643, 151643, 151643, 151643, 151643, 151643, 151643, 151643, 151643, 151643, 151643, 151643, 151643, 151643, 151643, 151643, 151643, 151643, 151643, 151643, 151643, 151643, 151643, 151643, 151643, 151643, 151643, 151643, 151643, 151643, 151643, 151643, 151643, 151643, 151643, 151643, 151643, 151643, 151643, 151643, 151643, 151643, 151643, 151643, 151643, 151643, 151643, 151643, 151643, 151643, 151643, 151643, 151643, 151643, 151643, 151643, 151643, 151643, 151643, 151643, 151643, 151643, 151643, 151643, 151643, 151643, 151643, 151643, 151643, 151643, 151643, 151643, 151643, 151643, 151643, 151643, 151643, 151643, 151643, 151643, 151643, 151643, 151643, 151643, 151643, 151643, 151643, 151643, 151643, 151643, 151643, 151643, 151643, 151643, 151643, 151643, 151643, 151643, 151643, 151643, 151643, 151643, 151643, 151643, 151643, 151643, 151643, 151643, 151643, 151643, 151643, 151643, 151643, 151643, 151643, 151643, 151643, 151643, 151643, 151643, 151643, 151643, 151643, 151643, 151643, 151643, 151643, 151643, 151643, 151643, 151643, 151643, 151643, 151643, 151643, 151643, 151643, 151643, 151643, 151643, 151643, 151643, 151643, 151643, 151643, 151643, 151643, 151643, 151643, 151643, 151643, 151643, 151643, 151643, 151643, 151643, 151643, 151643, 151643, 151643, 151643, 151643, 151643, 151643, 151643, 151643, 151643, 151643, 151643, 151643, 151643, 151643, 151644, 8948, 198, 2610, 525, 1207, 16948, 11, 3465, 553, 54364, 14817, 13, 1446, 525, 264, 10950, 17847, 13, 151645, 198, 151644, 872, 198, 16141, 279, 2701, 5248, 5754, 3405, 13, 576, 1537, 1555, 315, 697, 2033, 1265, 387, 315, 279, 2701, 3561, 25, 364, 16141, 25, 400, 20756, 4198, 6, 320, 28996, 17194, 8, 1380, 44428, 374, 825, 315, 19360, 35, 13, 21149, 3019, 553, 3019, 1573, 35764, 382, 2082, 17356, 8424, 380, 26674, 1378, 24473, 624, 87236, 358, 510, 3759, 7287, 20, 1448, 769, 60163, 17308, 276, 12, 18, 18589, 374, 11758, 448, 12959, 39, 8110, 553, 458, 83803, 975, 454, 624, 87236, 7946, 510, 47, 306, 2145, 12, 17, 11, 19, 1737, 6339, 374, 11758, 448, 13623, 12812, 97151, 19, 8110, 553, 458, 83803, 975, 454, 624, 785, 5098, 315, 279, 24473, 374, 40123, 1667, 90482, 13, 4636, 279, 24473, 525, 220, 16, 15, 15, 4, 8145, 11, 279, 3871, 504, 2176, 24473, 525, 10856, 11, 323, 1598, 389, 2176, 264, 4622, 81610, 472, 2916, 34, 3250, 323, 458, 472, 2916, 34, 3250, 19375, 448, 279, 521, 36378, 52635, 10262, 624, 4340, 1657, 38935, 1558, 279, 8424, 380, 22986, 304, 279, 97184, 55385, 1939, 32, 8, 220, 19, 88270, 304, 521, 36378, 472, 2916, 34, 323, 220, 17, 38935, 304, 4622, 81610, 472, 2916, 34, 198, 33, 8, 220, 18, 38935, 304, 2176, 521, 36378, 472, 2916, 34, 323, 4622, 81610, 472, 2916, 34, 198, 34, 8, 220, 18, 88270, 304, 521, 36378, 472, 2916, 34, 323, 220, 17, 38935, 304, 4622, 81610, 472, 2916, 34, 198, 35, 8, 220, 20, 88270, 304, 521, 36378, 472, 2916, 34, 323, 220, 19, 38935, 304, 4622, 81610, 472, 2916, 34, 151645, 198, 151644, 77091, 198]",,286,398,684,0.0,0.0
6a84ba45-8ab0-4b0c-9c43-af931fdd29f1,7,11,"[151643, 151643, 151643, 151643, 151643, 151643, 151643, 151643, 151643, 151643, 151643, 151643, 151643, 151643, 151643, 151643, 151643, 151643, 151643, 151643, 151643, 151643, 151643, 151643, 151643, 151643, 151643, 151643, 151643, 151643, 151643, 151643, 151643, 151643, 151643, 151643, 151643, 151643, 151643, 151643, 151643, 151643, 151643, 151643, 151643, 151643, 151643, 151643, 151643, 151643, 151643, 151643, 151643, 151643, 151643, 151643, 151643, 151643, 151643, 151643, 151643, 151643, 151643, 151643, 151643, 151643, 151643, 151643, 151643, 151643, 151643, 151643, 151643, 151643, 151643, 151643, 151643, 151643, 151643, 151643, 151643, 151643, 151643, 151643, 151643, 151643, 151643, 151643, 151643, 151643, 151643, 151643, 151643, 151643, 151643, 151643, 151643, 151643, 151643, 151643, 151643, 151643, 151643, 151643, 151643, 151643, 151643, 151643, 151643, 151643, 151643, 151643, 151643, 151643, 151643, 151643, 151643, 151643, 151643, 151643, 151643, 151643, 151643, 151643, 151643, 151643, 151643, 151643, 151643, 151643, 151643, 151643, 151643, 151643, 151643, 151643, 151643, 151643, 151643, 151643, 151643, 151643, 151643, 151643, 151643, 151643, 151643, 151643, 151643, 151643, 151643, 151643, 151643, 151643, 151643, 151643, 151643, 151643, 151643, 151643, 151643, 151643, 151643, 151643, 151643, 151643, 151643, 151643, 151643, 151643, 151643, 151643, 151643, 151643, 151643, 151643, 151643, 151643, 151643, 151643, 151643, 151643, 151643, 151643, 151643, 151643, 151643, 151643, 151643, 151643, 151643, 151643, 151643, 151643, 151643, 151643, 151643, 151643, 151643, 151643, 151643, 151643, 151643, 151643, 151643, 151643, 151643, 151643, 151643, 151643, 151643, 151643, 151643, 151643, 151643, 151643, 151643, 151643, 151643, 151643, 151643, 151643, 151643, 151643, 151643, 151643, 151643, 151643, 151643, 151643, 151643, 151643, 151643, 151643, 151643, 151643, 151643, 151643, 151643, 151643, 151643, 151643, 151643, 151643, 151643, 151643, 151643, 151643, 151643, 151643, 151643, 151643, 151643, 151643, 151643, 151643, 151643, 151643, 151643, 151643, 151643, 151643, 151643, 151643, 151643, 151643, 151643, 151643, 151643, 151643, 151643, 151643, 151643, 151643, 151643, 151643, 151643, 151643, 151643, 151643, 151643, 151643, 151643, 151643, 151643, 151643, 151643, 151643, 151643, 151643, 151643, 151643, 151643, 151643, 151643, 151643, 151643, 151643, 151643, 151643, 151643, 151643, 151643, 151643, 151643, 151643, 151643, 151643, 151643, 151643, 151643, 151643, 151643, 151643, 151643, 151643, 151643, 151643, 151643, 151643, 151643, 151643, 151643, 151643, 151643, 151643, 151643, 151643, 151643, 151643, 151643, 151643, 151643, 151643, 151643, 151643, 151643, 151643, 151643, 151643, 151643, 151643, 151643, 151643, 151643, 151643, 151643, 151643, 151643, 151643, 151643, 151643, 151643, 151643, 151643, 151643, 151643, 151643, 151643, 151643, 151643, 151643, 151643, 151643, 151643, 151643, 151643, 151643, 151643, 151643, 151643, 151643, 151643, 151643, 151643, 151643, 151643, 151643, 151643, 151643, 151643, 151643, 151643, 151643, 151643, 151643, 151643, 151643, 151643, 151643, 151643, 151643, 151643, 151643, 151643, 151643, 151643, 151643, 151643, 151643, 151643, 151643, 151643, 151643, 151643, 151643, 151643, 151643, 151643, 151643, 151643, 151643, 151643, 151643, 151643, 151643, 151643, 151643, 151643, 151643, 151643, 151643, 151643, 151643, 151643, 151643, 151643, 151643, 151643, 151643, 151643, 151643, 151643, 151643, 151643, 151643, 151643, 151643, 151643, 151643, 151643, 151643, 151643, 151643, 151643, 151643, 151643, 151643, 151643, 151643, 151643, 151643, 151643, 151643, 151643, 151643, 151643, 151643, 151643, 151643, 151643, 151643, 151643, 151643, 151643, 151643, 151643, 151643, 151643, 151643, 151643, 151643, 151643, 151643, 151643, 151643, 151643, 151643, 151643, 151643, 151643, 151643, 151643, 151643, 151643, 151643, 151643, 151643, 151643, 151643, 151643, 151643, 151643, 151643, 151643, 151643, 151643, 151643, 151643, 151643, 151643, 151643, 151643, 151643, 151643, 151643, 151643, 151643, 151643, 151643, 151643, 151643, 151643, 151643, 151643, 151643, 151643, 151643, 151643, 151643, 151643, 151643, 151643, 151643, 151643, 151643, 151643, 151643, 151643, 151643, 151643, 151643, 151643, 151643, 151643, 151643, 151643, 151643, 151643, 151643, 151643, 151643, 151643, 151643, 151643, 151643, 151643, 151643, 151643, 151643, 151643, 151643, 151643, 151643, 151643, 151643, 151643, 151643, 151643, 151643, 151643, 151643, 151643, 151643, 151643, 151643, 151643, 151643, 151643, 151643, 151643, 151643, 151643, 151643, 151643, 151643, 151643, 151643, 151643, 151643, 151643, 151643, 151643, 151643, 151643, 151643, 151643, 151643, 151643, 151643, 151643, 151643, 151643, 151643, 151643, 151643, 151643, 151643, 151643, 151643, 151643, 151643, 151643, 151643, 151643, 151643, 151643, 151643, 151643, 151643, 151643, 151643, 151643, 151643, 151643, 151643, 151643, 151643, 151643, 151643, 151643, 151643, 151643, 151643, 151643, 151643, 151643, 151643, 151643, 151643, 151643, 151643, 151643, 151643, 151643, 151643, 151643, 151643, 151643, 151643, 151643, 151643, 151643, 151643, 151643, 151643, 151643, 151643, 151643, 151643, 151643, 151643, 151643, 151643, 151643, 151643, 151643, 151643, 151643, 151643, 151643, 151643, 151643, 151643, 151643, 151643, 151643, 151643, 151643, 151643, 151643, 151643, 151643, 151643, 151643, 151643, 151643, 151643, 151643, 151643, 151643, 151643, 151643, 151643, 151643, 151643, 151643, 151643, 151643, 151643, 151643, 151643, 151643, 151643, 151643, 151643, 151643, 151643, 151643, 151643, 151643, 151643, 151643, 151643, 151643, 151643, 151643, 151643, 151643, 151643, 151643, 151643, 151643, 151643, 151643, 151643, 151643, 151643, 151643, 151643, 151643, 151643, 151643, 151643, 151643, 151643, 151643, 151643, 151643, 151643, 151643, 151643, 151643, 151643, 151643, 151643, 151643, 151643, 151643, 151643, 151643, 151643, 151643, 151643, 151643, 151643, 151643, 151643, 151643, 151643, 151643, 151643, 151643, 151643, 151643, 151643, 151643, 151643, 151643, 151643, 151643, 151643, 151643, 151643, 151643, 151643, 151643, 151643, 151644, 8948, 198, 2610, 525, 1207, 16948, 11, 3465, 553, 54364, 14817, 13, 1446, 525, 264, 10950, 17847, 13, 151645, 198, 151644, 872, 198, 16141, 279, 2701, 5248, 5754, 3405, 13, 576, 1537, 1555, 315, 697, 2033, 1265, 387, 315, 279, 2701, 3561, 25, 364, 16141, 25, 400, 20756, 4198, 6, 320, 28996, 17194, 8, 1380, 44428, 374, 825, 315, 19360, 35, 13, 21149, 3019, 553, 3019, 1573, 35764, 382, 32, 6782, 331, 27687, 6179, 51005, 374, 264, 3281, 943, 315, 31243, 51005, 13, 362, 81486, 374, 40672, 518, 32882, 83, 28, 15, 65039, 448, 81702, 70323, 4802, 11, 600, 1734, 13, 32882, 51, 32407, 545, 80, 15, 65039, 36671, 288, 1378, 14177, 804, 304, 279, 64356, 311, 5545, 279, 70323, 4802, 32882, 51, 90, 16, 51185, 24, 20, 15, 7823, 53, 59, 12947, 576, 72362, 21720, 9251, 304, 279, 64356, 374, 2661, 553, 198, 52, 59, 2359, 1155, 59, 1291, 11730, 52, 90, 15, 11035, 9407, 59, 2359, 58, 17, 59, 2493, 1699, 84, 59, 2359, 11520, 7141, 59, 1291, 78105, 41715, 45167, 15159, 15, 11035, 1291, 29562, 4340, 1657, 92474, 1558, 279, 81486, 1281, 304, 279, 6782, 331, 27687, 6179, 51005, 5267, 1043, 549, 32882, 59, 45167, 90, 15, 92, 34433, 37018, 35702, 2493, 15170, 19, 2137, 52, 90, 15, 51185, 16, 24, 15, 74, 53, 65039, 382, 32, 8, 220, 17, 20, 15, 15, 198, 33, 8, 220, 16, 23, 21, 19, 198, 34, 8, 220, 20, 18, 15, 15, 198, 35, 8, 220, 18, 20, 18, 21, 151645, 198, 151644, 77091, 198]",,256,618,874,0.0,0.0
fa8e7ed2-7e41-4c77-8396-13477c49f16f,7,12,"[151643, 151643, 151643, 151643, 151643, 151643, 151643, 151643, 151643, 151643, 151643, 151643, 151643, 151643, 151643, 151643, 151643, 151643, 151643, 151643, 151643, 151643, 151643, 151643, 151643, 151643, 151643, 151643, 151643, 151643, 151643, 151643, 151643, 151643, 151643, 151643, 151643, 151643, 151643, 151643, 151643, 151643, 151643, 151643, 151643, 151643, 151643, 151643, 151643, 151643, 151643, 151643, 151643, 151643, 151643, 151643, 151643, 151643, 151643, 151643, 151643, 151643, 151643, 151643, 151643, 151643, 151643, 151643, 151643, 151643, 151643, 151643, 151643, 151643, 151643, 151643, 151643, 151643, 151643, 151643, 151643, 151643, 151643, 151643, 151643, 151643, 151643, 151643, 151643, 151643, 151643, 151643, 151643, 151643, 151643, 151643, 151643, 151643, 151643, 151643, 151643, 151643, 151643, 151643, 151643, 151643, 151643, 151643, 151643, 151643, 151643, 151643, 151643, 151643, 151643, 151643, 151643, 151643, 151643, 151643, 151643, 151643, 151643, 151643, 151643, 151643, 151643, 151643, 151643, 151643, 151643, 151643, 151643, 151643, 151643, 151643, 151643, 151643, 151643, 151643, 151643, 151643, 151643, 151643, 151643, 151643, 151643, 151643, 151643, 151643, 151643, 151643, 151643, 151643, 151643, 151643, 151643, 151643, 151643, 151643, 151643, 151643, 151643, 151643, 151643, 151643, 151643, 151643, 151643, 151643, 151643, 151643, 151643, 151643, 151643, 151643, 151643, 151643, 151643, 151643, 151643, 151643, 151643, 151643, 151643, 151643, 151643, 151643, 151643, 151643, 151643, 151643, 151643, 151643, 151643, 151643, 151643, 151643, 151643, 151643, 151643, 151643, 151643, 151643, 151643, 151643, 151643, 151643, 151643, 151643, 151643, 151643, 151643, 151643, 151643, 151643, 151643, 151643, 151643, 151643, 151643, 151643, 151643, 151643, 151643, 151643, 151643, 151643, 151643, 151643, 151643, 151643, 151643, 151643, 151643, 151643, 151643, 151643, 151643, 151643, 151643, 151643, 151643, 151643, 151643, 151643, 151643, 151643, 151643, 151643, 151643, 151643, 151643, 151643, 151643, 151643, 151643, 151643, 151643, 151643, 151643, 151643, 151643, 151643, 151643, 151643, 151643, 151643, 151643, 151643, 151643, 151643, 151643, 151643, 151643, 151643, 151643, 151643, 151643, 151643, 151643, 151643, 151643, 151643, 151643, 151643, 151643, 151643, 151643, 151643, 151643, 151643, 151643, 151643, 151643, 151643, 151643, 151643, 151643, 151643, 151643, 151643, 151643, 151643, 151643, 151643, 151643, 151643, 151643, 151643, 151643, 151643, 151643, 151643, 151643, 151643, 151643, 151643, 151643, 151643, 151643, 151643, 151643, 151643, 151643, 151643, 151643, 151643, 151643, 151643, 151643, 151643, 151643, 151643, 151643, 151643, 151643, 151643, 151643, 151643, 151643, 151643, 151643, 151643, 151643, 151643, 151643, 151643, 151643, 151643, 151643, 151643, 151643, 151643, 151643, 151643, 151643, 151643, 151643, 151643, 151643, 151643, 151643, 151643, 151643, 151643, 151643, 151643, 151643, 151643, 151643, 151643, 151643, 151643, 151643, 151643, 151643, 151643, 151643, 151643, 151643, 151643, 151643, 151643, 151643, 151643, 151643, 151643, 151643, 151643, 151643, 151643, 151643, 151643, 151643, 151643, 151643, 151643, 151643, 151643, 151643, 151643, 151643, 151643, 151643, 151643, 151643, 151643, 151643, 151643, 151643, 151643, 151643, 151643, 151643, 151643, 151643, 151643, 151643, 151643, 151643, 151643, 151643, 151643, 151643, 151643, 151643, 151643, 151643, 151643, 151643, 151643, 151643, 151643, 151643, 151643, 151643, 151643, 151643, 151643, 151643, 151643, 151643, 151643, 151643, 151643, 151643, 151643, 151643, 151643, 151643, 151643, 151643, 151643, 151643, 151643, 151643, 151643, 151643, 151643, 151643, 151643, 151643, 151643, 151643, 151643, 151643, 151643, 151643, 151643, 151643, 151643, 151643, 151643, 151643, 151643, 151643, 151643, 151643, 151643, 151643, 151643, 151643, 151643, 151643, 151643, 151643, 151643, 151643, 151643, 151643, 151643, 151643, 151643, 151643, 151643, 151643, 151643, 151643, 151643, 151643, 151643, 151643, 151643, 151643, 151643, 151643, 151643, 151643, 151643, 151643, 151643, 151643, 151643, 151643, 151643, 151643, 151643, 151643, 151643, 151643, 151643, 151643, 151643, 151643, 151643, 151643, 151643, 151643, 151643, 151643, 151643, 151643, 151643, 151643, 151643, 151643, 151643, 151643, 151643, 151643, 151643, 151643, 151643, 151643, 151643, 151643, 151643, 151643, 151643, 151643, 151643, 151643, 151643, 151643, 151643, 151643, 151643, 151643, 151643, 151643, 151643, 151643, 151643, 151643, 151643, 151643, 151643, 151643, 151643, 151643, 151643, 151643, 151643, 151643, 151643, 151643, 151643, 151643, 151643, 151643, 151643, 151643, 151643, 151643, 151643, 151643, 151643, 151643, 151643, 151643, 151643, 151643, 151643, 151643, 151643, 151643, 151643, 151643, 151643, 151643, 151643, 151643, 151643, 151643, 151643, 151643, 151643, 151643, 151643, 151643, 151643, 151643, 151643, 151643, 151643, 151643, 151643, 151643, 151643, 151643, 151643, 151643, 151643, 151643, 151643, 151643, 151643, 151643, 151643, 151643, 151643, 151643, 151643, 151643, 151643, 151643, 151643, 151643, 151643, 151643, 151643, 151643, 151643, 151643, 151643, 151643, 151643, 151643, 151643, 151643, 151643, 151643, 151643, 151643, 151643, 151643, 151643, 151643, 151643, 151643, 151643, 151643, 151643, 151643, 151643, 151643, 151643, 151643, 151643, 151643, 151643, 151643, 151643, 151643, 151643, 151643, 151643, 151643, 151643, 151643, 151643, 151643, 151643, 151643, 151643, 151643, 151643, 151643, 151643, 151643, 151643, 151643, 151643, 151643, 151643, 151643, 151643, 151643, 151643, 151643, 151643, 151643, 151643, 151643, 151643, 151643, 151643, 151643, 151643, 151643, 151643, 151643, 151643, 151643, 151643, 151643, 151643, 151643, 151643, 151643, 151643, 151643, 151643, 151643, 151643, 151643, 151643, 151643, 151643, 151643, 151643, 151643, 151643, 151643, 151643, 151643, 151643, 151643, 151643, 151643, 151643, 151643, 151643, 151643, 151643, 151643, 151643, 151643, 151643, 151643, 151643, 151643, 151643, 151643, 151643, 151643, 151643, 151643, 151643, 151643, 151643, 151643, 151643, 151643, 151643, 151643, 151643, 151643, 151643, 151643, 151643, 151643, 151643, 151643, 151643, 151643, 151643, 151643, 151643, 151643, 151643, 151643, 151643, 151643, 151643, 151643, 151643, 151643, 151643, 151643, 151643, 151643, 151643, 151643, 151643, 151643, 151643, 151643, 151643, 151643, 151643, 151643, 151643, 151643, 151643, 151643, 151643, 151643, 151643, 151643, 151643, 151643, 151644, 8948, 198, 2610, 525, 1207, 16948, 11, 3465, 553, 54364, 14817, 13, 1446, 525, 264, 10950, 17847, 13, 151645, 198, 151644, 872, 198, 16141, 279, 2701, 5248, 5754, 3405, 13, 576, 1537, 1555, 315, 697, 2033, 1265, 387, 315, 279, 2701, 3561, 25, 364, 16141, 25, 400, 20756, 4198, 6, 320, 28996, 17194, 8, 1380, 44428, 374, 825, 315, 19360, 35, 13, 21149, 3019, 553, 3019, 1573, 35764, 382, 32, 4621, 2070, 282, 2601, 8, 17066, 1007, 8862, 33475, 438, 220, 16, 7382, 61, 17, 504, 279, 6238, 11, 600, 1734, 13, 279, 25621, 315, 279, 2070, 374, 282, 2601, 8, 284, 220, 16, 7382, 61, 17, 13, 576, 2070, 702, 2477, 36929, 3692, 1172, 3156, 220, 279, 56836, 5106, 304, 64151, 13934, 13, 54115, 279, 8123, 25098, 315, 279, 81158, 315, 279, 2070, 11, 11995, 229, 13, 69, 4766, 279, 8123, 315, 264, 25366, 315, 10578, 431, 2889, 1151, 518, 279, 6238, 13, 5692, 11, 11995, 229, 323, 282, 2176, 525, 6131, 438, 22879, 13, 15920, 4226, 3685, 374, 279, 1429, 8311, 825, 369, 279, 4226, 315, 279, 25098, 1939, 32, 8, 220, 19, 14, 18, 51745, 431, 198, 33, 8, 220, 15, 198, 34, 8, 220, 16, 198, 35, 8, 220, 19, 51745, 151645, 198, 151644, 77091, 198]",,211,398,609,0.0,0.0
b78d5255-3934-4526-8e95-e4e487fcfae1,7,13,"[151643, 151643, 151643, 151643, 151643, 151643, 151643, 151643, 151643, 151643, 151643, 151643, 151643, 151643, 151643, 151643, 151643, 151643, 151643, 151643, 151643, 151643, 151643, 151643, 151643, 151643, 151643, 151643, 151643, 151643, 151643, 151643, 151643, 151643, 151643, 151643, 151643, 151643, 151643, 151643, 151643, 151643, 151643, 151643, 151643, 151643, 151643, 151643, 151643, 151643, 151643, 151643, 151643, 151643, 151643, 151643, 151643, 151643, 151643, 151643, 151643, 151643, 151643, 151643, 151643, 151643, 151643, 151643, 151643, 151643, 151643, 151643, 151643, 151643, 151643, 151643, 151643, 151643, 151643, 151643, 151643, 151643, 151643, 151643, 151643, 151643, 151643, 151643, 151643, 151643, 151643, 151643, 151643, 151643, 151643, 151643, 151643, 151643, 151643, 151643, 151643, 151643, 151643, 151643, 151643, 151643, 151643, 151643, 151643, 151643, 151643, 151643, 151643, 151643, 151643, 151643, 151643, 151643, 151643, 151643, 151643, 151643, 151643, 151643, 151643, 151643, 151643, 151643, 151643, 151643, 151643, 151643, 151643, 151643, 151643, 151643, 151643, 151643, 151643, 151643, 151643, 151643, 151643, 151643, 151643, 151643, 151643, 151643, 151643, 151643, 151643, 151643, 151643, 151643, 151643, 151643, 151643, 151643, 151643, 151643, 151643, 151643, 151643, 151643, 151643, 151643, 151643, 151643, 151643, 151643, 151643, 151643, 151643, 151643, 151643, 151643, 151643, 151643, 151643, 151643, 151643, 151643, 151643, 151643, 151643, 151643, 151643, 151643, 151643, 151643, 151643, 151643, 151643, 151643, 151643, 151643, 151643, 151643, 151643, 151643, 151643, 151643, 151643, 151643, 151643, 151643, 151643, 151643, 151643, 151643, 151643, 151643, 151643, 151643, 151643, 151643, 151643, 151643, 151643, 151643, 151643, 151643, 151643, 151643, 151643, 151643, 151643, 151643, 151643, 151643, 151643, 151643, 151643, 151643, 151643, 151643, 151643, 151643, 151643, 151643, 151643, 151643, 151643, 151643, 151643, 151643, 151643, 151643, 151643, 151643, 151643, 151643, 151643, 151643, 151643, 151643, 151643, 151643, 151643, 151643, 151643, 151643, 151643, 151643, 151643, 151643, 151643, 151643, 151643, 151643, 151643, 151643, 151643, 151643, 151643, 151643, 151643, 151643, 151643, 151643, 151643, 151643, 151643, 151643, 151643, 151643, 151643, 151643, 151643, 151643, 151643, 151643, 151643, 151643, 151643, 151643, 151643, 151643, 151643, 151643, 151643, 151643, 151643, 151643, 151643, 151643, 151643, 151643, 151643, 151643, 151643, 151643, 151643, 151643, 151643, 151643, 151643, 151643, 151643, 151643, 151643, 151643, 151643, 151643, 151643, 151643, 151643, 151643, 151643, 151643, 151643, 151643, 151643, 151643, 151643, 151643, 151643, 151643, 151643, 151643, 151643, 151643, 151643, 151643, 151643, 151643, 151643, 151643, 151643, 151643, 151643, 151643, 151643, 151643, 151643, 151643, 151643, 151643, 151643, 151643, 151643, 151643, 151643, 151643, 151643, 151643, 151643, 151643, 151643, 151643, 151643, 151643, 151643, 151643, 151643, 151643, 151643, 151643, 151643, 151643, 151643, 151643, 151643, 151643, 151643, 151643, 151643, 151643, 151643, 151643, 151643, 151643, 151643, 151643, 151643, 151643, 151643, 151643, 151643, 151643, 151643, 151643, 151643, 151643, 151643, 151643, 151643, 151643, 151643, 151643, 151643, 151643, 151643, 151643, 151643, 151643, 151643, 151643, 151643, 151643, 151643, 151643, 151643, 151643, 151643, 151643, 151643, 151643, 151643, 151643, 151643, 151643, 151643, 151643, 151643, 151643, 151643, 151643, 151643, 151643, 151643, 151643, 151643, 151643, 151643, 151643, 151643, 151643, 151643, 151643, 151643, 151643, 151643, 151643, 151643, 151643, 151643, 151643, 151643, 151643, 151643, 151643, 151643, 151643, 151643, 151643, 151643, 151643, 151643, 151643, 151643, 151643, 151643, 151643, 151643, 151643, 151643, 151643, 151643, 151643, 151643, 151643, 151643, 151643, 151643, 151643, 151643, 151643, 151643, 151643, 151643, 151643, 151643, 151643, 151643, 151643, 151643, 151643, 151643, 151643, 151643, 151643, 151643, 151643, 151643, 151643, 151643, 151643, 151643, 151643, 151643, 151643, 151643, 151643, 151643, 151643, 151643, 151643, 151643, 151643, 151643, 151643, 151643, 151643, 151643, 151643, 151643, 151643, 151643, 151643, 151643, 151643, 151643, 151643, 151643, 151643, 151643, 151643, 151643, 151643, 151643, 151643, 151643, 151643, 151643, 151643, 151643, 151643, 151643, 151643, 151643, 151643, 151643, 151643, 151643, 151643, 151643, 151643, 151643, 151643, 151643, 151643, 151643, 151643, 151643, 151643, 151643, 151643, 151643, 151643, 151643, 151643, 151643, 151643, 151643, 151643, 151643, 151643, 151643, 151643, 151643, 151643, 151643, 151643, 151643, 151643, 151643, 151643, 151643, 151643, 151643, 151643, 151643, 151643, 151643, 151643, 151643, 151643, 151643, 151643, 151643, 151643, 151643, 151643, 151643, 151643, 151643, 151643, 151643, 151643, 151643, 151643, 151643, 151643, 151643, 151643, 151643, 151643, 151643, 151643, 151643, 151643, 151643, 151643, 151643, 151643, 151643, 151643, 151643, 151643, 151643, 151643, 151643, 151643, 151643, 151643, 151643, 151643, 151643, 151643, 151643, 151643, 151643, 151643, 151643, 151643, 151643, 151643, 151643, 151643, 151643, 151643, 151643, 151643, 151643, 151643, 151643, 151643, 151643, 151643, 151643, 151643, 151643, 151643, 151643, 151643, 151643, 151643, 151643, 151643, 151643, 151643, 151643, 151643, 151643, 151643, 151643, 151643, 151643, 151643, 151643, 151643, 151643, 151643, 151643, 151643, 151643, 151643, 151643, 151643, 151643, 151643, 151643, 151643, 151643, 151643, 151643, 151643, 151643, 151643, 151643, 151643, 151643, 151643, 151643, 151643, 151643, 151643, 151643, 151643, 151643, 151643, 151643, 151643, 151643, 151643, 151643, 151643, 151643, 151643, 151643, 151643, 151643, 151643, 151643, 151643, 151643, 151643, 151643, 151643, 151643, 151643, 151643, 151643, 151643, 151643, 151643, 151643, 151643, 151643, 151643, 151643, 151643, 151643, 151643, 151643, 151643, 151643, 151643, 151643, 151643, 151643, 151643, 151643, 151643, 151643, 151643, 151643, 151643, 151643, 151643, 151643, 151643, 151643, 151643, 151643, 151643, 151643, 151643, 151643, 151643, 151643, 151643, 151643, 151643, 151643, 151643, 151643, 151643, 151643, 151643, 151643, 151643, 151643, 151643, 151643, 151643, 151643, 151643, 151643, 151643, 151643, 151643, 151643, 151643, 151643, 151643, 151643, 151643, 151643, 151643, 151643, 151643, 151643, 151643, 151643, 151643, 151643, 151643, 151643, 151643, 151643, 151643, 151643, 151643, 151643, 151643, 151643, 151643, 151643, 151643, 151643, 151643, 151643, 151643, 151643, 151643, 151643, 151643, 151643, 151643, 151643, 151643, 151643, 151643, 151643, 151643, 151643, 151643, 151643, 151643, 151643, 151643, 151644, 8948, 198, 2610, 525, 1207, 16948, 11, 3465, 553, 54364, 14817, 13, 1446, 525, 264, 10950, 17847, 13, 151645, 198, 151644, 872, 198, 16141, 279, 2701, 5248, 5754, 3405, 13, 576, 1537, 1555, 315, 697, 2033, 1265, 387, 315, 279, 2701, 3561, 25, 364, 16141, 25, 400, 20756, 4198, 6, 320, 28996, 17194, 8, 1380, 44428, 374, 825, 315, 19360, 35, 13, 21149, 3019, 553, 3019, 1573, 35764, 382, 66, 3337, 385, 17308, 276, 603, 572, 11758, 448, 93471, 482, 11, 29064, 1985, 220, 16, 624, 16, 572, 31713, 448, 38595, 16643, 87, 577, 11, 29064, 1985, 220, 17, 624, 17, 572, 11758, 448, 270, 290, 3923, 81782, 323, 4510, 1869, 482, 11, 29064, 220, 18, 624, 18, 572, 11758, 448, 40578, 2356, 2406, 12, 465, 83, 1455, 1535, 4130, 278, 18814, 6275, 67, 1399, 11, 29064, 1985, 220, 19, 382, 5158, 1657, 8424, 2673, 12460, 34684, 32199, 525, 1052, 389, 1985, 220, 19, 1939, 32, 8, 220, 22, 198, 33, 8, 220, 21, 198, 34, 8, 220, 16, 15, 198, 35, 8, 220, 23, 151645, 198, 151644, 77091, 198]",,181,482,663,0.0,0.0
c9d7dcbb-a609-46f0-bbfc-f10a7acc91e8,7,14,"[151643, 151643, 151643, 151643, 151643, 151643, 151643, 151643, 151643, 151643, 151643, 151643, 151643, 151643, 151643, 151643, 151643, 151643, 151643, 151643, 151643, 151643, 151643, 151643, 151643, 151643, 151643, 151643, 151643, 151643, 151643, 151643, 151643, 151643, 151643, 151643, 151643, 151643, 151643, 151643, 151643, 151643, 151643, 151643, 151643, 151643, 151643, 151643, 151643, 151643, 151643, 151643, 151643, 151643, 151643, 151643, 151643, 151643, 151643, 151643, 151643, 151643, 151643, 151643, 151643, 151643, 151643, 151643, 151643, 151643, 151643, 151643, 151643, 151643, 151643, 151643, 151643, 151643, 151643, 151643, 151643, 151643, 151643, 151643, 151643, 151643, 151643, 151643, 151643, 151643, 151643, 151643, 151643, 151643, 151643, 151643, 151643, 151643, 151643, 151643, 151643, 151643, 151643, 151643, 151643, 151643, 151643, 151643, 151643, 151643, 151643, 151643, 151643, 151643, 151643, 151643, 151643, 151643, 151643, 151643, 151643, 151643, 151643, 151643, 151643, 151643, 151643, 151643, 151643, 151643, 151643, 151643, 151643, 151643, 151643, 151643, 151643, 151643, 151643, 151643, 151643, 151643, 151643, 151643, 151643, 151643, 151643, 151643, 151643, 151643, 151643, 151643, 151643, 151643, 151643, 151643, 151643, 151643, 151643, 151643, 151643, 151643, 151643, 151643, 151643, 151643, 151643, 151643, 151643, 151643, 151643, 151643, 151643, 151643, 151643, 151643, 151643, 151643, 151643, 151643, 151643, 151643, 151643, 151643, 151643, 151643, 151643, 151643, 151643, 151643, 151643, 151643, 151643, 151643, 151643, 151643, 151643, 151643, 151643, 151643, 151643, 151643, 151643, 151643, 151643, 151643, 151643, 151643, 151643, 151643, 151643, 151643, 151643, 151643, 151643, 151643, 151643, 151643, 151643, 151643, 151643, 151643, 151643, 151643, 151643, 151643, 151643, 151643, 151643, 151643, 151643, 151643, 151643, 151643, 151643, 151643, 151643, 151643, 151643, 151643, 151643, 151643, 151643, 151643, 151643, 151643, 151643, 151643, 151643, 151643, 151643, 151643, 151643, 151643, 151643, 151643, 151643, 151643, 151643, 151643, 151643, 151643, 151643, 151643, 151643, 151643, 151643, 151643, 151643, 151643, 151643, 151643, 151643, 151643, 151643, 151643, 151643, 151643, 151643, 151643, 151643, 151643, 151643, 151643, 151643, 151643, 151643, 151643, 151643, 151643, 151643, 151643, 151643, 151643, 151643, 151643, 151643, 151643, 151643, 151643, 151643, 151643, 151643, 151643, 151643, 151643, 151643, 151643, 151643, 151643, 151643, 151643, 151643, 151643, 151643, 151643, 151643, 151643, 151643, 151643, 151643, 151643, 151643, 151643, 151643, 151643, 151643, 151643, 151643, 151643, 151643, 151643, 151643, 151643, 151643, 151643, 151643, 151643, 151643, 151643, 151643, 151643, 151643, 151643, 151643, 151643, 151643, 151643, 151643, 151643, 151643, 151643, 151643, 151643, 151643, 151643, 151643, 151643, 151643, 151643, 151643, 151643, 151643, 151643, 151643, 151643, 151643, 151643, 151643, 151643, 151643, 151643, 151643, 151643, 151643, 151643, 151643, 151643, 151643, 151643, 151643, 151643, 151643, 151643, 151643, 151643, 151643, 151643, 151643, 151643, 151643, 151643, 151643, 151643, 151643, 151643, 151643, 151643, 151643, 151643, 151643, 151643, 151643, 151643, 151643, 151643, 151643, 151643, 151643, 151643, 151643, 151643, 151643, 151643, 151643, 151643, 151643, 151643, 151643, 151643, 151643, 151643, 151643, 151643, 151643, 151643, 151643, 151643, 151643, 151643, 151643, 151643, 151643, 151643, 151643, 151643, 151643, 151643, 151643, 151643, 151643, 151643, 151643, 151643, 151643, 151643, 151643, 151643, 151643, 151643, 151643, 151643, 151643, 151643, 151643, 151643, 151643, 151643, 151643, 151643, 151643, 151643, 151643, 151643, 151643, 151643, 151643, 151643, 151643, 151643, 151643, 151643, 151643, 151643, 151643, 151643, 151643, 151643, 151643, 151643, 151643, 151643, 151643, 151643, 151643, 151643, 151643, 151643, 151643, 151643, 151643, 151643, 151643, 151643, 151643, 151643, 151643, 151643, 151643, 151643, 151643, 151643, 151643, 151643, 151643, 151643, 151643, 151643, 151643, 151643, 151643, 151643, 151643, 151643, 151643, 151643, 151643, 151643, 151643, 151643, 151643, 151643, 151643, 151643, 151643, 151643, 151643, 151643, 151643, 151643, 151643, 151643, 151643, 151643, 151643, 151643, 151643, 151643, 151643, 151643, 151643, 151643, 151643, 151643, 151643, 151643, 151643, 151643, 151643, 151643, 151643, 151643, 151643, 151643, 151643, 151643, 151643, 151643, 151643, 151643, 151643, 151643, 151643, 151643, 151643, 151643, 151643, 151643, 151643, 151643, 151643, 151643, 151643, 151643, 151643, 151643, 151643, 151643, 151643, 151643, 151643, 151643, 151643, 151643, 151643, 151643, 151643, 151643, 151643, 151643, 151643, 151643, 151643, 151643, 151643, 151643, 151643, 151643, 151643, 151643, 151643, 151643, 151643, 151643, 151643, 151643, 151643, 151643, 151643, 151643, 151643, 151643, 151643, 151643, 151643, 151643, 151643, 151643, 151643, 151643, 151643, 151643, 151643, 151643, 151643, 151643, 151643, 151643, 151643, 151643, 151643, 151643, 151643, 151643, 151643, 151643, 151643, 151643, 151643, 151643, 151643, 151643, 151643, 151643, 151643, 151643, 151643, 151643, 151643, 151643, 151643, 151643, 151643, 151643, 151643, 151643, 151643, 151643, 151643, 151643, 151643, 151643, 151643, 151643, 151643, 151643, 151643, 151643, 151643, 151643, 151643, 151643, 151643, 151643, 151643, 151643, 151643, 151643, 151643, 151643, 151643, 151643, 151643, 151643, 151643, 151643, 151643, 151643, 151643, 151643, 151643, 151643, 151643, 151643, 151643, 151643, 151643, 151643, 151643, 151643, 151643, 151643, 151643, 151643, 151643, 151643, 151643, 151643, 151643, 151643, 151643, 151643, 151643, 151643, 151643, 151643, 151643, 151643, 151643, 151643, 151643, 151644, 8948, 198, 2610, 525, 1207, 16948, 11, 3465, 553, 54364, 14817, 13, 1446, 525, 264, 10950, 17847, 13, 151645, 198, 151644, 872, 198, 16141, 279, 2701, 5248, 5754, 3405, 13, 576, 1537, 1555, 315, 697, 2033, 1265, 387, 315, 279, 2701, 3561, 25, 364, 16141, 25, 400, 20756, 4198, 6, 320, 28996, 17194, 8, 1380, 44428, 374, 825, 315, 19360, 35, 13, 21149, 3019, 553, 3019, 1573, 35764, 382, 25756, 3460, 1372, 315, 41599, 15215, 8947, 553, 279, 8059, 5545, 279, 9237, 320, 1204, 3460, 30305, 315, 41599, 15215, 11, 4512, 438, 279, 1372, 315, 41599, 15215, 817, 9961, 61, 17, 11, 817, 2086, 3593, 10061, 601, 9658, 429, 11, 44355, 36674, 11, 279, 11823, 12, 22615, 8870, 14843, 10497, 304, 279, 6200, 315, 279, 8059, 911, 220, 23, 323, 264, 4279, 4420, 4134, 11, 1393, 678, 1008, 24473, 14616, 438, 807, 1033, 382, 3838, 1035, 387, 279, 44868, 11341, 315, 279, 30305, 1948, 1378, 20892, 315, 41599, 3313, 48869, 315, 220, 22, 15, 15, 12, 23, 15, 15, 6569, 53, 320, 7053, 220, 16, 8, 323, 220, 23, 15, 15, 12, 24, 15, 15, 1962, 53, 320, 7053, 220, 17, 568, 4710, 3882, 2200, 320, 7053, 220, 16, 8, 608, 30305, 320, 7053, 220, 17, 8, 374, 1447, 89389, 25, 582, 525, 7404, 911, 22535, 279, 11823, 12, 22615, 8870, 11, 537, 11823, 75544, 11, 11823, 21477, 476, 894, 1008, 13, 1084, 748, 537, 264, 85105, 476, 2494, 1075, 429, 28175, 89389, 220, 17, 25, 12941, 41599, 3313, 17172, 4344, 3537, 11, 714, 653, 537, 1486, 264, 3476, 1588, 9272, 32, 8, 220, 15, 13, 16, 320, 16, 15, 49309, 16, 4292, 33, 8, 220, 16, 624, 34, 8, 220, 15, 13, 15, 16, 320, 16, 15, 49309, 17, 4292, 35, 8, 220, 16, 15, 13, 151645, 198, 151644, 77091, 198]",,303,521,824,1.0,1.0
bb2864fc-25e2-4c71-81b2-f85256e45dea,7,15,"[151643, 151643, 151643, 151643, 151643, 151643, 151643, 151643, 151643, 151643, 151643, 151643, 151643, 151643, 151643, 151643, 151643, 151643, 151643, 151643, 151643, 151643, 151643, 151643, 151643, 151643, 151643, 151643, 151643, 151643, 151643, 151643, 151643, 151643, 151643, 151643, 151643, 151643, 151643, 151643, 151643, 151643, 151643, 151643, 151643, 151643, 151643, 151643, 151643, 151643, 151643, 151643, 151643, 151643, 151643, 151643, 151643, 151643, 151643, 151643, 151643, 151643, 151643, 151643, 151643, 151643, 151643, 151643, 151643, 151643, 151643, 151643, 151643, 151643, 151643, 151643, 151643, 151643, 151643, 151643, 151643, 151643, 151643, 151643, 151643, 151643, 151643, 151643, 151643, 151643, 151643, 151643, 151643, 151643, 151643, 151643, 151643, 151643, 151643, 151643, 151643, 151643, 151643, 151643, 151643, 151643, 151643, 151643, 151643, 151643, 151643, 151643, 151643, 151643, 151643, 151643, 151643, 151643, 151643, 151643, 151643, 151643, 151643, 151643, 151643, 151643, 151643, 151643, 151643, 151643, 151643, 151643, 151643, 151643, 151643, 151643, 151643, 151643, 151643, 151643, 151643, 151643, 151643, 151643, 151643, 151643, 151643, 151643, 151643, 151643, 151643, 151643, 151643, 151643, 151643, 151643, 151643, 151643, 151643, 151643, 151643, 151643, 151643, 151643, 151643, 151643, 151643, 151643, 151643, 151643, 151643, 151643, 151643, 151643, 151643, 151643, 151643, 151643, 151643, 151643, 151643, 151643, 151643, 151643, 151643, 151643, 151643, 151643, 151643, 151643, 151643, 151643, 151643, 151643, 151643, 151643, 151643, 151643, 151643, 151643, 151643, 151643, 151643, 151643, 151643, 151643, 151643, 151643, 151643, 151643, 151643, 151643, 151643, 151643, 151643, 151643, 151643, 151643, 151643, 151643, 151643, 151643, 151643, 151643, 151643, 151643, 151643, 151643, 151643, 151643, 151643, 151643, 151643, 151643, 151643, 151643, 151643, 151643, 151643, 151643, 151643, 151643, 151643, 151643, 151643, 151643, 151643, 151643, 151643, 151643, 151643, 151643, 151643, 151643, 151643, 151643, 151643, 151643, 151643, 151643, 151643, 151643, 151643, 151643, 151643, 151643, 151643, 151643, 151643, 151643, 151643, 151643, 151643, 151643, 151643, 151643, 151643, 151643, 151643, 151643, 151643, 151643, 151643, 151643, 151643, 151643, 151643, 151643, 151643, 151643, 151643, 151643, 151643, 151643, 151643, 151643, 151643, 151643, 151643, 151643, 151643, 151643, 151643, 151643, 151643, 151643, 151643, 151643, 151643, 151643, 151643, 151643, 151643, 151643, 151643, 151643, 151643, 151643, 151643, 151643, 151643, 151643, 151643, 151643, 151643, 151643, 151643, 151643, 151643, 151643, 151643, 151643, 151643, 151643, 151643, 151643, 151643, 151643, 151643, 151643, 151643, 151643, 151643, 151643, 151643, 151643, 151643, 151643, 151643, 151643, 151643, 151643, 151643, 151643, 151643, 151643, 151643, 151643, 151643, 151643, 151643, 151643, 151643, 151643, 151643, 151643, 151643, 151643, 151643, 151643, 151643, 151643, 151643, 151643, 151643, 151643, 151643, 151643, 151643, 151643, 151643, 151643, 151643, 151643, 151643, 151643, 151643, 151643, 151643, 151643, 151643, 151643, 151643, 151643, 151643, 151643, 151643, 151643, 151643, 151643, 151643, 151643, 151643, 151643, 151643, 151643, 151643, 151643, 151643, 151643, 151643, 151643, 151643, 151643, 151643, 151643, 151643, 151643, 151643, 151643, 151643, 151643, 151643, 151643, 151643, 151643, 151643, 151643, 151643, 151643, 151643, 151643, 151643, 151643, 151643, 151643, 151643, 151643, 151643, 151643, 151643, 151643, 151643, 151643, 151643, 151643, 151643, 151643, 151643, 151643, 151643, 151643, 151643, 151643, 151643, 151643, 151643, 151643, 151643, 151643, 151643, 151643, 151643, 151643, 151643, 151643, 151643, 151643, 151643, 151643, 151643, 151643, 151643, 151643, 151643, 151643, 151643, 151643, 151643, 151643, 151643, 151643, 151643, 151643, 151643, 151643, 151643, 151643, 151643, 151643, 151643, 151643, 151643, 151643, 151643, 151643, 151643, 151643, 151643, 151643, 151643, 151643, 151643, 151643, 151643, 151643, 151643, 151643, 151643, 151643, 151643, 151643, 151643, 151643, 151643, 151643, 151643, 151643, 151643, 151643, 151643, 151643, 151643, 151643, 151643, 151643, 151643, 151643, 151643, 151643, 151643, 151643, 151643, 151643, 151643, 151643, 151643, 151643, 151643, 151643, 151643, 151643, 151643, 151643, 151643, 151643, 151643, 151643, 151643, 151643, 151643, 151643, 151643, 151643, 151643, 151643, 151643, 151643, 151643, 151643, 151643, 151643, 151643, 151643, 151643, 151643, 151643, 151643, 151643, 151643, 151643, 151643, 151643, 151643, 151643, 151643, 151643, 151643, 151643, 151643, 151643, 151643, 151643, 151643, 151643, 151643, 151643, 151643, 151643, 151643, 151643, 151643, 151643, 151643, 151643, 151643, 151643, 151643, 151643, 151643, 151643, 151643, 151643, 151643, 151643, 151643, 151643, 151643, 151643, 151643, 151643, 151643, 151643, 151643, 151643, 151643, 151643, 151643, 151643, 151643, 151643, 151643, 151643, 151643, 151643, 151643, 151643, 151643, 151643, 151643, 151643, 151643, 151643, 151643, 151643, 151643, 151643, 151643, 151643, 151643, 151643, 151643, 151643, 151643, 151643, 151643, 151643, 151643, 151643, 151643, 151643, 151643, 151643, 151643, 151643, 151643, 151643, 151643, 151643, 151643, 151643, 151643, 151643, 151643, 151643, 151643, 151643, 151643, 151643, 151643, 151643, 151643, 151643, 151643, 151643, 151643, 151643, 151643, 151643, 151643, 151643, 151643, 151643, 151643, 151643, 151643, 151643, 151643, 151643, 151643, 151643, 151643, 151643, 151643, 151643, 151643, 151643, 151643, 151643, 151643, 151643, 151643, 151643, 151643, 151643, 151643, 151643, 151643, 151643, 151643, 151643, 151643, 151643, 151643, 151643, 151643, 151643, 151643, 151643, 151643, 151643, 151643, 151643, 151643, 151643, 151643, 151643, 151643, 151644, 8948, 198, 2610, 525, 1207, 16948, 11, 3465, 553, 54364, 14817, 13, 1446, 525, 264, 10950, 17847, 13, 151645, 198, 151644, 872, 198, 16141, 279, 2701, 5248, 5754, 3405, 13, 576, 1537, 1555, 315, 697, 2033, 1265, 387, 315, 279, 2701, 3561, 25, 364, 16141, 25, 400, 20756, 4198, 6, 320, 28996, 17194, 8, 1380, 44428, 374, 825, 315, 19360, 35, 13, 21149, 3019, 553, 3019, 1573, 35764, 382, 32, 70946, 1952, 10058, 702, 264, 1803, 2011, 88, 415, 13621, 264, 1803, 13313, 85736, 323, 264, 9503, 5652, 1874, 678, 8823, 311, 825, 2441, 13, 31110, 78, 311, 279, 1803, 2011, 88, 415, 13621, 525, 264, 16643, 87, 3923, 323, 264, 5103, 41872, 41400, 323, 3348, 311, 279, 1803, 2011, 88, 415, 13621, 374, 264, 21068, 60163, 1874, 13, 576, 21068, 60163, 323, 279, 12904, 525, 1083, 2176, 29199, 78, 311, 279, 308, 21561, 457, 13, 3555, 374, 279, 4396, 358, 3124, 1706, 829, 369, 419, 41930, 1939, 32, 8, 220, 17, 2832, 67007, 4130, 12, 18, 1786, 88, 5652, 12, 19, 1448, 769, 60163, 12, 20, 8460, 3923, 12, 21, 8013, 12927, 41872, 309, 3313, 8, 7964, 12738, 292, 13621, 198, 33, 8, 220, 18, 1786, 88, 5652, 12, 21, 8013, 12927, 41872, 309, 3313, 7287, 20, 8460, 3923, 12, 17, 2832, 67007, 4130, 12, 19, 1448, 769, 60163, 7964, 12738, 292, 13621, 198, 34, 8, 220, 17, 8013, 12927, 41872, 309, 3313, 7287, 18, 8460, 3923, 12, 19, 1448, 769, 60163, 12, 20, 1786, 88, 5652, 12, 21, 2832, 67007, 4130, 7964, 12738, 292, 13621, 198, 35, 8, 220, 20, 1786, 88, 5652, 12, 17, 8013, 12927, 41872, 309, 3313, 7287, 18, 8460, 3923, 12, 21, 2832, 67007, 4130, 12, 19, 1448, 769, 60163, 7964, 12738, 292, 13621, 151645, 198, 151644, 77091, 198]",,296,510,806,0.0,0.0
f18fa489-3ef7-412f-9085-ba152639b225,7,16,"[151643, 151643, 151643, 151643, 151643, 151643, 151643, 151643, 151643, 151643, 151643, 151643, 151643, 151643, 151643, 151643, 151643, 151643, 151643, 151643, 151643, 151643, 151643, 151643, 151643, 151643, 151643, 151643, 151643, 151643, 151643, 151643, 151643, 151643, 151643, 151643, 151643, 151643, 151643, 151643, 151643, 151643, 151643, 151643, 151643, 151643, 151643, 151643, 151643, 151643, 151643, 151643, 151643, 151643, 151643, 151643, 151643, 151643, 151643, 151643, 151643, 151643, 151643, 151643, 151643, 151643, 151643, 151643, 151643, 151643, 151643, 151643, 151643, 151643, 151643, 151643, 151643, 151643, 151643, 151643, 151643, 151643, 151643, 151643, 151643, 151643, 151643, 151643, 151643, 151643, 151643, 151643, 151643, 151643, 151643, 151643, 151643, 151643, 151643, 151643, 151643, 151643, 151643, 151643, 151643, 151643, 151643, 151643, 151643, 151643, 151643, 151643, 151643, 151643, 151643, 151643, 151643, 151643, 151643, 151643, 151643, 151643, 151643, 151643, 151643, 151643, 151643, 151643, 151643, 151643, 151643, 151643, 151643, 151643, 151643, 151643, 151643, 151643, 151643, 151643, 151643, 151643, 151643, 151643, 151643, 151643, 151643, 151643, 151643, 151643, 151643, 151643, 151643, 151643, 151643, 151643, 151643, 151643, 151643, 151643, 151643, 151643, 151643, 151643, 151643, 151643, 151643, 151643, 151643, 151643, 151643, 151643, 151643, 151643, 151643, 151643, 151643, 151643, 151643, 151643, 151643, 151643, 151643, 151643, 151643, 151643, 151643, 151643, 151643, 151643, 151643, 151643, 151643, 151643, 151643, 151643, 151643, 151643, 151643, 151643, 151643, 151643, 151643, 151643, 151643, 151643, 151643, 151643, 151643, 151643, 151643, 151643, 151643, 151643, 151643, 151643, 151643, 151643, 151643, 151643, 151643, 151643, 151643, 151643, 151643, 151643, 151643, 151643, 151643, 151643, 151643, 151643, 151643, 151643, 151643, 151643, 151643, 151643, 151643, 151643, 151643, 151643, 151643, 151643, 151643, 151643, 151643, 151643, 151643, 151643, 151643, 151643, 151643, 151643, 151643, 151643, 151643, 151643, 151643, 151643, 151643, 151643, 151643, 151643, 151643, 151643, 151643, 151643, 151643, 151643, 151643, 151643, 151643, 151643, 151643, 151643, 151643, 151643, 151643, 151643, 151643, 151643, 151643, 151643, 151643, 151643, 151643, 151643, 151643, 151643, 151643, 151643, 151643, 151643, 151643, 151643, 151643, 151643, 151643, 151643, 151643, 151643, 151643, 151643, 151643, 151643, 151643, 151643, 151643, 151643, 151643, 151643, 151643, 151643, 151643, 151643, 151643, 151643, 151643, 151643, 151643, 151643, 151643, 151643, 151643, 151643, 151643, 151643, 151643, 151643, 151643, 151643, 151643, 151643, 151643, 151643, 151643, 151643, 151643, 151643, 151643, 151643, 151643, 151643, 151643, 151643, 151643, 151643, 151643, 151643, 151643, 151643, 151643, 151643, 151643, 151643, 151643, 151643, 151643, 151643, 151643, 151643, 151643, 151643, 151643, 151643, 151643, 151643, 151643, 151643, 151643, 151643, 151643, 151643, 151643, 151643, 151643, 151643, 151643, 151643, 151643, 151643, 151643, 151643, 151643, 151643, 151643, 151643, 151643, 151643, 151643, 151643, 151643, 151643, 151643, 151643, 151643, 151643, 151643, 151643, 151643, 151643, 151643, 151643, 151643, 151643, 151643, 151643, 151643, 151643, 151643, 151643, 151643, 151643, 151643, 151643, 151643, 151643, 151643, 151643, 151643, 151643, 151643, 151643, 151643, 151643, 151643, 151643, 151643, 151643, 151643, 151643, 151643, 151643, 151643, 151643, 151643, 151643, 151643, 151643, 151643, 151643, 151643, 151643, 151643, 151643, 151643, 151643, 151643, 151643, 151643, 151643, 151643, 151643, 151643, 151643, 151643, 151643, 151643, 151643, 151643, 151643, 151643, 151643, 151643, 151643, 151643, 151643, 151643, 151643, 151643, 151643, 151643, 151643, 151643, 151643, 151643, 151643, 151643, 151643, 151643, 151643, 151643, 151643, 151643, 151643, 151643, 151643, 151643, 151643, 151643, 151643, 151643, 151643, 151643, 151643, 151643, 151643, 151643, 151643, 151643, 151643, 151643, 151643, 151643, 151643, 151643, 151643, 151643, 151643, 151643, 151643, 151643, 151643, 151643, 151643, 151643, 151643, 151643, 151643, 151643, 151643, 151643, 151643, 151643, 151643, 151643, 151643, 151643, 151643, 151643, 151643, 151643, 151643, 151643, 151643, 151643, 151643, 151643, 151643, 151643, 151643, 151643, 151643, 151643, 151643, 151643, 151643, 151643, 151643, 151643, 151643, 151643, 151643, 151643, 151643, 151643, 151643, 151643, 151643, 151643, 151643, 151643, 151643, 151643, 151643, 151643, 151643, 151643, 151643, 151643, 151643, 151643, 151643, 151643, 151643, 151643, 151643, 151643, 151643, 151643, 151643, 151643, 151643, 151643, 151643, 151643, 151643, 151643, 151643, 151643, 151643, 151643, 151643, 151643, 151643, 151643, 151643, 151643, 151643, 151643, 151643, 151643, 151643, 151643, 151643, 151643, 151643, 151643, 151643, 151643, 151643, 151643, 151643, 151643, 151643, 151643, 151643, 151643, 151643, 151643, 151643, 151643, 151643, 151643, 151643, 151643, 151643, 151643, 151643, 151643, 151643, 151643, 151643, 151643, 151643, 151643, 151643, 151643, 151643, 151643, 151643, 151643, 151643, 151643, 151643, 151643, 151643, 151643, 151643, 151643, 151643, 151643, 151643, 151643, 151643, 151643, 151643, 151643, 151643, 151643, 151643, 151643, 151643, 151643, 151643, 151643, 151643, 151643, 151643, 151643, 151643, 151643, 151643, 151643, 151643, 151643, 151643, 151643, 151643, 151643, 151643, 151643, 151643, 151643, 151643, 151643, 151643, 151643, 151643, 151643, 151643, 151643, 151643, 151643, 151643, 151643, 151643, 151643, 151643, 151643, 151643, 151643, 151643, 151643, 151643, 151643, 151643, 151643, 151643, 151643, 151643, 151643, 151643, 151643, 151643, 151643, 151643, 151643, 151643, 151643, 151643, 151643, 151643, 151643, 151643, 151643, 151643, 151643, 151643, 151643, 151643, 151643, 151643, 151643, 151643, 151643, 151643, 151643, 151643, 151643, 151643, 151643, 151643, 151643, 151643, 151643, 151643, 151643, 151643, 151643, 151643, 151643, 151643, 151643, 151643, 151643, 151643, 151643, 151643, 151643, 151643, 151643, 151643, 151643, 151643, 151643, 151643, 151643, 151643, 151643, 151643, 151644, 8948, 198, 2610, 525, 1207, 16948, 11, 3465, 553, 54364, 14817, 13, 1446, 525, 264, 10950, 17847, 13, 151645, 198, 151644, 872, 198, 16141, 279, 2701, 5248, 5754, 3405, 13, 576, 1537, 1555, 315, 697, 2033, 1265, 387, 315, 279, 2701, 3561, 25, 364, 16141, 25, 400, 20756, 4198, 6, 320, 28996, 17194, 8, 1380, 44428, 374, 825, 315, 19360, 35, 13, 21149, 3019, 553, 3019, 1573, 35764, 382, 13552, 3095, 429, 614, 279, 1852, 30106, 14806, 714, 525, 2155, 304, 862, 23759, 26112, 525, 3881, 438, 374, 68538, 13, 2160, 68538, 614, 1378, 4494, 11, 24526, 374, 68538, 323, 22646, 29048, 68538, 13, 62185, 374, 68538, 614, 279, 1852, 30106, 14806, 714, 1745, 304, 862, 14389, 13, 758, 22646, 29048, 68538, 11, 34615, 525, 8433, 304, 279, 1852, 1616, 11, 714, 862, 27804, 304, 3550, 525, 2155, 624, 23085, 315, 279, 2701, 17356, 4544, 31506, 1473, 28293, 374, 25359, 2142, 1939, 16, 13, 5103, 41872, 220, 21, 11, 21, 24293, 67, 2327, 299, 40995, 16, 11, 16, 24293, 65, 573, 12032, 3923, 11696, 17, 11, 17, 24293, 29680, 277, 2011, 3923, 349, 198, 17, 13, 78474, 220, 17, 2832, 67007, 4130, 776, 848, 78, 349, 198, 18, 13, 70946, 5127, 268, 603, 198, 19, 13, 5103, 41872, 282, 30867, 349, 271, 32, 8, 220, 17, 323, 220, 18, 198, 33, 8, 220, 16, 11, 220, 17, 323, 220, 19, 198, 34, 8, 220, 18, 323, 220, 19, 198, 35, 8, 220, 16, 323, 220, 17, 151645, 198, 151644, 77091, 198]",,252,329,581,1.0,1.0
4a65fb7b-d4e5-4218-8696-a16258737c74,7,17,"[151643, 151643, 151643, 151643, 151643, 151643, 151643, 151643, 151643, 151643, 151643, 151643, 151643, 151643, 151643, 151643, 151643, 151643, 151643, 151643, 151643, 151643, 151643, 151643, 151643, 151643, 151643, 151643, 151643, 151643, 151643, 151643, 151643, 151643, 151643, 151643, 151643, 151643, 151643, 151643, 151643, 151643, 151643, 151643, 151643, 151643, 151643, 151643, 151643, 151643, 151643, 151643, 151643, 151643, 151643, 151643, 151643, 151643, 151643, 151643, 151643, 151643, 151643, 151643, 151643, 151643, 151643, 151643, 151643, 151643, 151643, 151643, 151643, 151643, 151643, 151643, 151643, 151643, 151643, 151643, 151643, 151643, 151643, 151643, 151643, 151643, 151643, 151643, 151643, 151643, 151643, 151643, 151643, 151643, 151643, 151643, 151643, 151643, 151643, 151643, 151643, 151643, 151643, 151643, 151643, 151643, 151643, 151643, 151643, 151643, 151643, 151643, 151643, 151643, 151643, 151643, 151643, 151643, 151643, 151643, 151643, 151643, 151643, 151643, 151643, 151643, 151643, 151643, 151643, 151643, 151643, 151643, 151643, 151643, 151643, 151643, 151643, 151643, 151643, 151643, 151643, 151643, 151643, 151643, 151643, 151643, 151643, 151643, 151643, 151643, 151643, 151643, 151643, 151643, 151643, 151643, 151643, 151643, 151643, 151643, 151643, 151643, 151643, 151643, 151643, 151643, 151643, 151643, 151643, 151643, 151643, 151643, 151643, 151643, 151643, 151643, 151643, 151643, 151643, 151643, 151643, 151643, 151643, 151643, 151643, 151643, 151643, 151643, 151643, 151643, 151643, 151643, 151643, 151643, 151643, 151643, 151643, 151643, 151643, 151643, 151643, 151643, 151643, 151643, 151643, 151643, 151643, 151643, 151643, 151643, 151643, 151643, 151643, 151643, 151643, 151643, 151643, 151643, 151643, 151643, 151643, 151643, 151643, 151643, 151643, 151643, 151643, 151643, 151643, 151643, 151643, 151643, 151643, 151643, 151643, 151643, 151643, 151643, 151643, 151643, 151643, 151643, 151643, 151643, 151643, 151643, 151643, 151643, 151643, 151643, 151643, 151643, 151643, 151643, 151643, 151643, 151643, 151643, 151643, 151643, 151643, 151643, 151643, 151643, 151643, 151643, 151643, 151643, 151643, 151643, 151643, 151643, 151643, 151643, 151643, 151643, 151643, 151643, 151643, 151643, 151643, 151643, 151643, 151643, 151643, 151643, 151643, 151643, 151643, 151643, 151643, 151643, 151643, 151643, 151643, 151643, 151643, 151643, 151643, 151643, 151643, 151643, 151643, 151643, 151643, 151643, 151643, 151643, 151643, 151643, 151643, 151643, 151643, 151643, 151643, 151643, 151643, 151643, 151643, 151643, 151643, 151643, 151643, 151643, 151643, 151643, 151643, 151643, 151643, 151643, 151643, 151643, 151643, 151643, 151643, 151643, 151643, 151643, 151643, 151643, 151643, 151643, 151643, 151643, 151643, 151643, 151643, 151643, 151643, 151643, 151643, 151643, 151643, 151643, 151643, 151643, 151643, 151643, 151643, 151643, 151643, 151643, 151643, 151643, 151643, 151643, 151643, 151643, 151643, 151643, 151643, 151643, 151643, 151643, 151643, 151643, 151643, 151643, 151643, 151643, 151643, 151643, 151643, 151643, 151643, 151643, 151643, 151643, 151643, 151643, 151643, 151643, 151643, 151643, 151643, 151643, 151643, 151643, 151643, 151643, 151643, 151643, 151643, 151643, 151643, 151643, 151643, 151643, 151643, 151643, 151643, 151643, 151643, 151643, 151643, 151643, 151643, 151643, 151643, 151643, 151643, 151643, 151643, 151643, 151643, 151643, 151643, 151643, 151643, 151643, 151643, 151643, 151643, 151643, 151643, 151643, 151643, 151643, 151643, 151643, 151643, 151643, 151643, 151643, 151643, 151643, 151643, 151643, 151643, 151643, 151643, 151643, 151643, 151643, 151643, 151643, 151643, 151643, 151643, 151643, 151643, 151643, 151643, 151643, 151643, 151643, 151643, 151643, 151643, 151643, 151643, 151643, 151643, 151643, 151643, 151643, 151643, 151643, 151643, 151643, 151643, 151643, 151643, 151643, 151643, 151643, 151643, 151643, 151643, 151643, 151643, 151643, 151643, 151643, 151643, 151643, 151643, 151643, 151643, 151643, 151643, 151643, 151643, 151643, 151643, 151643, 151643, 151643, 151643, 151643, 151643, 151643, 151643, 151643, 151643, 151643, 151643, 151643, 151643, 151643, 151643, 151643, 151643, 151643, 151643, 151643, 151643, 151643, 151643, 151643, 151643, 151643, 151643, 151643, 151643, 151643, 151643, 151643, 151643, 151643, 151643, 151643, 151643, 151643, 151643, 151643, 151643, 151643, 151643, 151643, 151643, 151643, 151643, 151643, 151643, 151643, 151643, 151643, 151643, 151643, 151643, 151643, 151643, 151643, 151643, 151643, 151643, 151643, 151643, 151643, 151643, 151643, 151643, 151643, 151643, 151643, 151643, 151643, 151643, 151643, 151643, 151643, 151643, 151643, 151643, 151643, 151643, 151643, 151643, 151643, 151643, 151643, 151643, 151643, 151643, 151643, 151643, 151643, 151643, 151643, 151643, 151643, 151643, 151643, 151643, 151643, 151643, 151643, 151643, 151643, 151643, 151643, 151643, 151643, 151643, 151643, 151643, 151643, 151643, 151643, 151643, 151643, 151643, 151643, 151643, 151643, 151643, 151643, 151643, 151643, 151643, 151643, 151643, 151643, 151643, 151643, 151643, 151643, 151643, 151643, 151643, 151643, 151643, 151643, 151643, 151643, 151643, 151643, 151643, 151643, 151643, 151643, 151643, 151643, 151643, 151643, 151643, 151643, 151643, 151643, 151643, 151643, 151643, 151643, 151643, 151643, 151643, 151643, 151643, 151643, 151643, 151643, 151643, 151643, 151643, 151643, 151643, 151643, 151643, 151643, 151643, 151643, 151643, 151643, 151643, 151643, 151643, 151643, 151643, 151643, 151643, 151643, 151643, 151643, 151643, 151643, 151643, 151643, 151643, 151643, 151643, 151643, 151643, 151643, 151643, 151643, 151643, 151643, 151643, 151643, 151643, 151643, 151643, 151643, 151643, 151643, 151643, 151643, 151643, 151643, 151643, 151643, 151643, 151643, 151643, 151643, 151643, 151643, 151643, 151643, 151643, 151643, 151643, 151643, 151643, 151643, 151643, 151643, 151643, 151643, 151643, 151643, 151643, 151643, 151643, 151643, 151643, 151643, 151643, 151643, 151643, 151643, 151643, 151643, 151643, 151643, 151643, 151643, 151643, 151643, 151643, 151643, 151643, 151643, 151643, 151643, 151643, 151643, 151643, 151643, 151643, 151643, 151643, 151643, 151643, 151643, 151643, 151643, 151643, 151643, 151643, 151643, 151643, 151643, 151643, 151643, 151643, 151643, 151643, 151643, 151643, 151643, 151643, 151643, 151643, 151643, 151643, 151643, 151643, 151643, 151643, 151643, 151643, 151643, 151643, 151643, 151643, 151643, 151643, 151643, 151643, 151643, 151643, 151643, 151643, 151643, 151643, 151643, 151643, 151643, 151643, 151643, 151643, 151643, 151643, 151643, 151643, 151643, 151643, 151643, 151643, 151643, 151643, 151643, 151643, 151643, 151643, 151643, 151643, 151643, 151643, 151643, 151643, 151643, 151643, 151643, 151643, 151643, 151643, 151643, 151643, 151643, 151643, 151643, 151643, 151643, 151643, 151643, 151643, 151643, 151643, 151643, 151643, 151643, 151643, 151643, 151643, 151643, 151643, 151643, 151643, 151643, 151643, 151643, 151643, 151643, 151643, 151643, 151643, 151643, 151643, 151643, 151643, 151643, 151643, 151644, 8948, 198, 2610, 525, 1207, 16948, 11, 3465, 553, 54364, 14817, 13, 1446, 525, 264, 10950, 17847, 13, 151645, 198, 151644, 872, 198, 16141, 279, 2701, 5248, 5754, 3405, 13, 576, 1537, 1555, 315, 697, 2033, 1265, 387, 315, 279, 2701, 3561, 25, 364, 16141, 25, 400, 20756, 4198, 6, 320, 28996, 17194, 8, 1380, 44428, 374, 825, 315, 19360, 35, 13, 21149, 3019, 553, 3019, 1573, 35764, 382, 3838, 374, 279, 1922, 315, 34684, 47194, 315, 279, 1985, 12180, 979, 220, 17, 8460, 3923, 12, 20, 8273, 258, 3923, 66, 3337, 385, 17308, 12, 18, 20767, 757, 277, 2011, 88, 415, 13621, 374, 54741, 448, 2518, 31988, 29869, 323, 13623, 315, 33411, 1939, 32, 8, 220, 20, 198, 33, 8, 220, 15, 198, 34, 8, 220, 16, 198, 35, 8, 220, 18, 151645, 198, 151644, 77091, 198]",,139,575,714,0.0,0.0
ad0ddd5e-14c0-438e-a1fe-d8a546353aee,7,18,"[151643, 151643, 151643, 151643, 151643, 151643, 151643, 151643, 151643, 151643, 151643, 151643, 151643, 151643, 151643, 151643, 151643, 151643, 151643, 151643, 151643, 151643, 151643, 151643, 151643, 151643, 151643, 151643, 151643, 151643, 151643, 151643, 151643, 151643, 151643, 151643, 151643, 151643, 151643, 151643, 151643, 151643, 151643, 151643, 151643, 151643, 151643, 151643, 151643, 151643, 151643, 151643, 151643, 151643, 151643, 151643, 151643, 151643, 151643, 151643, 151643, 151643, 151643, 151643, 151643, 151643, 151643, 151643, 151643, 151643, 151643, 151643, 151643, 151643, 151643, 151643, 151643, 151643, 151643, 151643, 151643, 151643, 151643, 151643, 151643, 151643, 151643, 151643, 151643, 151643, 151643, 151643, 151643, 151643, 151643, 151643, 151643, 151643, 151643, 151643, 151643, 151643, 151643, 151643, 151643, 151643, 151643, 151643, 151643, 151643, 151643, 151643, 151643, 151643, 151643, 151643, 151643, 151643, 151643, 151643, 151643, 151643, 151643, 151643, 151643, 151643, 151643, 151643, 151643, 151643, 151643, 151643, 151643, 151643, 151643, 151643, 151643, 151643, 151643, 151643, 151643, 151643, 151643, 151643, 151643, 151643, 151643, 151643, 151643, 151643, 151643, 151643, 151643, 151643, 151643, 151643, 151643, 151643, 151643, 151643, 151643, 151643, 151643, 151643, 151643, 151643, 151643, 151643, 151643, 151643, 151643, 151643, 151643, 151643, 151643, 151643, 151643, 151643, 151643, 151643, 151643, 151643, 151643, 151643, 151643, 151643, 151643, 151643, 151643, 151643, 151643, 151643, 151643, 151643, 151643, 151643, 151643, 151643, 151643, 151643, 151643, 151643, 151643, 151643, 151643, 151643, 151643, 151643, 151643, 151643, 151643, 151643, 151643, 151643, 151643, 151643, 151643, 151643, 151643, 151643, 151643, 151643, 151643, 151643, 151643, 151643, 151643, 151643, 151643, 151643, 151643, 151643, 151643, 151643, 151643, 151643, 151643, 151643, 151643, 151643, 151643, 151643, 151643, 151643, 151643, 151643, 151643, 151643, 151643, 151643, 151643, 151643, 151643, 151643, 151643, 151643, 151643, 151643, 151643, 151643, 151643, 151643, 151643, 151643, 151643, 151643, 151643, 151643, 151643, 151643, 151643, 151643, 151643, 151643, 151643, 151643, 151643, 151643, 151643, 151643, 151643, 151643, 151643, 151643, 151643, 151643, 151643, 151643, 151643, 151643, 151643, 151643, 151643, 151643, 151643, 151643, 151643, 151643, 151643, 151643, 151643, 151643, 151643, 151643, 151643, 151643, 151643, 151643, 151643, 151643, 151643, 151643, 151643, 151643, 151643, 151643, 151643, 151643, 151643, 151643, 151643, 151643, 151643, 151643, 151643, 151643, 151643, 151643, 151643, 151643, 151643, 151643, 151643, 151643, 151643, 151643, 151643, 151643, 151643, 151643, 151643, 151643, 151643, 151643, 151643, 151643, 151643, 151643, 151643, 151643, 151643, 151643, 151643, 151643, 151643, 151643, 151643, 151643, 151643, 151643, 151643, 151643, 151643, 151643, 151643, 151643, 151643, 151643, 151643, 151643, 151643, 151643, 151643, 151643, 151643, 151643, 151643, 151643, 151643, 151643, 151643, 151643, 151643, 151643, 151643, 151643, 151643, 151643, 151643, 151643, 151643, 151643, 151643, 151643, 151643, 151643, 151643, 151643, 151643, 151643, 151643, 151643, 151643, 151643, 151643, 151643, 151643, 151643, 151643, 151643, 151643, 151643, 151643, 151643, 151643, 151643, 151643, 151643, 151643, 151643, 151643, 151643, 151643, 151643, 151643, 151643, 151643, 151643, 151643, 151643, 151643, 151643, 151643, 151643, 151643, 151643, 151643, 151643, 151643, 151643, 151643, 151643, 151643, 151643, 151643, 151643, 151643, 151643, 151643, 151643, 151643, 151643, 151643, 151643, 151643, 151643, 151643, 151643, 151643, 151643, 151643, 151643, 151643, 151643, 151643, 151643, 151643, 151643, 151643, 151643, 151643, 151643, 151643, 151643, 151643, 151643, 151643, 151643, 151643, 151643, 151643, 151643, 151643, 151643, 151643, 151643, 151643, 151643, 151643, 151643, 151643, 151643, 151643, 151643, 151643, 151643, 151643, 151643, 151643, 151643, 151643, 151643, 151643, 151643, 151643, 151643, 151643, 151643, 151643, 151643, 151643, 151643, 151643, 151643, 151643, 151643, 151643, 151643, 151643, 151643, 151643, 151643, 151643, 151643, 151643, 151643, 151643, 151643, 151643, 151643, 151643, 151643, 151643, 151643, 151643, 151643, 151643, 151643, 151643, 151643, 151643, 151643, 151643, 151643, 151643, 151643, 151643, 151643, 151643, 151643, 151643, 151643, 151643, 151643, 151643, 151643, 151643, 151643, 151643, 151643, 151643, 151643, 151643, 151643, 151643, 151643, 151643, 151643, 151643, 151643, 151643, 151643, 151643, 151643, 151643, 151643, 151643, 151643, 151643, 151643, 151643, 151643, 151643, 151643, 151643, 151643, 151643, 151643, 151643, 151643, 151643, 151643, 151643, 151643, 151643, 151643, 151643, 151643, 151643, 151643, 151643, 151643, 151643, 151643, 151643, 151643, 151643, 151643, 151643, 151643, 151643, 151643, 151643, 151643, 151643, 151643, 151643, 151643, 151643, 151643, 151643, 151643, 151643, 151643, 151643, 151643, 151643, 151643, 151643, 151643, 151643, 151643, 151643, 151643, 151643, 151643, 151643, 151643, 151643, 151643, 151643, 151643, 151643, 151643, 151643, 151643, 151643, 151643, 151643, 151643, 151643, 151643, 151643, 151643, 151643, 151643, 151643, 151643, 151643, 151643, 151643, 151643, 151643, 151643, 151643, 151643, 151643, 151643, 151643, 151643, 151643, 151643, 151643, 151643, 151643, 151643, 151643, 151643, 151643, 151643, 151643, 151643, 151643, 151643, 151643, 151643, 151643, 151643, 151643, 151643, 151643, 151643, 151643, 151643, 151643, 151643, 151643, 151643, 151643, 151643, 151643, 151643, 151643, 151643, 151643, 151643, 151643, 151643, 151643, 151643, 151643, 151643, 151643, 151643, 151643, 151643, 151643, 151643, 151643, 151643, 151643, 151643, 151643, 151643, 151643, 151643, 151643, 151643, 151643, 151643, 151643, 151643, 151643, 151643, 151643, 151643, 151643, 151643, 151643, 151643, 151643, 151643, 151643, 151643, 151643, 151643, 151643, 151643, 151643, 151643, 151643, 151643, 151643, 151643, 151643, 151643, 151643, 151643, 151643, 151643, 151643, 151643, 151643, 151643, 151643, 151643, 151643, 151643, 151643, 151643, 151643, 151643, 151643, 151643, 151643, 151643, 151643, 151643, 151643, 151643, 151643, 151643, 151643, 151643, 151643, 151643, 151643, 151643, 151643, 151643, 151643, 151643, 151643, 151643, 151643, 151643, 151643, 151643, 151643, 151643, 151643, 151643, 151643, 151643, 151643, 151643, 151643, 151643, 151643, 151643, 151643, 151643, 151643, 151643, 151643, 151643, 151643, 151643, 151643, 151643, 151643, 151643, 151643, 151643, 151643, 151643, 151643, 151643, 151643, 151643, 151643, 151643, 151643, 151643, 151643, 151643, 151643, 151643, 151643, 151643, 151643, 151643, 151643, 151643, 151643, 151643, 151643, 151643, 151643, 151643, 151643, 151643, 151643, 151643, 151643, 151643, 151643, 151644, 8948, 198, 2610, 525, 1207, 16948, 11, 3465, 553, 54364, 14817, 13, 1446, 525, 264, 10950, 17847, 13, 151645, 198, 151644, 872, 198, 16141, 279, 2701, 5248, 5754, 3405, 13, 576, 1537, 1555, 315, 697, 2033, 1265, 387, 315, 279, 2701, 3561, 25, 364, 16141, 25, 400, 20756, 4198, 6, 320, 28996, 17194, 8, 1380, 44428, 374, 825, 315, 19360, 35, 13, 21149, 3019, 553, 3019, 1573, 35764, 382, 47866, 279, 1197, 11866, 3288, 315, 20628, 2022, 979, 220, 20, 15, 15, 64070, 220, 15, 13, 17, 386, 472, 5066, 11, 220, 18, 15, 15, 64070, 220, 15, 13, 18, 386, 472, 17, 13880, 19, 323, 220, 17, 15, 15, 64070, 220, 15, 13, 20, 386, 14322, 19238, 39, 8, 17, 525, 9519, 382, 32, 8, 481, 18, 13, 23, 15, 95003, 198, 33, 8, 481, 16, 21, 13, 15, 595, 41, 198, 34, 8, 481, 17, 13, 22, 17, 95003, 198, 35, 8, 481, 16, 16, 13, 19, 17, 95003, 151645, 198, 151644, 77091, 198]",,167,806,973,1.0,1.0
776ef3a3-bf74-4b9b-820c-f9d77952ca90,7,19,"[151643, 151643, 151643, 151643, 151643, 151643, 151643, 151643, 151643, 151643, 151643, 151643, 151643, 151643, 151643, 151643, 151643, 151643, 151643, 151643, 151643, 151643, 151643, 151643, 151643, 151643, 151643, 151643, 151643, 151643, 151643, 151643, 151643, 151643, 151643, 151643, 151643, 151643, 151643, 151643, 151643, 151643, 151643, 151643, 151643, 151643, 151643, 151643, 151643, 151643, 151643, 151643, 151643, 151643, 151643, 151643, 151643, 151643, 151643, 151643, 151643, 151643, 151643, 151643, 151643, 151643, 151643, 151643, 151643, 151643, 151643, 151643, 151643, 151643, 151643, 151643, 151643, 151643, 151643, 151643, 151643, 151643, 151643, 151643, 151643, 151643, 151643, 151643, 151643, 151643, 151643, 151643, 151643, 151643, 151643, 151643, 151643, 151643, 151643, 151643, 151643, 151643, 151643, 151643, 151643, 151643, 151643, 151643, 151643, 151643, 151643, 151643, 151643, 151643, 151643, 151643, 151643, 151643, 151643, 151643, 151643, 151643, 151643, 151643, 151643, 151643, 151643, 151643, 151643, 151643, 151643, 151643, 151643, 151643, 151643, 151643, 151643, 151643, 151643, 151643, 151643, 151643, 151643, 151643, 151643, 151643, 151643, 151643, 151643, 151643, 151643, 151643, 151643, 151643, 151643, 151643, 151643, 151643, 151643, 151643, 151643, 151643, 151643, 151643, 151643, 151643, 151643, 151643, 151643, 151643, 151643, 151643, 151643, 151643, 151643, 151643, 151643, 151643, 151643, 151643, 151643, 151643, 151643, 151643, 151643, 151643, 151643, 151643, 151643, 151643, 151643, 151643, 151643, 151643, 151643, 151643, 151643, 151643, 151643, 151643, 151643, 151643, 151643, 151643, 151643, 151643, 151643, 151643, 151643, 151643, 151643, 151643, 151643, 151643, 151643, 151643, 151643, 151643, 151643, 151643, 151643, 151643, 151643, 151643, 151643, 151643, 151643, 151643, 151643, 151643, 151643, 151643, 151643, 151643, 151643, 151643, 151643, 151643, 151643, 151643, 151643, 151643, 151643, 151643, 151643, 151643, 151643, 151643, 151643, 151643, 151643, 151643, 151643, 151643, 151643, 151643, 151643, 151643, 151643, 151643, 151643, 151643, 151643, 151643, 151643, 151643, 151643, 151643, 151643, 151643, 151643, 151643, 151643, 151643, 151643, 151643, 151643, 151643, 151643, 151643, 151643, 151643, 151643, 151643, 151643, 151643, 151643, 151643, 151643, 151643, 151643, 151643, 151643, 151643, 151643, 151643, 151643, 151643, 151643, 151643, 151643, 151643, 151643, 151643, 151643, 151643, 151643, 151643, 151643, 151643, 151643, 151643, 151643, 151643, 151643, 151643, 151643, 151643, 151643, 151643, 151643, 151643, 151643, 151643, 151643, 151643, 151643, 151643, 151643, 151643, 151643, 151643, 151643, 151643, 151643, 151643, 151643, 151643, 151643, 151643, 151643, 151643, 151643, 151643, 151643, 151643, 151643, 151643, 151643, 151643, 151643, 151643, 151643, 151643, 151643, 151643, 151643, 151643, 151643, 151643, 151643, 151643, 151643, 151643, 151643, 151643, 151643, 151643, 151643, 151643, 151643, 151643, 151643, 151643, 151643, 151643, 151643, 151643, 151643, 151643, 151643, 151643, 151643, 151643, 151643, 151643, 151643, 151643, 151643, 151643, 151643, 151643, 151643, 151643, 151643, 151643, 151643, 151643, 151643, 151643, 151643, 151643, 151643, 151643, 151643, 151643, 151643, 151643, 151643, 151643, 151643, 151643, 151643, 151643, 151643, 151643, 151643, 151643, 151643, 151643, 151643, 151643, 151643, 151643, 151643, 151643, 151643, 151643, 151643, 151643, 151643, 151643, 151643, 151643, 151643, 151643, 151643, 151643, 151643, 151643, 151643, 151643, 151643, 151643, 151643, 151643, 151643, 151643, 151643, 151643, 151643, 151643, 151643, 151643, 151643, 151643, 151643, 151643, 151643, 151643, 151643, 151643, 151643, 151643, 151643, 151643, 151643, 151643, 151643, 151643, 151643, 151643, 151643, 151643, 151643, 151643, 151643, 151643, 151643, 151643, 151643, 151643, 151643, 151643, 151643, 151643, 151643, 151643, 151643, 151643, 151643, 151643, 151643, 151643, 151643, 151643, 151643, 151643, 151643, 151643, 151643, 151643, 151643, 151643, 151643, 151643, 151643, 151643, 151643, 151643, 151643, 151643, 151643, 151643, 151643, 151643, 151643, 151643, 151643, 151643, 151643, 151643, 151643, 151643, 151643, 151643, 151643, 151643, 151643, 151643, 151643, 151643, 151643, 151643, 151643, 151643, 151643, 151643, 151643, 151643, 151643, 151643, 151643, 151643, 151643, 151643, 151643, 151643, 151643, 151643, 151643, 151643, 151643, 151643, 151643, 151643, 151643, 151643, 151643, 151643, 151643, 151643, 151643, 151643, 151643, 151643, 151643, 151643, 151643, 151643, 151643, 151643, 151643, 151643, 151643, 151643, 151643, 151643, 151643, 151643, 151643, 151643, 151643, 151643, 151643, 151643, 151643, 151643, 151643, 151643, 151643, 151643, 151643, 151643, 151643, 151643, 151643, 151643, 151643, 151643, 151643, 151643, 151643, 151643, 151643, 151643, 151643, 151643, 151643, 151643, 151643, 151643, 151643, 151643, 151643, 151643, 151643, 151643, 151643, 151643, 151643, 151643, 151643, 151643, 151643, 151643, 151643, 151643, 151643, 151643, 151643, 151643, 151643, 151643, 151643, 151643, 151643, 151643, 151643, 151643, 151643, 151643, 151643, 151643, 151643, 151643, 151643, 151643, 151643, 151643, 151643, 151643, 151643, 151643, 151643, 151643, 151643, 151643, 151643, 151643, 151643, 151643, 151643, 151643, 151643, 151643, 151643, 151643, 151643, 151643, 151643, 151643, 151643, 151643, 151643, 151643, 151643, 151643, 151643, 151643, 151643, 151643, 151643, 151643, 151643, 151643, 151643, 151643, 151643, 151643, 151643, 151643, 151643, 151643, 151643, 151643, 151643, 151643, 151643, 151643, 151643, 151643, 151643, 151643, 151643, 151643, 151643, 151643, 151643, 151643, 151643, 151643, 151643, 151643, 151643, 151643, 151643, 151643, 151643, 151643, 151643, 151643, 151643, 151643, 151643, 151643, 151643, 151643, 151643, 151643, 151643, 151643, 151643, 151643, 151643, 151643, 151643, 151643, 151643, 151643, 151643, 151643, 151643, 151643, 151643, 151643, 151643, 151643, 151643, 151643, 151643, 151643, 151643, 151643, 151643, 151643, 151643, 151643, 151643, 151643, 151643, 151643, 151643, 151643, 151643, 151643, 151643, 151643, 151643, 151643, 151643, 151643, 151643, 151643, 151643, 151643, 151643, 151643, 151643, 151643, 151643, 151643, 151643, 151643, 151643, 151643, 151643, 151643, 151643, 151643, 151643, 151643, 151643, 151643, 151643, 151643, 151643, 151643, 151643, 151643, 151643, 151643, 151643, 151643, 151643, 151643, 151643, 151643, 151643, 151643, 151643, 151643, 151643, 151643, 151643, 151643, 151643, 151643, 151643, 151643, 151643, 151643, 151643, 151643, 151643, 151643, 151643, 151644, 8948, 198, 2610, 525, 1207, 16948, 11, 3465, 553, 54364, 14817, 13, 1446, 525, 264, 10950, 17847, 13, 151645, 198, 151644, 872, 198, 16141, 279, 2701, 5248, 5754, 3405, 13, 576, 1537, 1555, 315, 697, 2033, 1265, 387, 315, 279, 2701, 3561, 25, 364, 16141, 25, 400, 20756, 4198, 6, 320, 28996, 17194, 8, 1380, 44428, 374, 825, 315, 19360, 35, 13, 21149, 3019, 553, 3019, 1573, 35764, 382, 32, 11483, 12720, 369, 279, 38875, 315, 264, 1985, 8482, 472, 10, 27672, 572, 38447, 518, 3054, 9315, 323, 36043, 220, 16, 13, 220, 11429, 56122, 458, 9788, 19699, 572, 20866, 1119, 279, 4303, 12720, 3259, 279, 4379, 315, 279, 12720, 28393, 369, 279, 1985, 18003, 323, 279, 5476, 2684, 4017, 4152, 311, 458, 505, 1575, 21220, 12720, 13, 576, 36043, 897, 315, 279, 6291, 5497, 311, 220, 19, 1283, 419, 48916, 5256, 13, 3555, 646, 387, 279, 3204, 2874, 369, 10018, 279, 4379, 315, 12720, 1939, 32, 8, 576, 7172, 7262, 315, 279, 6291, 198, 33, 8, 576, 7172, 8123, 315, 279, 6291, 198, 34, 8, 576, 7172, 36043, 315, 279, 6291, 198, 35, 8, 576, 7172, 9315, 315, 279, 6291, 151645, 198, 151644, 77091, 198]",,197,287,484,0.0,0.0
90943fc3-842c-4053-9b5f-e00e2eae11ff,7,20,"[151643, 151643, 151643, 151643, 151643, 151643, 151643, 151643, 151643, 151643, 151643, 151643, 151643, 151643, 151643, 151643, 151643, 151643, 151643, 151643, 151643, 151643, 151643, 151643, 151643, 151643, 151643, 151643, 151643, 151643, 151643, 151643, 151643, 151643, 151643, 151643, 151643, 151643, 151643, 151643, 151643, 151643, 151643, 151643, 151643, 151643, 151643, 151643, 151643, 151643, 151643, 151643, 151643, 151643, 151643, 151643, 151643, 151643, 151643, 151643, 151643, 151643, 151643, 151643, 151643, 151643, 151643, 151643, 151643, 151643, 151643, 151643, 151643, 151643, 151643, 151643, 151643, 151643, 151643, 151643, 151643, 151643, 151643, 151643, 151643, 151643, 151643, 151643, 151643, 151643, 151643, 151643, 151643, 151643, 151643, 151643, 151643, 151643, 151643, 151643, 151643, 151643, 151643, 151643, 151643, 151643, 151643, 151643, 151643, 151643, 151643, 151643, 151643, 151643, 151643, 151643, 151643, 151643, 151643, 151643, 151643, 151643, 151643, 151643, 151643, 151643, 151643, 151643, 151643, 151643, 151643, 151643, 151643, 151643, 151643, 151643, 151643, 151643, 151643, 151643, 151643, 151643, 151643, 151643, 151643, 151643, 151643, 151643, 151643, 151643, 151643, 151643, 151643, 151643, 151643, 151643, 151643, 151643, 151643, 151643, 151643, 151643, 151643, 151643, 151643, 151643, 151643, 151643, 151643, 151643, 151643, 151643, 151643, 151643, 151643, 151643, 151643, 151643, 151643, 151643, 151643, 151643, 151643, 151643, 151643, 151643, 151643, 151643, 151643, 151643, 151643, 151643, 151643, 151643, 151643, 151643, 151643, 151643, 151643, 151643, 151643, 151643, 151643, 151643, 151643, 151643, 151643, 151643, 151643, 151643, 151643, 151643, 151643, 151643, 151643, 151643, 151643, 151643, 151643, 151643, 151643, 151643, 151643, 151643, 151643, 151643, 151643, 151643, 151643, 151643, 151643, 151643, 151643, 151643, 151643, 151643, 151643, 151643, 151643, 151643, 151643, 151643, 151643, 151643, 151643, 151643, 151643, 151643, 151643, 151643, 151643, 151643, 151643, 151643, 151643, 151643, 151643, 151643, 151643, 151643, 151643, 151643, 151643, 151643, 151643, 151643, 151643, 151643, 151643, 151643, 151643, 151643, 151643, 151643, 151643, 151643, 151643, 151643, 151643, 151643, 151643, 151643, 151643, 151643, 151643, 151643, 151643, 151643, 151643, 151643, 151643, 151643, 151643, 151643, 151643, 151643, 151643, 151643, 151643, 151643, 151643, 151643, 151643, 151643, 151643, 151643, 151643, 151643, 151643, 151643, 151643, 151643, 151643, 151643, 151643, 151643, 151643, 151643, 151643, 151643, 151643, 151643, 151643, 151643, 151643, 151643, 151643, 151643, 151643, 151643, 151643, 151643, 151643, 151643, 151643, 151643, 151643, 151643, 151643, 151643, 151643, 151643, 151643, 151643, 151643, 151643, 151643, 151643, 151643, 151643, 151643, 151643, 151643, 151643, 151643, 151643, 151643, 151643, 151643, 151643, 151643, 151643, 151643, 151643, 151643, 151643, 151643, 151643, 151643, 151643, 151643, 151643, 151643, 151643, 151643, 151643, 151643, 151643, 151643, 151643, 151643, 151643, 151643, 151643, 151643, 151643, 151643, 151643, 151643, 151643, 151643, 151643, 151643, 151643, 151643, 151643, 151643, 151643, 151643, 151643, 151643, 151643, 151643, 151643, 151643, 151643, 151643, 151643, 151643, 151643, 151643, 151643, 151643, 151643, 151643, 151643, 151643, 151643, 151643, 151643, 151643, 151643, 151643, 151643, 151643, 151643, 151643, 151643, 151643, 151643, 151643, 151643, 151643, 151643, 151643, 151643, 151643, 151643, 151643, 151643, 151643, 151643, 151643, 151643, 151643, 151643, 151643, 151643, 151643, 151643, 151643, 151643, 151643, 151643, 151643, 151643, 151643, 151643, 151643, 151643, 151643, 151643, 151643, 151643, 151643, 151643, 151643, 151643, 151643, 151643, 151643, 151643, 151643, 151643, 151643, 151643, 151643, 151643, 151643, 151643, 151643, 151643, 151643, 151643, 151643, 151643, 151643, 151643, 151643, 151643, 151643, 151643, 151643, 151643, 151643, 151643, 151643, 151643, 151643, 151643, 151643, 151643, 151643, 151643, 151643, 151643, 151643, 151643, 151643, 151643, 151643, 151643, 151643, 151643, 151643, 151643, 151643, 151643, 151643, 151643, 151643, 151643, 151643, 151643, 151643, 151643, 151643, 151643, 151643, 151643, 151643, 151643, 151643, 151643, 151643, 151643, 151643, 151643, 151643, 151643, 151643, 151643, 151643, 151643, 151643, 151643, 151643, 151643, 151643, 151643, 151643, 151643, 151643, 151643, 151643, 151643, 151643, 151643, 151643, 151643, 151643, 151643, 151643, 151643, 151643, 151643, 151643, 151643, 151643, 151643, 151643, 151643, 151643, 151643, 151643, 151643, 151643, 151643, 151643, 151643, 151643, 151643, 151643, 151643, 151643, 151643, 151643, 151643, 151643, 151643, 151643, 151643, 151643, 151643, 151643, 151643, 151643, 151643, 151643, 151643, 151643, 151643, 151643, 151643, 151643, 151643, 151643, 151643, 151643, 151643, 151643, 151643, 151643, 151643, 151643, 151643, 151643, 151643, 151643, 151643, 151643, 151643, 151643, 151643, 151643, 151643, 151643, 151643, 151643, 151643, 151643, 151643, 151643, 151643, 151643, 151643, 151643, 151643, 151643, 151643, 151643, 151643, 151643, 151643, 151643, 151643, 151643, 151643, 151643, 151643, 151643, 151643, 151643, 151643, 151643, 151643, 151643, 151643, 151643, 151643, 151643, 151643, 151643, 151643, 151643, 151643, 151643, 151643, 151643, 151643, 151643, 151643, 151643, 151643, 151643, 151643, 151643, 151643, 151643, 151643, 151643, 151643, 151644, 8948, 198, 2610, 525, 1207, 16948, 11, 3465, 553, 54364, 14817, 13, 1446, 525, 264, 10950, 17847, 13, 151645, 198, 151644, 872, 198, 16141, 279, 2701, 5248, 5754, 3405, 13, 576, 1537, 1555, 315, 697, 2033, 1265, 387, 315, 279, 2701, 3561, 25, 364, 16141, 25, 400, 20756, 4198, 6, 320, 28996, 17194, 8, 1380, 44428, 374, 825, 315, 19360, 35, 13, 21149, 3019, 553, 3019, 1573, 35764, 382, 37175, 279, 809, 41387, 315, 279, 46601, 20314, 23270, 5675, 11, 362, 315, 264, 11834, 263, 387, 15251, 553, 264, 220, 17, 17568, 17, 6172, 23905, 36054, 279, 28724, 957, 23606, 23905, 7, 85034, 8, 284, 264, 7, 85034, 568, 5692, 11, 264, 374, 279, 28724, 957, 11, 97875, 374, 279, 28724, 1688, 13, 576, 6172, 5675, 702, 279, 1352, 23905, 284, 272, 144498, 50, 26, 1380, 279, 6783, 272, 54113, 14, 19, 48245, 323, 328, 1660, 264, 220, 17, 17568, 17, 6172, 13, 576, 1156, 2802, 315, 279, 6172, 328, 374, 320, 15, 256, 481, 72, 8, 323, 279, 2086, 2802, 374, 320, 72, 220, 220, 15, 568, 1446, 525, 4588, 311, 11047, 279, 28724, 957, 323, 34734, 3160, 10605, 315, 279, 5675, 23905, 13, 11954, 279, 21937, 11, 892, 5114, 3685, 686, 498, 2908, 311, 387, 4396, 1939, 32, 8, 576, 49952, 949, 315, 279, 28724, 957, 315, 23905, 525, 488, 16, 14, 17, 476, 1365, 16, 14, 17, 11, 323, 279, 1931, 949, 315, 429, 525, 488, 16, 476, 1365, 16, 624, 33, 8, 576, 28724, 21409, 97875, 315, 279, 5675, 23905, 525, 279, 8037, 5746, 315, 279, 6172, 5675, 23905, 2661, 3403, 624, 34, 8, 576, 49952, 949, 315, 279, 28724, 957, 315, 23905, 525, 488, 17, 48245, 71, 476, 1365, 17, 48245, 71, 11, 323, 279, 1931, 949, 315, 429, 525, 488, 71, 14, 19, 48245, 476, 1365, 71, 14, 19, 48245, 624, 35, 8, 576, 28724, 1688, 315, 279, 5675, 23905, 646, 1083, 387, 458, 28724, 1688, 315, 362, 61, 17, 11, 714, 537, 315, 279, 1863, 41387, 11, 15395, 13, 151645, 198, 151644, 77091, 198]",,342,719,1061,0.0,0.0
398d0f1e-8148-4c12-8ca6-9adcf137b792,7,21,"[151643, 151643, 151643, 151643, 151643, 151643, 151643, 151643, 151643, 151643, 151643, 151643, 151643, 151643, 151643, 151643, 151643, 151643, 151643, 151643, 151643, 151643, 151643, 151643, 151643, 151643, 151643, 151643, 151643, 151643, 151643, 151643, 151643, 151643, 151643, 151643, 151643, 151643, 151643, 151643, 151643, 151643, 151643, 151643, 151643, 151643, 151643, 151643, 151643, 151643, 151643, 151643, 151643, 151643, 151643, 151643, 151643, 151643, 151643, 151643, 151643, 151643, 151643, 151643, 151643, 151643, 151643, 151643, 151643, 151643, 151643, 151643, 151643, 151643, 151643, 151643, 151643, 151643, 151643, 151643, 151643, 151643, 151643, 151643, 151643, 151643, 151643, 151643, 151643, 151643, 151643, 151643, 151643, 151643, 151643, 151643, 151643, 151643, 151643, 151643, 151643, 151643, 151643, 151643, 151643, 151643, 151643, 151643, 151643, 151643, 151643, 151643, 151643, 151643, 151643, 151643, 151643, 151643, 151643, 151643, 151643, 151643, 151643, 151643, 151643, 151643, 151643, 151643, 151643, 151643, 151643, 151643, 151643, 151643, 151643, 151643, 151643, 151643, 151643, 151643, 151643, 151643, 151643, 151643, 151643, 151643, 151643, 151643, 151643, 151643, 151643, 151643, 151643, 151643, 151643, 151643, 151643, 151643, 151643, 151643, 151643, 151643, 151643, 151643, 151643, 151643, 151643, 151643, 151643, 151643, 151643, 151643, 151643, 151643, 151643, 151643, 151643, 151643, 151643, 151643, 151643, 151643, 151643, 151643, 151643, 151643, 151643, 151643, 151643, 151643, 151643, 151643, 151643, 151643, 151643, 151643, 151643, 151643, 151643, 151643, 151643, 151643, 151643, 151643, 151643, 151643, 151643, 151643, 151643, 151643, 151643, 151643, 151643, 151643, 151643, 151643, 151643, 151643, 151643, 151643, 151643, 151643, 151643, 151643, 151643, 151643, 151643, 151643, 151643, 151643, 151643, 151643, 151643, 151643, 151643, 151643, 151643, 151643, 151643, 151643, 151643, 151643, 151643, 151643, 151643, 151643, 151643, 151643, 151643, 151643, 151643, 151643, 151643, 151643, 151643, 151643, 151643, 151643, 151643, 151643, 151643, 151643, 151643, 151643, 151643, 151643, 151643, 151643, 151643, 151643, 151643, 151643, 151643, 151643, 151643, 151643, 151643, 151643, 151643, 151643, 151643, 151643, 151643, 151643, 151643, 151643, 151643, 151643, 151643, 151643, 151643, 151643, 151643, 151643, 151643, 151643, 151643, 151643, 151643, 151643, 151643, 151643, 151643, 151643, 151643, 151643, 151643, 151643, 151643, 151643, 151643, 151643, 151643, 151643, 151643, 151643, 151643, 151643, 151643, 151643, 151643, 151643, 151643, 151643, 151643, 151643, 151643, 151643, 151643, 151643, 151643, 151643, 151643, 151643, 151643, 151643, 151643, 151643, 151643, 151643, 151643, 151643, 151643, 151643, 151643, 151643, 151643, 151643, 151643, 151643, 151643, 151643, 151643, 151643, 151643, 151643, 151643, 151643, 151643, 151643, 151643, 151643, 151643, 151643, 151643, 151643, 151643, 151643, 151643, 151643, 151643, 151643, 151643, 151643, 151643, 151643, 151643, 151643, 151643, 151643, 151643, 151643, 151643, 151643, 151643, 151643, 151643, 151643, 151643, 151643, 151643, 151643, 151643, 151643, 151643, 151643, 151643, 151643, 151643, 151643, 151643, 151643, 151643, 151643, 151643, 151643, 151643, 151643, 151643, 151643, 151643, 151643, 151643, 151643, 151643, 151643, 151643, 151643, 151643, 151643, 151643, 151643, 151643, 151643, 151643, 151643, 151643, 151643, 151643, 151643, 151643, 151643, 151643, 151643, 151643, 151643, 151643, 151643, 151643, 151643, 151643, 151643, 151643, 151643, 151643, 151643, 151643, 151643, 151643, 151643, 151643, 151643, 151643, 151643, 151643, 151643, 151643, 151643, 151643, 151643, 151643, 151643, 151643, 151643, 151643, 151643, 151643, 151643, 151643, 151643, 151643, 151643, 151643, 151643, 151643, 151643, 151643, 151643, 151643, 151643, 151643, 151643, 151644, 8948, 198, 2610, 525, 1207, 16948, 11, 3465, 553, 54364, 14817, 13, 1446, 525, 264, 10950, 17847, 13, 151645, 198, 151644, 872, 198, 16141, 279, 2701, 5248, 5754, 3405, 13, 576, 1537, 1555, 315, 697, 2033, 1265, 387, 315, 279, 2701, 3561, 25, 364, 16141, 25, 400, 20756, 4198, 6, 320, 28996, 17194, 8, 1380, 44428, 374, 825, 315, 19360, 35, 13, 21149, 3019, 553, 3019, 1573, 35764, 382, 51057, 264, 1459, 6757, 2804, 374, 7218, 448, 264, 34682, 57960, 4083, 84386, 25547, 83, 15087, 11, 1380, 259, 374, 882, 11, 448, 5091, 311, 279, 6238, 13, 6771, 57960, 4083, 90, 81, 31716, 387, 279, 2070, 1459, 11, 1380, 279, 2070, 374, 13166, 11, 448, 5091, 311, 279, 6238, 315, 279, 1852, 5785, 4034, 11, 323, 220, 57960, 4083, 90, 67, 31716, 387, 279, 4621, 504, 279, 1459, 1380, 279, 65569, 2070, 572, 7907, 518, 1045, 6788, 882, 400, 376, 3, 311, 279, 21930, 1459, 57960, 4083, 90, 81, 92, 12947, 576, 15435, 315, 279, 7218, 6757, 2804, 518, 279, 2070, 23163, 9690, 400, 376, 3, 374, 57960, 4083, 90, 85, 92, 12947, 3555, 525, 279, 17274, 4650, 320, 53, 8, 323, 4621, 4650, 19788, 4083, 90, 32, 5410, 518, 882, 259, 11, 36054, 400, 83, 861, 489, 54876, 323, 2309, 57960, 4083, 90, 81, 31716, 30, 758, 19009, 279, 23393, 11, 990, 279, 44197, 315, 400, 66, 36726, 3100, 4628, 304, 28202, 11, 57960, 7124, 321, 10148, 1464, 3, 11549, 1927, 315, 1910, 3550, 323, 57960, 15128, 14179, 3, 374, 279, 54324, 2897, 382, 32, 8, 647, 11520, 4083, 90, 81, 2137, 83, 8, 284, 1124, 67, 37018, 90, 80, 15170, 19, 59, 2493, 59, 31767, 14179, 435, 2137, 1124, 4083, 90, 32, 11520, 4083, 90, 81, 2137, 83, 9139, 284, 1124, 67, 37018, 35702, 4083, 90, 85, 3417, 90, 66, 61, 17, 92, 647, 11520, 4083, 90, 81, 2137, 83, 340, 33, 8, 647, 11520, 4083, 90, 81, 2137, 83, 8, 284, 1124, 67, 37018, 90, 59833, 15170, 19, 59, 2493, 59, 31767, 14179, 320, 67, 272, 481, 1124, 4083, 90, 67, 7810, 1124, 4083, 90, 85, 5410, 2137, 220, 1124, 4083, 90, 32, 11520, 4083, 90, 81, 2137, 83, 9139, 284, 1124, 67, 37018, 35702, 15128, 14179, 77066, 1124, 4083, 90, 85, 3417, 90, 19, 59, 2493, 320, 67, 272, 481, 1124, 4083, 90, 67, 7810, 1124, 4083, 90, 85, 92753, 34, 8, 647, 11520, 4083, 90, 81, 2137, 83, 8, 284, 1124, 67, 37018, 90, 80, 15170, 19, 59, 2493, 59, 31767, 14179, 435, 2137, 220, 1124, 4083, 90, 32, 11520, 4083, 90, 81, 2137, 83, 9139, 284, 1124, 67, 37018, 35702, 4083, 90, 85, 61, 17, 3417, 90, 66, 61, 17, 92, 647, 11520, 4083, 90, 81, 2137, 83, 340, 35, 8, 647, 11520, 4083, 90, 81, 2137, 83, 8, 284, 1124, 67, 37018, 90, 59833, 15170, 19, 59, 2493, 59, 31767, 14179, 320, 67, 272, 488, 1124, 4083, 90, 67, 7810, 1124, 4083, 90, 85, 5410, 2137, 220, 1124, 4083, 90, 32, 11520, 4083, 90, 81, 2137, 83, 9139, 284, 1124, 67, 37018, 35702, 15128, 77066, 1124, 4083, 90, 85, 3417, 90, 19, 59, 2493, 320, 67, 272, 488, 1124, 4083, 90, 67, 7810, 1124, 4083, 90, 85, 5410, 92, 151645, 198, 151644, 77091, 198]",,542,376,918,1.0,1.0
ec7dbbff-8189-4f56-990a-eecfd6126f15,7,22,"[151643, 151643, 151643, 151643, 151643, 151643, 151643, 151643, 151643, 151643, 151643, 151643, 151643, 151643, 151643, 151643, 151643, 151643, 151643, 151643, 151643, 151643, 151643, 151643, 151643, 151643, 151643, 151643, 151643, 151643, 151643, 151643, 151643, 151643, 151643, 151643, 151643, 151643, 151643, 151643, 151643, 151643, 151643, 151643, 151643, 151643, 151643, 151643, 151643, 151643, 151643, 151643, 151643, 151643, 151643, 151643, 151643, 151643, 151643, 151643, 151643, 151643, 151643, 151643, 151643, 151643, 151643, 151643, 151643, 151643, 151643, 151643, 151643, 151643, 151643, 151643, 151643, 151643, 151643, 151643, 151643, 151643, 151643, 151643, 151643, 151643, 151643, 151643, 151643, 151643, 151643, 151643, 151643, 151643, 151643, 151643, 151643, 151643, 151643, 151643, 151643, 151643, 151643, 151643, 151643, 151643, 151643, 151643, 151643, 151643, 151643, 151643, 151643, 151643, 151643, 151643, 151643, 151643, 151643, 151643, 151643, 151643, 151643, 151643, 151643, 151643, 151643, 151643, 151643, 151643, 151643, 151643, 151643, 151643, 151643, 151643, 151643, 151643, 151643, 151643, 151643, 151643, 151643, 151643, 151643, 151643, 151643, 151643, 151643, 151643, 151643, 151643, 151643, 151643, 151643, 151643, 151643, 151643, 151643, 151643, 151643, 151643, 151643, 151643, 151643, 151643, 151643, 151643, 151643, 151643, 151643, 151643, 151643, 151643, 151643, 151643, 151643, 151643, 151643, 151643, 151643, 151643, 151643, 151643, 151643, 151643, 151643, 151643, 151643, 151643, 151643, 151643, 151643, 151643, 151643, 151643, 151643, 151643, 151643, 151643, 151643, 151643, 151643, 151643, 151643, 151643, 151643, 151643, 151643, 151643, 151643, 151643, 151643, 151643, 151643, 151643, 151643, 151643, 151643, 151643, 151643, 151643, 151643, 151643, 151643, 151643, 151643, 151643, 151643, 151643, 151643, 151643, 151643, 151643, 151643, 151643, 151643, 151643, 151643, 151643, 151643, 151643, 151643, 151643, 151643, 151643, 151643, 151643, 151643, 151643, 151643, 151643, 151643, 151643, 151643, 151643, 151643, 151643, 151643, 151643, 151643, 151643, 151643, 151643, 151643, 151643, 151643, 151643, 151643, 151643, 151643, 151643, 151643, 151643, 151643, 151643, 151643, 151643, 151643, 151643, 151643, 151643, 151643, 151643, 151643, 151643, 151643, 151643, 151643, 151643, 151643, 151643, 151643, 151643, 151643, 151643, 151643, 151643, 151643, 151643, 151643, 151643, 151643, 151643, 151643, 151643, 151643, 151643, 151643, 151643, 151643, 151643, 151643, 151643, 151643, 151643, 151643, 151643, 151643, 151643, 151643, 151643, 151643, 151643, 151643, 151643, 151643, 151643, 151643, 151643, 151643, 151643, 151643, 151643, 151643, 151643, 151643, 151643, 151643, 151643, 151643, 151643, 151643, 151643, 151643, 151643, 151643, 151643, 151643, 151643, 151643, 151643, 151643, 151643, 151643, 151643, 151643, 151643, 151643, 151643, 151643, 151643, 151643, 151643, 151643, 151643, 151643, 151643, 151643, 151643, 151643, 151643, 151643, 151643, 151643, 151643, 151643, 151643, 151643, 151643, 151643, 151643, 151643, 151643, 151643, 151643, 151643, 151643, 151643, 151643, 151643, 151643, 151643, 151643, 151643, 151643, 151643, 151643, 151643, 151643, 151643, 151643, 151643, 151643, 151643, 151643, 151643, 151643, 151643, 151643, 151643, 151643, 151643, 151643, 151643, 151643, 151643, 151643, 151643, 151643, 151643, 151643, 151643, 151643, 151643, 151643, 151643, 151643, 151643, 151643, 151643, 151643, 151643, 151643, 151643, 151643, 151643, 151643, 151643, 151643, 151643, 151643, 151643, 151643, 151643, 151643, 151643, 151643, 151643, 151643, 151643, 151643, 151643, 151643, 151643, 151643, 151643, 151643, 151643, 151643, 151643, 151643, 151643, 151643, 151643, 151643, 151643, 151643, 151643, 151643, 151643, 151643, 151643, 151643, 151643, 151643, 151643, 151643, 151643, 151643, 151643, 151643, 151643, 151643, 151643, 151643, 151643, 151643, 151643, 151643, 151643, 151643, 151643, 151643, 151643, 151643, 151643, 151643, 151643, 151643, 151643, 151643, 151643, 151643, 151643, 151643, 151643, 151643, 151643, 151643, 151643, 151643, 151643, 151643, 151643, 151643, 151643, 151643, 151643, 151643, 151643, 151643, 151643, 151643, 151643, 151643, 151643, 151643, 151643, 151643, 151643, 151643, 151643, 151643, 151643, 151643, 151643, 151643, 151643, 151643, 151643, 151643, 151643, 151643, 151643, 151643, 151643, 151643, 151643, 151643, 151643, 151643, 151643, 151643, 151643, 151643, 151643, 151643, 151643, 151643, 151643, 151643, 151643, 151643, 151643, 151643, 151643, 151643, 151643, 151643, 151643, 151643, 151643, 151643, 151643, 151643, 151643, 151643, 151643, 151643, 151643, 151643, 151643, 151643, 151643, 151643, 151643, 151643, 151643, 151643, 151643, 151643, 151643, 151643, 151643, 151643, 151643, 151643, 151643, 151643, 151643, 151643, 151643, 151643, 151643, 151643, 151643, 151643, 151643, 151643, 151643, 151643, 151643, 151643, 151643, 151643, 151643, 151643, 151643, 151643, 151643, 151643, 151643, 151643, 151643, 151643, 151643, 151643, 151643, 151643, 151643, 151643, 151643, 151643, 151643, 151643, 151643, 151643, 151643, 151643, 151643, 151643, 151643, 151643, 151643, 151643, 151643, 151643, 151643, 151643, 151643, 151643, 151643, 151643, 151643, 151643, 151643, 151643, 151643, 151643, 151643, 151643, 151643, 151643, 151643, 151643, 151643, 151643, 151643, 151643, 151643, 151643, 151643, 151643, 151643, 151643, 151643, 151643, 151643, 151643, 151643, 151643, 151643, 151643, 151643, 151643, 151643, 151643, 151643, 151643, 151643, 151643, 151643, 151643, 151643, 151643, 151643, 151643, 151643, 151643, 151643, 151643, 151643, 151643, 151643, 151643, 151643, 151643, 151643, 151643, 151643, 151643, 151643, 151643, 151643, 151643, 151643, 151643, 151643, 151643, 151643, 151643, 151643, 151643, 151643, 151643, 151643, 151643, 151643, 151643, 151643, 151643, 151643, 151643, 151643, 151643, 151643, 151643, 151643, 151643, 151643, 151643, 151643, 151643, 151643, 151643, 151643, 151643, 151643, 151643, 151643, 151643, 151643, 151643, 151643, 151643, 151643, 151643, 151643, 151643, 151643, 151643, 151643, 151643, 151643, 151643, 151643, 151643, 151643, 151643, 151643, 151643, 151643, 151643, 151643, 151643, 151643, 151643, 151643, 151643, 151643, 151643, 151643, 151643, 151643, 151643, 151643, 151643, 151643, 151643, 151643, 151643, 151643, 151643, 151643, 151643, 151643, 151643, 151643, 151643, 151643, 151643, 151643, 151643, 151643, 151643, 151643, 151643, 151643, 151643, 151643, 151643, 151644, 8948, 198, 2610, 525, 1207, 16948, 11, 3465, 553, 54364, 14817, 13, 1446, 525, 264, 10950, 17847, 13, 151645, 198, 151644, 872, 198, 16141, 279, 2701, 5248, 5754, 3405, 13, 576, 1537, 1555, 315, 697, 2033, 1265, 387, 315, 279, 2701, 3561, 25, 364, 16141, 25, 400, 20756, 4198, 6, 320, 28996, 17194, 8, 1380, 44428, 374, 825, 315, 19360, 35, 13, 21149, 3019, 553, 3019, 1573, 35764, 382, 35, 24308, 279, 5916, 3684, 4362, 311, 6782, 26887, 220, 20, 30430, 453, 887, 3923, 12, 18, 11, 19, 1737, 318, 41872, 66, 3337, 385, 17308, 12, 16, 12, 1952, 4566, 10058, 1786, 17831, 2270, 587, 13774, 382, 32, 8, 220, 19, 30430, 453, 887, 3923, 12, 20, 11, 21, 1737, 318, 769, 88, 385, 77519, 12, 16, 11, 22, 1737, 42568, 198, 33, 8, 220, 20, 30430, 453, 887, 3923, 12, 18, 11, 19, 1737, 318, 769, 88, 385, 77519, 12, 17, 11, 21, 1737, 42568, 198, 34, 8, 220, 20, 30430, 453, 887, 3923, 12, 18, 11, 19, 1737, 318, 769, 88, 385, 77519, 12, 16, 11, 22, 1737, 42568, 198, 35, 8, 220, 20, 30430, 453, 887, 3923, 12, 18, 11, 19, 1737, 318, 769, 88, 385, 77519, 12, 16, 11, 21, 1737, 42568, 151645, 198, 151644, 77091, 198]",,212,540,752,0.0,0.0
0897676e-61d3-4a2a-9464-2dad16b73c11,7,23,"[151643, 151643, 151643, 151643, 151643, 151643, 151643, 151643, 151643, 151643, 151643, 151643, 151643, 151643, 151643, 151643, 151643, 151643, 151643, 151643, 151643, 151643, 151643, 151643, 151643, 151643, 151643, 151643, 151643, 151643, 151643, 151643, 151643, 151643, 151643, 151643, 151643, 151643, 151643, 151643, 151643, 151643, 151643, 151643, 151643, 151643, 151643, 151643, 151643, 151643, 151643, 151643, 151643, 151643, 151643, 151643, 151643, 151643, 151643, 151643, 151643, 151643, 151643, 151643, 151643, 151643, 151643, 151643, 151643, 151643, 151643, 151643, 151643, 151643, 151643, 151643, 151643, 151643, 151643, 151643, 151643, 151643, 151643, 151643, 151643, 151643, 151643, 151643, 151643, 151643, 151643, 151643, 151643, 151643, 151643, 151643, 151643, 151643, 151643, 151643, 151643, 151643, 151643, 151643, 151643, 151643, 151643, 151643, 151643, 151643, 151643, 151643, 151643, 151643, 151643, 151643, 151643, 151643, 151643, 151643, 151643, 151643, 151643, 151643, 151643, 151643, 151643, 151643, 151643, 151643, 151643, 151643, 151643, 151643, 151643, 151643, 151643, 151643, 151643, 151643, 151643, 151643, 151643, 151643, 151643, 151643, 151643, 151643, 151643, 151643, 151643, 151643, 151643, 151643, 151643, 151643, 151643, 151643, 151643, 151643, 151643, 151643, 151643, 151643, 151643, 151643, 151643, 151643, 151643, 151643, 151643, 151643, 151643, 151643, 151643, 151643, 151643, 151643, 151643, 151643, 151643, 151643, 151643, 151643, 151643, 151643, 151643, 151643, 151643, 151643, 151643, 151643, 151643, 151643, 151643, 151643, 151643, 151643, 151643, 151643, 151643, 151643, 151643, 151643, 151643, 151643, 151643, 151643, 151643, 151643, 151643, 151643, 151643, 151643, 151643, 151643, 151643, 151643, 151643, 151643, 151643, 151643, 151643, 151643, 151643, 151643, 151643, 151643, 151643, 151643, 151643, 151643, 151643, 151643, 151643, 151643, 151643, 151643, 151643, 151643, 151643, 151643, 151643, 151643, 151643, 151643, 151643, 151643, 151643, 151643, 151643, 151643, 151643, 151643, 151643, 151643, 151643, 151643, 151643, 151643, 151643, 151643, 151643, 151643, 151643, 151643, 151643, 151643, 151643, 151643, 151643, 151643, 151643, 151643, 151643, 151643, 151643, 151643, 151643, 151643, 151643, 151643, 151643, 151643, 151643, 151643, 151643, 151643, 151643, 151643, 151643, 151643, 151643, 151643, 151643, 151643, 151643, 151643, 151643, 151643, 151643, 151643, 151643, 151643, 151643, 151643, 151643, 151643, 151643, 151643, 151643, 151643, 151643, 151643, 151643, 151643, 151643, 151643, 151643, 151643, 151643, 151643, 151643, 151643, 151643, 151643, 151643, 151643, 151643, 151643, 151643, 151643, 151643, 151643, 151643, 151643, 151643, 151643, 151643, 151643, 151643, 151643, 151643, 151643, 151643, 151643, 151643, 151643, 151643, 151643, 151643, 151643, 151643, 151643, 151643, 151643, 151643, 151643, 151643, 151643, 151643, 151643, 151643, 151643, 151643, 151643, 151643, 151643, 151643, 151643, 151643, 151643, 151643, 151643, 151643, 151643, 151643, 151643, 151643, 151643, 151643, 151643, 151643, 151643, 151643, 151643, 151643, 151643, 151643, 151643, 151643, 151643, 151643, 151643, 151643, 151643, 151643, 151643, 151643, 151643, 151643, 151643, 151643, 151643, 151643, 151643, 151643, 151643, 151643, 151643, 151643, 151643, 151643, 151643, 151643, 151643, 151643, 151643, 151643, 151643, 151643, 151643, 151643, 151643, 151643, 151643, 151643, 151643, 151643, 151643, 151643, 151643, 151643, 151643, 151643, 151643, 151643, 151643, 151643, 151643, 151643, 151643, 151643, 151643, 151643, 151643, 151643, 151643, 151643, 151643, 151643, 151643, 151643, 151643, 151643, 151643, 151643, 151643, 151643, 151643, 151643, 151643, 151643, 151643, 151643, 151643, 151643, 151643, 151643, 151643, 151643, 151643, 151643, 151643, 151643, 151643, 151643, 151643, 151643, 151643, 151643, 151643, 151643, 151643, 151643, 151643, 151643, 151643, 151643, 151643, 151643, 151643, 151643, 151643, 151643, 151643, 151643, 151643, 151643, 151643, 151643, 151643, 151643, 151643, 151643, 151643, 151643, 151643, 151643, 151643, 151643, 151643, 151643, 151643, 151643, 151643, 151643, 151643, 151643, 151643, 151643, 151643, 151643, 151643, 151643, 151643, 151643, 151643, 151643, 151643, 151643, 151643, 151643, 151643, 151643, 151643, 151643, 151643, 151643, 151643, 151643, 151643, 151643, 151643, 151643, 151643, 151643, 151643, 151643, 151643, 151643, 151643, 151643, 151643, 151643, 151643, 151643, 151643, 151643, 151643, 151643, 151643, 151643, 151643, 151643, 151643, 151643, 151643, 151643, 151643, 151643, 151643, 151643, 151643, 151643, 151643, 151643, 151643, 151643, 151643, 151643, 151643, 151643, 151643, 151643, 151643, 151643, 151643, 151643, 151643, 151643, 151643, 151643, 151643, 151643, 151643, 151643, 151643, 151643, 151643, 151643, 151643, 151643, 151643, 151643, 151643, 151643, 151643, 151643, 151643, 151643, 151643, 151643, 151643, 151643, 151643, 151643, 151643, 151643, 151643, 151643, 151643, 151643, 151643, 151643, 151643, 151643, 151643, 151643, 151643, 151643, 151643, 151643, 151643, 151643, 151643, 151643, 151643, 151643, 151644, 8948, 198, 2610, 525, 1207, 16948, 11, 3465, 553, 54364, 14817, 13, 1446, 525, 264, 10950, 17847, 13, 151645, 198, 151644, 872, 198, 16141, 279, 2701, 5248, 5754, 3405, 13, 576, 1537, 1555, 315, 697, 2033, 1265, 387, 315, 279, 2701, 3561, 25, 364, 16141, 25, 400, 20756, 4198, 6, 320, 28996, 17194, 8, 1380, 44428, 374, 825, 315, 19360, 35, 13, 21149, 3019, 553, 3019, 1573, 35764, 382, 785, 42707, 1948, 279, 42646, 14011, 2070, 1599, 323, 80582, 908, 374, 2661, 553, 271, 59, 10374, 5416, 90, 43, 11035, 2359, 7021, 59, 1291, 8, 10829, 59, 12935, 90, 69, 11035, 2257, 35702, 30765, 15170, 69, 11035, 2359, 7021, 59, 1291, 10699, 2359, 11520, 8602, 16917, 10, 55, 59, 2359, 7021, 59, 1291, 10699, 1291, 10699, 30765, 15159, 69, 11035, 2359, 7021, 59, 1291, 692, 785, 3072, 315, 279, 42646, 263, 1599, 374, 220, 21, 4229, 53, 624, 3838, 525, 279, 23938, 336, 7022, 5420, 1622, 942, 315, 279, 42646, 263, 1599, 518, 279, 15457, 1973, 1939, 5012, 25, 369, 279, 70708, 990, 264, 97913, 6440, 382, 32, 8, 1599, 59, 19491, 293, 59, 2257, 90, 65, 2137, 82, 59, 2257, 84386, 2137, 84, 59, 2257, 90, 84, 2137, 67, 59, 2257, 90, 67, 2137, 59, 29143, 47822, 10, 11035, 29143, 87210, 2137, 59, 15128, 47822, 10, 11035, 15128, 87210, 2137, 68, 47822, 10, 92, 68, 87210, 532, 33, 8, 1599, 59, 19491, 272, 59, 2257, 90, 66, 2137, 82, 59, 2257, 84386, 2137, 84, 59, 2257, 90, 84, 2137, 67, 59, 2257, 90, 67, 2137, 83, 59, 2257, 90, 83, 2137, 59, 29143, 47822, 10, 11035, 29143, 87210, 2137, 59, 15128, 47822, 10, 11035, 15128, 87210, 2137, 68, 47822, 10, 92, 68, 87210, 532, 34, 8, 1599, 59, 19491, 272, 59, 2257, 90, 66, 2137, 82, 59, 2257, 84386, 2137, 84, 59, 2257, 90, 84, 2137, 67, 59, 2257, 90, 67, 2137, 59, 29143, 47822, 10, 11035, 29143, 87210, 2137, 59, 15128, 47822, 10, 11035, 15128, 87210, 2137, 68, 47822, 10, 92, 68, 87210, 532, 35, 8, 1599, 59, 19491, 293, 59, 2257, 90, 65, 2137, 82, 59, 2257, 84386, 2137, 84, 59, 2257, 90, 84, 2137, 67, 59, 2257, 90, 67, 2137, 59, 29143, 47822, 10, 11035, 29143, 87210, 2137, 68, 47822, 10, 92, 68, 87210, 92, 151645, 198, 151644, 77091, 198]",,385,757,1142,1.0,1.0
259948fe-18ec-4e54-8a20-1befde55282f,7,24,"[151643, 151643, 151643, 151643, 151643, 151643, 151643, 151643, 151643, 151643, 151643, 151643, 151643, 151643, 151643, 151643, 151643, 151643, 151643, 151643, 151643, 151643, 151643, 151643, 151643, 151643, 151643, 151643, 151643, 151643, 151643, 151643, 151643, 151643, 151643, 151643, 151643, 151643, 151643, 151643, 151643, 151643, 151643, 151643, 151643, 151643, 151643, 151643, 151643, 151643, 151643, 151643, 151643, 151643, 151643, 151643, 151643, 151643, 151643, 151643, 151643, 151643, 151643, 151643, 151643, 151643, 151643, 151643, 151643, 151643, 151643, 151643, 151643, 151643, 151643, 151643, 151643, 151643, 151643, 151643, 151643, 151643, 151643, 151643, 151643, 151643, 151643, 151643, 151643, 151643, 151643, 151643, 151643, 151643, 151643, 151643, 151643, 151643, 151643, 151643, 151643, 151643, 151643, 151643, 151643, 151643, 151643, 151643, 151643, 151643, 151643, 151643, 151643, 151643, 151643, 151643, 151643, 151643, 151643, 151643, 151643, 151643, 151643, 151643, 151643, 151643, 151643, 151643, 151643, 151643, 151643, 151643, 151643, 151643, 151643, 151643, 151643, 151643, 151643, 151643, 151643, 151643, 151643, 151643, 151643, 151643, 151643, 151643, 151643, 151643, 151643, 151643, 151643, 151643, 151643, 151643, 151643, 151643, 151643, 151643, 151643, 151643, 151643, 151643, 151643, 151643, 151643, 151643, 151643, 151643, 151643, 151643, 151643, 151643, 151643, 151643, 151643, 151643, 151643, 151643, 151643, 151643, 151643, 151643, 151643, 151643, 151643, 151643, 151643, 151643, 151643, 151643, 151643, 151643, 151643, 151643, 151643, 151643, 151643, 151643, 151643, 151643, 151643, 151643, 151643, 151643, 151643, 151643, 151643, 151643, 151643, 151643, 151643, 151643, 151643, 151643, 151643, 151643, 151643, 151643, 151643, 151643, 151643, 151643, 151643, 151643, 151643, 151643, 151643, 151643, 151643, 151643, 151643, 151643, 151643, 151643, 151643, 151643, 151643, 151643, 151643, 151643, 151643, 151643, 151643, 151643, 151643, 151643, 151643, 151643, 151643, 151643, 151643, 151643, 151643, 151643, 151643, 151643, 151643, 151643, 151643, 151643, 151643, 151643, 151643, 151643, 151643, 151643, 151643, 151643, 151643, 151643, 151643, 151643, 151643, 151643, 151643, 151643, 151643, 151643, 151643, 151643, 151643, 151643, 151643, 151643, 151643, 151643, 151643, 151643, 151643, 151643, 151643, 151643, 151643, 151643, 151643, 151643, 151643, 151643, 151643, 151643, 151643, 151643, 151643, 151643, 151643, 151643, 151643, 151643, 151643, 151643, 151643, 151643, 151643, 151643, 151643, 151643, 151643, 151643, 151643, 151643, 151643, 151643, 151643, 151643, 151643, 151643, 151643, 151643, 151643, 151643, 151643, 151643, 151643, 151643, 151643, 151643, 151643, 151643, 151643, 151643, 151643, 151643, 151643, 151643, 151643, 151643, 151643, 151643, 151643, 151643, 151643, 151643, 151643, 151643, 151643, 151643, 151643, 151643, 151643, 151643, 151643, 151643, 151643, 151643, 151643, 151643, 151643, 151643, 151643, 151643, 151643, 151643, 151643, 151643, 151643, 151643, 151643, 151643, 151643, 151643, 151643, 151643, 151643, 151643, 151643, 151643, 151643, 151643, 151643, 151643, 151643, 151643, 151643, 151643, 151643, 151643, 151643, 151643, 151643, 151643, 151643, 151643, 151643, 151643, 151643, 151643, 151643, 151643, 151643, 151643, 151643, 151643, 151643, 151643, 151643, 151643, 151643, 151643, 151643, 151643, 151643, 151643, 151643, 151643, 151643, 151643, 151643, 151643, 151643, 151643, 151643, 151643, 151643, 151643, 151643, 151643, 151643, 151643, 151643, 151643, 151643, 151643, 151643, 151643, 151643, 151643, 151643, 151643, 151643, 151643, 151643, 151643, 151643, 151643, 151643, 151643, 151643, 151643, 151643, 151643, 151643, 151643, 151643, 151643, 151643, 151643, 151643, 151643, 151643, 151643, 151643, 151643, 151643, 151643, 151643, 151643, 151643, 151643, 151643, 151643, 151643, 151643, 151643, 151643, 151643, 151643, 151643, 151643, 151643, 151643, 151643, 151643, 151643, 151643, 151643, 151643, 151643, 151643, 151643, 151643, 151643, 151643, 151643, 151643, 151643, 151643, 151643, 151643, 151643, 151643, 151643, 151643, 151643, 151643, 151643, 151643, 151643, 151643, 151643, 151643, 151643, 151643, 151643, 151643, 151643, 151643, 151643, 151643, 151643, 151643, 151643, 151643, 151643, 151643, 151643, 151643, 151643, 151643, 151643, 151643, 151643, 151643, 151643, 151643, 151643, 151643, 151643, 151643, 151643, 151643, 151643, 151643, 151643, 151643, 151643, 151643, 151643, 151643, 151643, 151643, 151643, 151643, 151643, 151643, 151643, 151643, 151643, 151643, 151643, 151643, 151643, 151643, 151643, 151643, 151643, 151643, 151643, 151643, 151643, 151643, 151643, 151643, 151643, 151643, 151643, 151643, 151643, 151643, 151643, 151643, 151643, 151643, 151643, 151643, 151643, 151643, 151643, 151643, 151643, 151643, 151643, 151643, 151643, 151643, 151643, 151643, 151643, 151643, 151643, 151643, 151643, 151643, 151643, 151643, 151643, 151643, 151643, 151643, 151643, 151643, 151643, 151643, 151643, 151643, 151643, 151643, 151643, 151643, 151643, 151643, 151643, 151643, 151643, 151643, 151643, 151643, 151643, 151643, 151643, 151643, 151643, 151643, 151643, 151643, 151643, 151643, 151643, 151643, 151643, 151643, 151643, 151643, 151643, 151643, 151643, 151643, 151643, 151643, 151643, 151643, 151643, 151643, 151643, 151643, 151643, 151643, 151643, 151643, 151643, 151643, 151643, 151643, 151643, 151643, 151643, 151643, 151643, 151643, 151643, 151643, 151643, 151643, 151643, 151643, 151643, 151643, 151643, 151643, 151643, 151643, 151643, 151643, 151643, 151643, 151643, 151643, 151643, 151643, 151643, 151643, 151643, 151643, 151643, 151643, 151643, 151643, 151643, 151643, 151643, 151643, 151643, 151643, 151643, 151643, 151643, 151643, 151643, 151643, 151643, 151643, 151643, 151643, 151643, 151643, 151643, 151643, 151643, 151643, 151643, 151643, 151643, 151643, 151643, 151643, 151643, 151643, 151643, 151643, 151643, 151643, 151643, 151643, 151643, 151643, 151643, 151643, 151643, 151643, 151643, 151643, 151643, 151643, 151643, 151643, 151643, 151643, 151643, 151643, 151643, 151643, 151643, 151643, 151643, 151643, 151643, 151643, 151643, 151643, 151643, 151643, 151643, 151643, 151643, 151643, 151643, 151643, 151643, 151643, 151643, 151643, 151643, 151643, 151643, 151643, 151643, 151643, 151643, 151643, 151643, 151643, 151643, 151643, 151643, 151643, 151643, 151643, 151643, 151643, 151643, 151643, 151643, 151643, 151643, 151643, 151643, 151643, 151643, 151643, 151643, 151643, 151643, 151643, 151643, 151643, 151643, 151643, 151643, 151643, 151643, 151643, 151643, 151643, 151643, 151643, 151643, 151643, 151643, 151643, 151643, 151643, 151643, 151643, 151643, 151643, 151643, 151643, 151643, 151643, 151643, 151643, 151643, 151643, 151643, 151643, 151643, 151643, 151643, 151643, 151644, 8948, 198, 2610, 525, 1207, 16948, 11, 3465, 553, 54364, 14817, 13, 1446, 525, 264, 10950, 17847, 13, 151645, 198, 151644, 872, 198, 16141, 279, 2701, 5248, 5754, 3405, 13, 576, 1537, 1555, 315, 697, 2033, 1265, 387, 315, 279, 2701, 3561, 25, 364, 16141, 25, 400, 20756, 4198, 6, 320, 28996, 17194, 8, 1380, 44428, 374, 825, 315, 19360, 35, 13, 21149, 3019, 553, 3019, 1573, 35764, 382, 33610, 279, 2701, 505, 93460, 1415, 11, 892, 825, 702, 279, 8426, 17457, 1939, 64, 8, 1527, 9237, 1448, 395, 323, 9237, 17710, 11580, 624, 65, 8, 362, 11580, 448, 220, 17, 9237, 31638, 323, 264, 17457, 315, 13187, 220, 20, 13, 20, 342, 69198, 61, 18, 624, 66, 8, 362, 11580, 448, 279, 1852, 18037, 438, 9237, 714, 220, 20, 3039, 803, 10951, 1091, 9237, 624, 67, 8, 362, 11580, 448, 279, 1852, 18037, 438, 9237, 714, 4279, 279, 3072, 315, 9237, 382, 32, 8, 264, 198, 33, 8, 294, 198, 34, 8, 272, 198, 35, 8, 293, 151645, 198, 151644, 77091, 198]",,174,372,546,0.0,0.0
c9985f05-9a96-477b-9f58-1e445df9f7fe,7,25,"[151643, 151643, 151643, 151643, 151643, 151643, 151643, 151643, 151643, 151643, 151643, 151643, 151643, 151643, 151643, 151643, 151643, 151643, 151643, 151643, 151643, 151643, 151643, 151643, 151643, 151643, 151643, 151643, 151643, 151643, 151643, 151643, 151643, 151643, 151643, 151643, 151643, 151643, 151643, 151643, 151643, 151643, 151643, 151643, 151643, 151643, 151643, 151643, 151643, 151643, 151643, 151643, 151643, 151643, 151643, 151643, 151643, 151643, 151643, 151643, 151643, 151643, 151643, 151643, 151643, 151643, 151643, 151643, 151643, 151643, 151643, 151643, 151643, 151643, 151643, 151643, 151643, 151643, 151643, 151643, 151643, 151643, 151643, 151643, 151643, 151643, 151643, 151643, 151643, 151643, 151643, 151643, 151643, 151643, 151643, 151643, 151643, 151643, 151643, 151643, 151643, 151643, 151643, 151643, 151643, 151643, 151643, 151643, 151643, 151643, 151643, 151643, 151643, 151643, 151643, 151643, 151643, 151643, 151643, 151643, 151643, 151643, 151643, 151643, 151643, 151643, 151643, 151643, 151643, 151643, 151643, 151643, 151643, 151643, 151643, 151643, 151643, 151643, 151643, 151643, 151643, 151643, 151643, 151643, 151643, 151643, 151643, 151643, 151643, 151643, 151643, 151643, 151643, 151643, 151643, 151643, 151643, 151643, 151643, 151643, 151643, 151643, 151643, 151643, 151643, 151643, 151643, 151643, 151643, 151643, 151643, 151643, 151643, 151643, 151643, 151643, 151643, 151643, 151643, 151643, 151643, 151643, 151643, 151643, 151643, 151643, 151643, 151643, 151643, 151643, 151643, 151643, 151643, 151643, 151643, 151643, 151643, 151643, 151643, 151643, 151643, 151643, 151643, 151643, 151643, 151643, 151643, 151643, 151643, 151643, 151643, 151643, 151643, 151643, 151643, 151643, 151643, 151643, 151643, 151643, 151643, 151643, 151643, 151643, 151643, 151643, 151643, 151643, 151643, 151643, 151643, 151643, 151643, 151643, 151643, 151643, 151643, 151643, 151643, 151643, 151643, 151643, 151643, 151643, 151643, 151643, 151643, 151643, 151643, 151643, 151643, 151643, 151643, 151643, 151643, 151643, 151643, 151643, 151643, 151643, 151643, 151643, 151643, 151643, 151643, 151643, 151643, 151643, 151643, 151643, 151643, 151643, 151643, 151643, 151643, 151643, 151643, 151643, 151643, 151643, 151643, 151643, 151643, 151643, 151643, 151643, 151643, 151643, 151643, 151643, 151643, 151643, 151643, 151643, 151643, 151643, 151643, 151643, 151643, 151643, 151643, 151643, 151643, 151643, 151643, 151643, 151643, 151643, 151643, 151643, 151643, 151643, 151643, 151643, 151643, 151643, 151643, 151643, 151643, 151643, 151643, 151643, 151643, 151643, 151643, 151643, 151643, 151643, 151643, 151643, 151643, 151643, 151643, 151643, 151643, 151643, 151643, 151643, 151643, 151643, 151643, 151643, 151643, 151643, 151643, 151643, 151643, 151643, 151643, 151643, 151643, 151643, 151643, 151643, 151643, 151643, 151643, 151643, 151643, 151643, 151643, 151643, 151643, 151643, 151643, 151643, 151643, 151643, 151643, 151643, 151643, 151643, 151643, 151643, 151643, 151643, 151643, 151643, 151643, 151643, 151643, 151643, 151643, 151643, 151643, 151643, 151643, 151643, 151643, 151643, 151643, 151643, 151643, 151643, 151643, 151643, 151643, 151643, 151643, 151643, 151643, 151643, 151643, 151643, 151643, 151643, 151643, 151643, 151643, 151643, 151643, 151643, 151643, 151643, 151643, 151643, 151643, 151643, 151643, 151643, 151643, 151643, 151643, 151643, 151643, 151643, 151643, 151643, 151643, 151643, 151643, 151643, 151643, 151643, 151643, 151643, 151643, 151643, 151643, 151643, 151643, 151643, 151643, 151643, 151643, 151643, 151643, 151643, 151643, 151643, 151643, 151643, 151643, 151643, 151643, 151643, 151643, 151643, 151643, 151643, 151643, 151643, 151643, 151643, 151643, 151643, 151643, 151643, 151643, 151643, 151643, 151643, 151643, 151643, 151643, 151643, 151643, 151643, 151643, 151643, 151643, 151643, 151643, 151643, 151643, 151643, 151643, 151643, 151643, 151643, 151643, 151643, 151643, 151643, 151643, 151643, 151643, 151643, 151643, 151643, 151643, 151643, 151643, 151643, 151643, 151643, 151643, 151643, 151643, 151643, 151643, 151643, 151643, 151643, 151643, 151643, 151643, 151643, 151643, 151643, 151643, 151643, 151643, 151643, 151643, 151643, 151643, 151643, 151643, 151643, 151643, 151643, 151643, 151643, 151643, 151643, 151643, 151643, 151643, 151643, 151643, 151643, 151643, 151643, 151643, 151643, 151643, 151643, 151643, 151643, 151643, 151643, 151643, 151643, 151643, 151643, 151643, 151643, 151643, 151643, 151643, 151643, 151643, 151643, 151643, 151643, 151643, 151643, 151643, 151643, 151643, 151643, 151643, 151643, 151643, 151643, 151643, 151643, 151643, 151643, 151643, 151643, 151643, 151643, 151643, 151643, 151643, 151643, 151643, 151643, 151643, 151643, 151643, 151643, 151643, 151643, 151643, 151643, 151643, 151643, 151643, 151643, 151643, 151643, 151643, 151643, 151643, 151643, 151643, 151643, 151643, 151643, 151643, 151643, 151643, 151643, 151643, 151643, 151643, 151643, 151643, 151643, 151643, 151643, 151643, 151643, 151643, 151643, 151643, 151643, 151643, 151643, 151643, 151643, 151643, 151643, 151643, 151643, 151643, 151643, 151643, 151643, 151643, 151643, 151643, 151643, 151643, 151643, 151643, 151643, 151643, 151643, 151643, 151643, 151643, 151643, 151643, 151643, 151643, 151643, 151643, 151643, 151643, 151643, 151643, 151643, 151643, 151643, 151643, 151643, 151643, 151643, 151643, 151643, 151643, 151643, 151643, 151643, 151643, 151643, 151643, 151643, 151643, 151643, 151643, 151643, 151643, 151643, 151643, 151643, 151643, 151643, 151643, 151643, 151643, 151643, 151643, 151643, 151643, 151643, 151643, 151643, 151643, 151643, 151643, 151643, 151643, 151643, 151643, 151643, 151643, 151643, 151643, 151643, 151643, 151643, 151643, 151643, 151643, 151643, 151644, 8948, 198, 2610, 525, 1207, 16948, 11, 3465, 553, 54364, 14817, 13, 1446, 525, 264, 10950, 17847, 13, 151645, 198, 151644, 872, 198, 16141, 279, 2701, 5248, 5754, 3405, 13, 576, 1537, 1555, 315, 697, 2033, 1265, 387, 315, 279, 2701, 3561, 25, 364, 16141, 25, 400, 20756, 4198, 6, 320, 28996, 17194, 8, 1380, 44428, 374, 825, 315, 19360, 35, 13, 21149, 3019, 553, 3019, 1573, 35764, 382, 785, 1584, 315, 264, 1849, 518, 882, 259, 374, 2661, 553, 279, 3250, 6172, 3432, 5424, 10293, 16, 11, 220, 17, 11, 220, 16, 701, 323, 279, 19624, 315, 1378, 9282, 4788, 393, 323, 1207, 315, 279, 1849, 525, 15251, 553, 1378, 9334, 35195, 13, 576, 6172, 12159, 311, 5675, 393, 702, 279, 5424, 304, 1156, 2802, 438, 320, 15, 11, 220, 16, 14, 1124, 26888, 90, 17, 2137, 220, 15, 701, 5424, 304, 279, 2086, 2802, 438, 320, 16, 14, 1124, 26888, 90, 17, 2137, 220, 15, 11, 220, 16, 14, 1124, 26888, 90, 17, 5410, 323, 429, 304, 4843, 2802, 438, 320, 15, 11, 220, 16, 14, 1124, 26888, 90, 17, 2137, 220, 15, 568, 576, 6172, 5675, 369, 1207, 374, 15251, 553, 279, 9334, 6172, 3432, 5424, 304, 279, 1156, 2802, 438, 320, 16, 11, 220, 15, 11, 220, 15, 701, 2086, 2802, 438, 320, 15, 11, 220, 15, 11, 220, 15, 8, 323, 4843, 2802, 438, 320, 15, 11, 220, 15, 11, 481, 16, 568, 4695, 11, 421, 4325, 10953, 1207, 1101, 1283, 279, 18662, 315, 393, 11, 1128, 374, 279, 18927, 315, 3709, 220, 15, 369, 393, 323, 481, 16, 369, 1207, 304, 279, 19511, 21595, 1939, 32, 8, 220, 16, 14, 18, 198, 33, 8, 220, 16, 14, 21, 198, 34, 8, 220, 17, 14, 18, 198, 35, 8, 220, 16, 14, 17, 151645, 198, 151644, 77091, 198]",,304,1165,1469,0.0,0.0
db8f3b82-e385-4feb-a075-52251ea38102,7,26,"[151643, 151643, 151643, 151643, 151643, 151643, 151643, 151643, 151643, 151643, 151643, 151643, 151643, 151643, 151643, 151643, 151643, 151643, 151643, 151643, 151643, 151643, 151643, 151643, 151643, 151643, 151643, 151643, 151643, 151643, 151643, 151643, 151643, 151643, 151643, 151643, 151643, 151643, 151643, 151643, 151643, 151643, 151643, 151643, 151643, 151643, 151643, 151643, 151643, 151643, 151643, 151643, 151643, 151643, 151643, 151643, 151643, 151643, 151643, 151643, 151643, 151643, 151643, 151643, 151643, 151643, 151643, 151643, 151643, 151643, 151643, 151643, 151643, 151643, 151643, 151643, 151643, 151643, 151643, 151643, 151643, 151643, 151643, 151643, 151643, 151643, 151643, 151643, 151643, 151643, 151643, 151643, 151643, 151643, 151643, 151643, 151643, 151643, 151643, 151643, 151643, 151643, 151643, 151643, 151643, 151643, 151643, 151643, 151643, 151643, 151643, 151643, 151643, 151643, 151643, 151643, 151643, 151643, 151643, 151643, 151643, 151643, 151643, 151643, 151643, 151643, 151643, 151643, 151643, 151643, 151643, 151643, 151643, 151643, 151643, 151643, 151643, 151643, 151643, 151643, 151643, 151643, 151643, 151643, 151643, 151643, 151643, 151643, 151643, 151643, 151643, 151643, 151643, 151643, 151643, 151643, 151643, 151643, 151643, 151643, 151643, 151643, 151643, 151643, 151643, 151643, 151643, 151643, 151643, 151643, 151643, 151643, 151643, 151643, 151643, 151643, 151643, 151643, 151643, 151643, 151643, 151643, 151643, 151643, 151643, 151643, 151643, 151643, 151643, 151643, 151643, 151643, 151643, 151643, 151643, 151643, 151643, 151643, 151643, 151643, 151643, 151643, 151643, 151643, 151643, 151643, 151643, 151643, 151643, 151643, 151643, 151643, 151643, 151643, 151643, 151643, 151643, 151643, 151643, 151643, 151643, 151643, 151643, 151643, 151643, 151643, 151643, 151643, 151643, 151643, 151643, 151643, 151643, 151643, 151643, 151643, 151643, 151643, 151643, 151643, 151643, 151643, 151643, 151643, 151643, 151643, 151643, 151643, 151643, 151643, 151643, 151643, 151643, 151643, 151643, 151643, 151643, 151643, 151643, 151643, 151643, 151643, 151643, 151643, 151643, 151643, 151643, 151643, 151643, 151643, 151643, 151643, 151643, 151643, 151643, 151643, 151643, 151643, 151643, 151643, 151643, 151643, 151643, 151643, 151643, 151643, 151643, 151643, 151643, 151643, 151643, 151643, 151643, 151643, 151643, 151643, 151643, 151643, 151643, 151643, 151643, 151643, 151643, 151643, 151643, 151643, 151643, 151643, 151643, 151643, 151643, 151643, 151643, 151643, 151643, 151643, 151643, 151643, 151643, 151643, 151643, 151643, 151643, 151643, 151643, 151643, 151643, 151643, 151643, 151643, 151643, 151643, 151643, 151643, 151643, 151643, 151643, 151643, 151643, 151643, 151643, 151643, 151643, 151643, 151643, 151643, 151643, 151643, 151643, 151643, 151643, 151643, 151643, 151643, 151643, 151643, 151643, 151643, 151643, 151643, 151643, 151643, 151643, 151643, 151643, 151643, 151643, 151643, 151643, 151643, 151643, 151643, 151643, 151643, 151643, 151643, 151643, 151643, 151643, 151643, 151643, 151643, 151643, 151643, 151643, 151643, 151643, 151643, 151643, 151643, 151643, 151643, 151643, 151643, 151643, 151643, 151643, 151643, 151643, 151643, 151643, 151643, 151643, 151643, 151643, 151643, 151643, 151643, 151643, 151643, 151643, 151643, 151643, 151643, 151643, 151643, 151643, 151643, 151643, 151643, 151643, 151643, 151643, 151643, 151643, 151643, 151643, 151643, 151643, 151643, 151643, 151643, 151643, 151643, 151643, 151643, 151643, 151643, 151643, 151643, 151643, 151643, 151643, 151643, 151643, 151643, 151643, 151643, 151643, 151643, 151643, 151643, 151643, 151643, 151643, 151643, 151643, 151643, 151643, 151643, 151643, 151643, 151643, 151643, 151643, 151643, 151643, 151643, 151643, 151643, 151643, 151643, 151643, 151643, 151643, 151643, 151643, 151643, 151643, 151643, 151643, 151643, 151643, 151643, 151643, 151643, 151643, 151643, 151643, 151643, 151643, 151643, 151643, 151643, 151643, 151643, 151643, 151643, 151643, 151643, 151643, 151643, 151643, 151643, 151643, 151643, 151643, 151643, 151643, 151643, 151643, 151643, 151643, 151643, 151643, 151643, 151643, 151643, 151643, 151643, 151643, 151643, 151643, 151643, 151643, 151643, 151643, 151643, 151643, 151643, 151643, 151643, 151643, 151643, 151643, 151643, 151643, 151643, 151643, 151643, 151643, 151643, 151643, 151643, 151643, 151643, 151643, 151643, 151643, 151643, 151643, 151643, 151643, 151643, 151643, 151643, 151643, 151643, 151643, 151643, 151643, 151643, 151643, 151643, 151643, 151643, 151643, 151643, 151643, 151643, 151643, 151643, 151643, 151643, 151643, 151643, 151643, 151643, 151643, 151643, 151643, 151643, 151643, 151643, 151643, 151643, 151643, 151643, 151643, 151643, 151643, 151643, 151643, 151643, 151643, 151643, 151643, 151643, 151643, 151643, 151643, 151643, 151643, 151643, 151643, 151643, 151643, 151643, 151643, 151643, 151643, 151643, 151643, 151643, 151643, 151643, 151643, 151643, 151643, 151643, 151643, 151643, 151643, 151643, 151643, 151643, 151643, 151643, 151643, 151643, 151643, 151643, 151643, 151643, 151643, 151643, 151643, 151643, 151643, 151643, 151643, 151643, 151643, 151643, 151643, 151643, 151643, 151643, 151643, 151643, 151643, 151643, 151643, 151643, 151643, 151643, 151643, 151643, 151643, 151643, 151643, 151643, 151643, 151643, 151643, 151643, 151643, 151643, 151643, 151643, 151643, 151643, 151643, 151643, 151643, 151643, 151643, 151643, 151643, 151643, 151643, 151643, 151643, 151643, 151643, 151643, 151643, 151643, 151643, 151643, 151643, 151643, 151643, 151643, 151643, 151643, 151643, 151643, 151643, 151643, 151643, 151643, 151643, 151643, 151643, 151643, 151643, 151643, 151643, 151643, 151643, 151643, 151643, 151643, 151643, 151643, 151643, 151643, 151643, 151643, 151643, 151643, 151643, 151643, 151643, 151643, 151643, 151643, 151643, 151643, 151643, 151643, 151643, 151643, 151643, 151643, 151643, 151643, 151643, 151643, 151643, 151643, 151643, 151643, 151643, 151643, 151643, 151643, 151643, 151643, 151643, 151643, 151643, 151643, 151643, 151643, 151643, 151643, 151643, 151643, 151643, 151643, 151643, 151643, 151643, 151643, 151643, 151643, 151643, 151643, 151643, 151643, 151643, 151643, 151643, 151643, 151643, 151643, 151643, 151643, 151643, 151643, 151643, 151643, 151643, 151643, 151643, 151643, 151643, 151643, 151643, 151643, 151643, 151643, 151643, 151643, 151643, 151644, 8948, 198, 2610, 525, 1207, 16948, 11, 3465, 553, 54364, 14817, 13, 1446, 525, 264, 10950, 17847, 13, 151645, 198, 151644, 872, 198, 16141, 279, 2701, 5248, 5754, 3405, 13, 576, 1537, 1555, 315, 697, 2033, 1265, 387, 315, 279, 2701, 3561, 25, 364, 16141, 25, 400, 20756, 4198, 6, 320, 28996, 17194, 8, 1380, 44428, 374, 825, 315, 19360, 35, 13, 21149, 3019, 553, 3019, 1573, 35764, 382, 7771, 36344, 702, 68020, 264, 501, 30128, 2070, 10126, 389, 3040, 32420, 99008, 4107, 11, 323, 374, 23966, 279, 87294, 315, 3654, 5080, 23810, 6337, 46187, 304, 429, 10126, 13, 1913, 862, 18010, 498, 21236, 264, 67222, 6066, 832, 5185, 25, 264, 88220, 77, 1515, 13549, 11, 323, 1790, 311, 432, 11, 279, 4244, 330, 2141, 16045, 1, 8110, 553, 264, 914, 315, 6961, 18021, 11, 5109, 11, 323, 41238, 1948, 1128, 4994, 311, 387, 4802, 28405, 13, 576, 17738, 1349, 25, 8287, 61, 18, 353, 342, 61, 17, 17946, 7, 17, 8, 353, 220, 23, 353, 220, 16, 11884, 19, 2493, 29776, 21, 353, 320, 48, 10270, 29776, 17, 382, 785, 13549, 11, 25822, 11, 702, 1012, 22383, 60291, 480, 553, 264, 73025, 10799, 13, 2585, 1657, 29753, 1521, 432, 6644, 1939, 32, 8, 220, 18, 198, 33, 8, 220, 21, 198, 34, 8, 220, 16, 198, 35, 8, 220, 17, 151645, 198, 151644, 77091, 198]",,227,446,673,0.0,0.0
becd5ea1-7a09-408b-8523-93d088680e77,7,27,"[151643, 151643, 151643, 151643, 151643, 151643, 151643, 151643, 151643, 151643, 151643, 151643, 151643, 151643, 151643, 151643, 151643, 151643, 151643, 151643, 151643, 151643, 151643, 151643, 151643, 151643, 151643, 151643, 151643, 151643, 151643, 151643, 151643, 151643, 151643, 151643, 151643, 151643, 151643, 151643, 151643, 151643, 151643, 151643, 151643, 151643, 151643, 151643, 151643, 151643, 151643, 151643, 151643, 151643, 151643, 151643, 151643, 151643, 151643, 151643, 151643, 151643, 151643, 151643, 151643, 151643, 151643, 151643, 151643, 151643, 151643, 151643, 151643, 151643, 151643, 151643, 151643, 151643, 151643, 151643, 151643, 151643, 151643, 151643, 151643, 151643, 151643, 151643, 151643, 151643, 151643, 151643, 151643, 151643, 151643, 151643, 151643, 151643, 151643, 151643, 151643, 151643, 151643, 151643, 151643, 151643, 151643, 151643, 151643, 151643, 151643, 151643, 151643, 151643, 151643, 151643, 151643, 151643, 151643, 151643, 151643, 151643, 151643, 151643, 151643, 151643, 151643, 151643, 151643, 151643, 151643, 151643, 151643, 151643, 151643, 151643, 151643, 151643, 151643, 151643, 151643, 151643, 151643, 151643, 151643, 151643, 151643, 151643, 151643, 151643, 151643, 151643, 151643, 151643, 151643, 151643, 151643, 151643, 151643, 151643, 151643, 151643, 151643, 151643, 151643, 151643, 151643, 151643, 151643, 151643, 151643, 151643, 151643, 151643, 151643, 151643, 151643, 151643, 151643, 151643, 151643, 151643, 151643, 151643, 151643, 151643, 151643, 151643, 151643, 151643, 151643, 151643, 151643, 151643, 151643, 151643, 151643, 151643, 151643, 151643, 151643, 151643, 151643, 151643, 151643, 151643, 151643, 151643, 151643, 151643, 151643, 151643, 151643, 151643, 151643, 151643, 151643, 151643, 151643, 151643, 151643, 151643, 151643, 151643, 151643, 151643, 151643, 151643, 151643, 151643, 151643, 151643, 151643, 151643, 151643, 151643, 151643, 151643, 151643, 151643, 151643, 151643, 151643, 151643, 151643, 151643, 151643, 151643, 151643, 151643, 151643, 151643, 151643, 151643, 151643, 151643, 151643, 151643, 151643, 151643, 151643, 151643, 151643, 151643, 151643, 151643, 151643, 151643, 151643, 151643, 151643, 151643, 151643, 151643, 151643, 151643, 151643, 151643, 151643, 151643, 151643, 151643, 151643, 151643, 151643, 151643, 151643, 151643, 151643, 151643, 151643, 151643, 151643, 151643, 151643, 151643, 151643, 151643, 151643, 151643, 151643, 151643, 151643, 151643, 151643, 151643, 151643, 151643, 151643, 151643, 151643, 151643, 151643, 151643, 151643, 151643, 151643, 151643, 151643, 151643, 151643, 151643, 151643, 151643, 151643, 151643, 151643, 151643, 151643, 151643, 151643, 151643, 151643, 151643, 151643, 151643, 151643, 151643, 151643, 151643, 151643, 151643, 151643, 151643, 151643, 151643, 151643, 151643, 151643, 151643, 151643, 151643, 151643, 151643, 151643, 151643, 151643, 151643, 151643, 151643, 151643, 151643, 151643, 151643, 151643, 151643, 151643, 151643, 151643, 151643, 151643, 151643, 151643, 151643, 151643, 151643, 151643, 151643, 151643, 151643, 151643, 151643, 151643, 151643, 151643, 151643, 151643, 151643, 151643, 151643, 151643, 151643, 151643, 151643, 151643, 151643, 151643, 151643, 151643, 151643, 151643, 151643, 151643, 151643, 151643, 151643, 151643, 151643, 151643, 151643, 151643, 151643, 151643, 151643, 151643, 151643, 151643, 151643, 151643, 151643, 151643, 151643, 151643, 151643, 151643, 151643, 151643, 151643, 151643, 151643, 151643, 151643, 151643, 151643, 151643, 151643, 151643, 151643, 151643, 151643, 151643, 151643, 151643, 151643, 151643, 151643, 151643, 151643, 151643, 151643, 151643, 151643, 151643, 151643, 151643, 151643, 151643, 151643, 151643, 151643, 151643, 151643, 151643, 151643, 151643, 151643, 151643, 151643, 151643, 151643, 151643, 151643, 151643, 151643, 151643, 151643, 151643, 151643, 151643, 151643, 151643, 151643, 151643, 151643, 151643, 151643, 151643, 151643, 151643, 151643, 151643, 151643, 151643, 151643, 151643, 151643, 151643, 151643, 151643, 151643, 151643, 151643, 151643, 151643, 151643, 151643, 151643, 151643, 151643, 151643, 151643, 151643, 151643, 151643, 151643, 151643, 151643, 151643, 151643, 151643, 151643, 151643, 151643, 151643, 151643, 151643, 151643, 151643, 151643, 151643, 151643, 151643, 151643, 151643, 151643, 151643, 151643, 151643, 151643, 151643, 151643, 151643, 151643, 151643, 151643, 151643, 151643, 151643, 151643, 151643, 151643, 151643, 151643, 151643, 151643, 151643, 151643, 151643, 151643, 151643, 151643, 151643, 151643, 151643, 151643, 151643, 151643, 151643, 151643, 151643, 151643, 151643, 151643, 151643, 151643, 151643, 151643, 151643, 151643, 151643, 151643, 151643, 151643, 151643, 151643, 151643, 151643, 151643, 151643, 151643, 151643, 151643, 151643, 151643, 151643, 151643, 151643, 151643, 151643, 151643, 151643, 151643, 151643, 151643, 151643, 151643, 151643, 151643, 151643, 151643, 151643, 151643, 151643, 151643, 151643, 151643, 151643, 151643, 151643, 151643, 151643, 151643, 151643, 151643, 151643, 151643, 151643, 151643, 151643, 151643, 151643, 151643, 151643, 151643, 151643, 151643, 151643, 151643, 151643, 151643, 151643, 151643, 151643, 151643, 151643, 151643, 151643, 151643, 151643, 151643, 151643, 151643, 151643, 151643, 151643, 151643, 151643, 151643, 151643, 151643, 151643, 151643, 151643, 151643, 151643, 151643, 151643, 151643, 151643, 151643, 151643, 151643, 151643, 151643, 151643, 151643, 151643, 151643, 151643, 151643, 151643, 151643, 151643, 151643, 151643, 151643, 151643, 151643, 151643, 151643, 151643, 151643, 151643, 151643, 151643, 151643, 151643, 151643, 151643, 151643, 151643, 151643, 151643, 151643, 151643, 151643, 151643, 151643, 151643, 151643, 151643, 151643, 151643, 151643, 151643, 151643, 151643, 151643, 151643, 151644, 8948, 198, 2610, 525, 1207, 16948, 11, 3465, 553, 54364, 14817, 13, 1446, 525, 264, 10950, 17847, 13, 151645, 198, 151644, 872, 198, 16141, 279, 2701, 5248, 5754, 3405, 13, 576, 1537, 1555, 315, 697, 2033, 1265, 387, 315, 279, 2701, 3561, 25, 364, 16141, 25, 400, 20756, 4198, 6, 320, 28996, 17194, 8, 1380, 44428, 374, 825, 315, 19360, 35, 13, 21149, 3019, 553, 3019, 1573, 35764, 382, 28301, 1437, 23628, 468, 304, 279, 2701, 12720, 12859, 624, 43134, 362, 11, 979, 54741, 448, 472, 28668, 11, 18644, 23628, 425, 624, 43134, 425, 11, 5193, 13951, 448, 472, 17, 304, 279, 9362, 315, 393, 67, 11, 7586, 23628, 356, 624, 43134, 356, 11, 5193, 12720, 448, 472, 8996, 17, 11, 7586, 23628, 422, 624, 43134, 422, 11, 5193, 42932, 315, 458, 79973, 6819, 11, 7586, 23628, 468, 624, 74933, 510, 64, 8, 61572, 362, 11, 979, 54741, 448, 458, 9788, 31988, 20244, 379, 16655, 11, 7586, 220, 16, 11, 17, 1737, 318, 41872, 12, 19, 8013, 776, 848, 12, 17, 12, 3923, 307, 1952, 46986, 3337, 22288, 306, 2145, 624, 65, 8, 576, 16248, 19745, 315, 23628, 362, 49729, 264, 3746, 16162, 518, 2163, 220, 16, 22, 20, 15, 9961, 49309, 16, 19853, 11, 16248, 19745, 315, 23628, 468, 49729, 3746, 16162, 518, 2163, 220, 16, 22, 16, 20, 9961, 49309, 16, 382, 32, 8, 220, 18, 11, 19, 1737, 318, 41872, 66, 3337, 385, 17308, 276, 12, 16, 18589, 198, 33, 8, 220, 17, 11, 18, 11, 19, 10188, 318, 41872, 66, 3337, 22288, 306, 276, 12, 16, 18589, 198, 34, 8, 220, 17, 11, 17, 11, 18, 11, 19, 2385, 295, 2396, 41872, 66, 3337, 1684, 48524, 12, 16, 18589, 198, 35, 8, 220, 19, 1448, 41872, 66, 3337, 385, 383, 417, 276, 12, 16, 18589, 151645, 198, 151644, 77091, 198]",,305,397,702,1.0,1.0
fb1aa9dc-402b-4e16-a984-e5df7b16a983,7,28,"[151643, 151643, 151643, 151643, 151643, 151643, 151643, 151643, 151643, 151643, 151643, 151643, 151643, 151643, 151643, 151643, 151643, 151643, 151643, 151643, 151643, 151643, 151643, 151643, 151643, 151643, 151643, 151643, 151643, 151643, 151643, 151643, 151643, 151643, 151643, 151643, 151643, 151643, 151643, 151643, 151643, 151643, 151643, 151643, 151643, 151643, 151643, 151643, 151643, 151643, 151643, 151643, 151643, 151643, 151643, 151643, 151643, 151643, 151643, 151643, 151643, 151643, 151643, 151643, 151643, 151643, 151643, 151643, 151643, 151643, 151643, 151643, 151643, 151643, 151643, 151643, 151643, 151643, 151643, 151643, 151643, 151643, 151643, 151643, 151643, 151643, 151643, 151643, 151643, 151643, 151643, 151643, 151643, 151643, 151643, 151643, 151643, 151643, 151643, 151643, 151643, 151643, 151643, 151643, 151643, 151643, 151643, 151643, 151643, 151643, 151643, 151643, 151643, 151643, 151643, 151643, 151643, 151643, 151643, 151643, 151643, 151643, 151643, 151643, 151643, 151643, 151643, 151643, 151643, 151643, 151643, 151643, 151643, 151643, 151643, 151643, 151643, 151643, 151643, 151643, 151643, 151643, 151643, 151643, 151643, 151643, 151643, 151643, 151643, 151643, 151643, 151643, 151643, 151643, 151643, 151643, 151643, 151643, 151643, 151643, 151643, 151643, 151643, 151643, 151643, 151643, 151643, 151643, 151643, 151643, 151643, 151643, 151643, 151643, 151643, 151643, 151643, 151643, 151643, 151643, 151643, 151643, 151643, 151643, 151643, 151643, 151643, 151643, 151643, 151643, 151643, 151643, 151643, 151643, 151643, 151643, 151643, 151643, 151643, 151643, 151643, 151643, 151643, 151643, 151643, 151643, 151643, 151643, 151643, 151643, 151643, 151643, 151643, 151643, 151643, 151643, 151643, 151643, 151643, 151643, 151643, 151643, 151643, 151643, 151643, 151643, 151643, 151643, 151643, 151643, 151643, 151643, 151643, 151643, 151643, 151643, 151643, 151643, 151643, 151643, 151643, 151643, 151643, 151643, 151643, 151643, 151643, 151643, 151643, 151643, 151643, 151643, 151643, 151643, 151643, 151643, 151643, 151643, 151643, 151643, 151643, 151643, 151643, 151643, 151643, 151643, 151643, 151643, 151643, 151643, 151643, 151643, 151643, 151643, 151643, 151643, 151643, 151643, 151643, 151643, 151643, 151643, 151643, 151643, 151643, 151643, 151643, 151643, 151643, 151643, 151643, 151643, 151643, 151643, 151643, 151643, 151643, 151643, 151643, 151643, 151643, 151643, 151643, 151643, 151643, 151643, 151643, 151643, 151643, 151643, 151643, 151643, 151643, 151643, 151643, 151643, 151643, 151643, 151643, 151643, 151643, 151643, 151643, 151643, 151643, 151643, 151643, 151643, 151643, 151643, 151643, 151643, 151643, 151643, 151643, 151643, 151643, 151643, 151643, 151643, 151643, 151643, 151643, 151643, 151643, 151643, 151643, 151643, 151643, 151643, 151643, 151643, 151643, 151643, 151643, 151643, 151643, 151643, 151643, 151643, 151643, 151643, 151643, 151643, 151643, 151643, 151643, 151643, 151643, 151643, 151643, 151643, 151643, 151643, 151643, 151643, 151643, 151643, 151643, 151643, 151643, 151643, 151643, 151643, 151643, 151643, 151643, 151643, 151643, 151643, 151643, 151643, 151643, 151643, 151643, 151643, 151643, 151643, 151643, 151643, 151643, 151643, 151643, 151643, 151643, 151643, 151643, 151643, 151643, 151643, 151643, 151643, 151643, 151643, 151643, 151643, 151643, 151643, 151643, 151643, 151643, 151643, 151643, 151643, 151643, 151643, 151643, 151643, 151643, 151643, 151643, 151643, 151643, 151643, 151643, 151643, 151643, 151643, 151643, 151643, 151643, 151643, 151643, 151643, 151643, 151643, 151643, 151643, 151643, 151643, 151643, 151643, 151643, 151643, 151643, 151643, 151643, 151643, 151643, 151643, 151643, 151643, 151643, 151643, 151643, 151643, 151643, 151643, 151643, 151643, 151643, 151643, 151643, 151643, 151643, 151643, 151643, 151643, 151643, 151643, 151643, 151643, 151643, 151643, 151643, 151643, 151643, 151643, 151643, 151643, 151643, 151643, 151643, 151643, 151643, 151643, 151643, 151643, 151643, 151643, 151643, 151643, 151643, 151643, 151643, 151643, 151643, 151643, 151643, 151643, 151643, 151643, 151643, 151643, 151643, 151643, 151643, 151643, 151643, 151643, 151643, 151643, 151643, 151643, 151643, 151643, 151643, 151643, 151643, 151643, 151643, 151643, 151643, 151643, 151643, 151643, 151643, 151643, 151643, 151643, 151643, 151643, 151643, 151643, 151643, 151643, 151643, 151643, 151643, 151643, 151643, 151643, 151643, 151643, 151643, 151643, 151643, 151643, 151643, 151643, 151643, 151643, 151643, 151643, 151643, 151643, 151643, 151643, 151643, 151643, 151643, 151643, 151643, 151643, 151643, 151643, 151643, 151643, 151643, 151643, 151643, 151643, 151643, 151643, 151643, 151643, 151643, 151643, 151643, 151643, 151643, 151643, 151643, 151643, 151643, 151643, 151643, 151643, 151643, 151643, 151643, 151643, 151643, 151643, 151643, 151643, 151643, 151643, 151643, 151643, 151643, 151643, 151643, 151643, 151643, 151643, 151643, 151643, 151643, 151643, 151643, 151643, 151643, 151643, 151643, 151643, 151643, 151643, 151643, 151643, 151643, 151643, 151643, 151643, 151643, 151643, 151643, 151643, 151643, 151643, 151643, 151643, 151643, 151643, 151643, 151643, 151643, 151643, 151643, 151643, 151643, 151643, 151643, 151643, 151643, 151643, 151643, 151643, 151643, 151643, 151643, 151643, 151643, 151643, 151643, 151643, 151643, 151643, 151643, 151643, 151643, 151643, 151643, 151643, 151643, 151643, 151643, 151643, 151643, 151643, 151643, 151643, 151643, 151643, 151643, 151643, 151643, 151643, 151643, 151643, 151643, 151643, 151643, 151643, 151643, 151643, 151643, 151643, 151643, 151643, 151643, 151643, 151643, 151643, 151643, 151643, 151643, 151643, 151643, 151643, 151644, 8948, 198, 2610, 525, 1207, 16948, 11, 3465, 553, 54364, 14817, 13, 1446, 525, 264, 10950, 17847, 13, 151645, 198, 151644, 872, 198, 16141, 279, 2701, 5248, 5754, 3405, 13, 576, 1537, 1555, 315, 697, 2033, 1265, 387, 315, 279, 2701, 3561, 25, 364, 16141, 25, 400, 20756, 4198, 6, 320, 28996, 17194, 8, 1380, 44428, 374, 825, 315, 19360, 35, 13, 21149, 3019, 553, 3019, 1573, 35764, 382, 11613, 32875, 614, 1012, 16507, 26507, 287, 264, 6774, 1667, 2176, 279, 24065, 323, 56836, 15435, 320, 35281, 8, 5413, 13, 576, 6774, 702, 264, 3072, 315, 220, 16, 13, 20, 3039, 429, 315, 279, 8059, 11, 264, 10578, 220, 16, 13, 17, 3039, 429, 315, 279, 8059, 11, 323, 458, 7373, 9315, 320, 51, 6445, 8, 315, 220, 21, 18, 15, 15, 730, 13, 28835, 16, 702, 264, 3072, 13578, 311, 220, 22, 9237, 31638, 323, 264, 10578, 220, 16, 13, 22, 3039, 429, 315, 9237, 11, 1393, 28835, 17, 702, 264, 3072, 13578, 311, 220, 20, 9237, 31638, 323, 264, 10578, 220, 16, 13, 18, 3039, 429, 315, 9237, 13, 57503, 11, 2176, 32875, 525, 304, 26931, 85128, 13, 28835, 16, 89874, 264, 38345, 6407, 315, 705, 311, 220, 15, 13, 15, 18, 79252, 304, 279, 36813, 1555, 508, 79781, 60, 518, 220, 21, 18, 15, 15, 79252, 11, 1393, 279, 69919, 5421, 315, 28835, 17, 389, 279, 1852, 1555, 3059, 304, 264, 38345, 96574, 12910, 6407, 315, 705, 311, 220, 15, 13, 15, 19, 79252, 13, 63964, 429, 2176, 32875, 15218, 279, 1852, 452, 88987, 11, 1128, 374, 279, 11341, 315, 279, 55311, 19879, 1948, 28835, 16, 323, 28835, 17, 1939, 32, 8, 3968, 220, 15, 13, 20, 18, 198, 33, 8, 3968, 220, 15, 13, 24, 23, 198, 34, 8, 3968, 220, 16, 13, 15, 20, 198, 35, 8, 3968, 220, 16, 13, 18, 15, 151645, 198, 151644, 77091, 198]",,314,773,1087,1.0,1.0
d039b908-4e16-44cf-ae57-62eaa669a1ec,7,29,"[151643, 151643, 151643, 151643, 151643, 151643, 151643, 151643, 151643, 151643, 151643, 151643, 151643, 151643, 151643, 151643, 151643, 151643, 151643, 151643, 151643, 151643, 151643, 151643, 151643, 151643, 151643, 151643, 151643, 151643, 151643, 151643, 151643, 151643, 151643, 151643, 151643, 151643, 151643, 151643, 151643, 151643, 151643, 151643, 151643, 151643, 151643, 151643, 151643, 151643, 151643, 151643, 151643, 151643, 151643, 151643, 151643, 151643, 151643, 151643, 151643, 151643, 151643, 151643, 151643, 151643, 151643, 151643, 151643, 151643, 151643, 151643, 151643, 151643, 151643, 151643, 151643, 151643, 151643, 151643, 151643, 151643, 151643, 151643, 151643, 151643, 151643, 151643, 151643, 151643, 151643, 151643, 151643, 151643, 151643, 151643, 151643, 151643, 151643, 151643, 151643, 151643, 151643, 151643, 151643, 151643, 151643, 151643, 151643, 151643, 151643, 151643, 151643, 151643, 151643, 151643, 151643, 151643, 151643, 151643, 151643, 151643, 151643, 151643, 151643, 151643, 151643, 151643, 151643, 151643, 151643, 151643, 151643, 151643, 151643, 151643, 151643, 151643, 151643, 151643, 151643, 151643, 151643, 151643, 151643, 151643, 151643, 151643, 151643, 151643, 151643, 151643, 151643, 151643, 151643, 151643, 151643, 151643, 151643, 151643, 151643, 151643, 151643, 151643, 151643, 151643, 151643, 151643, 151643, 151643, 151643, 151643, 151643, 151643, 151643, 151643, 151643, 151643, 151643, 151643, 151643, 151643, 151643, 151643, 151643, 151643, 151643, 151643, 151643, 151643, 151643, 151643, 151643, 151643, 151643, 151643, 151643, 151643, 151643, 151643, 151643, 151643, 151643, 151643, 151643, 151643, 151643, 151643, 151643, 151643, 151643, 151643, 151643, 151643, 151643, 151643, 151643, 151643, 151643, 151643, 151643, 151643, 151643, 151643, 151643, 151643, 151643, 151643, 151643, 151643, 151643, 151643, 151643, 151643, 151643, 151643, 151643, 151643, 151643, 151643, 151643, 151643, 151643, 151643, 151643, 151643, 151643, 151643, 151643, 151643, 151643, 151643, 151643, 151643, 151643, 151643, 151643, 151643, 151643, 151643, 151643, 151643, 151643, 151643, 151643, 151643, 151643, 151643, 151643, 151643, 151643, 151643, 151643, 151643, 151643, 151643, 151643, 151643, 151643, 151643, 151643, 151643, 151643, 151643, 151643, 151643, 151643, 151643, 151643, 151643, 151643, 151643, 151643, 151643, 151643, 151643, 151643, 151643, 151643, 151643, 151643, 151643, 151643, 151643, 151643, 151643, 151643, 151643, 151643, 151643, 151643, 151643, 151643, 151643, 151643, 151643, 151643, 151643, 151643, 151643, 151643, 151643, 151643, 151643, 151643, 151643, 151643, 151643, 151643, 151643, 151643, 151643, 151643, 151643, 151643, 151643, 151643, 151643, 151643, 151643, 151643, 151643, 151643, 151643, 151643, 151643, 151643, 151643, 151643, 151643, 151643, 151643, 151643, 151643, 151643, 151643, 151643, 151643, 151643, 151643, 151643, 151643, 151643, 151643, 151643, 151643, 151643, 151643, 151643, 151643, 151643, 151643, 151643, 151643, 151643, 151643, 151643, 151643, 151643, 151643, 151643, 151643, 151643, 151643, 151643, 151643, 151643, 151643, 151643, 151643, 151643, 151643, 151643, 151643, 151643, 151643, 151643, 151643, 151643, 151643, 151643, 151643, 151643, 151643, 151643, 151643, 151643, 151643, 151643, 151643, 151643, 151643, 151643, 151643, 151643, 151643, 151643, 151643, 151643, 151643, 151643, 151643, 151643, 151643, 151643, 151643, 151643, 151643, 151643, 151643, 151643, 151643, 151643, 151643, 151643, 151643, 151643, 151643, 151643, 151643, 151643, 151643, 151643, 151643, 151643, 151643, 151643, 151643, 151643, 151643, 151643, 151643, 151643, 151643, 151643, 151643, 151643, 151643, 151643, 151643, 151643, 151643, 151643, 151643, 151643, 151643, 151643, 151643, 151643, 151643, 151643, 151643, 151643, 151643, 151643, 151643, 151643, 151643, 151643, 151643, 151643, 151643, 151643, 151643, 151643, 151643, 151643, 151643, 151643, 151643, 151643, 151643, 151643, 151643, 151643, 151643, 151643, 151643, 151643, 151643, 151643, 151643, 151643, 151643, 151643, 151643, 151643, 151643, 151643, 151643, 151643, 151643, 151643, 151643, 151643, 151643, 151643, 151643, 151643, 151643, 151643, 151643, 151643, 151643, 151643, 151643, 151643, 151643, 151643, 151643, 151643, 151643, 151643, 151643, 151643, 151643, 151643, 151643, 151643, 151643, 151643, 151643, 151643, 151643, 151643, 151643, 151643, 151643, 151643, 151643, 151643, 151643, 151643, 151643, 151643, 151643, 151643, 151643, 151643, 151643, 151643, 151643, 151643, 151643, 151643, 151643, 151643, 151643, 151643, 151643, 151643, 151643, 151643, 151643, 151643, 151643, 151643, 151643, 151643, 151643, 151643, 151643, 151643, 151643, 151643, 151643, 151643, 151643, 151643, 151643, 151643, 151643, 151643, 151643, 151643, 151643, 151643, 151643, 151643, 151643, 151643, 151643, 151643, 151643, 151643, 151643, 151643, 151643, 151643, 151643, 151643, 151643, 151643, 151643, 151643, 151643, 151643, 151643, 151643, 151643, 151643, 151643, 151643, 151643, 151643, 151643, 151643, 151643, 151643, 151643, 151643, 151643, 151643, 151643, 151643, 151643, 151643, 151643, 151643, 151643, 151643, 151643, 151643, 151643, 151643, 151643, 151643, 151643, 151643, 151643, 151643, 151643, 151643, 151643, 151643, 151643, 151643, 151643, 151643, 151643, 151643, 151643, 151643, 151643, 151643, 151643, 151643, 151643, 151643, 151643, 151643, 151643, 151643, 151643, 151643, 151643, 151643, 151643, 151643, 151643, 151643, 151643, 151643, 151643, 151643, 151643, 151643, 151643, 151643, 151643, 151643, 151643, 151643, 151643, 151643, 151643, 151643, 151643, 151643, 151643, 151643, 151643, 151643, 151643, 151643, 151643, 151643, 151643, 151643, 151643, 151643, 151643, 151643, 151643, 151643, 151643, 151643, 151643, 151643, 151643, 151643, 151643, 151643, 151643, 151643, 151643, 151643, 151643, 151643, 151643, 151643, 151643, 151643, 151643, 151643, 151643, 151643, 151643, 151643, 151643, 151643, 151643, 151643, 151643, 151643, 151643, 151643, 151643, 151643, 151643, 151643, 151643, 151643, 151643, 151643, 151643, 151643, 151643, 151643, 151643, 151643, 151643, 151643, 151643, 151643, 151643, 151643, 151643, 151643, 151643, 151643, 151643, 151643, 151643, 151643, 151643, 151643, 151643, 151643, 151643, 151643, 151643, 151643, 151643, 151643, 151643, 151643, 151643, 151643, 151643, 151643, 151643, 151643, 151643, 151643, 151643, 151643, 151643, 151643, 151643, 151643, 151643, 151643, 151643, 151643, 151643, 151643, 151643, 151643, 151643, 151643, 151643, 151643, 151643, 151643, 151643, 151643, 151643, 151643, 151643, 151643, 151643, 151643, 151643, 151643, 151643, 151643, 151643, 151643, 151643, 151643, 151643, 151643, 151643, 151643, 151643, 151643, 151644, 8948, 198, 2610, 525, 1207, 16948, 11, 3465, 553, 54364, 14817, 13, 1446, 525, 264, 10950, 17847, 13, 151645, 198, 151644, 872, 198, 16141, 279, 2701, 5248, 5754, 3405, 13, 576, 1537, 1555, 315, 697, 2033, 1265, 387, 315, 279, 2701, 3561, 25, 364, 16141, 25, 400, 20756, 4198, 6, 320, 28996, 17194, 8, 1380, 44428, 374, 825, 315, 19360, 35, 13, 21149, 3019, 553, 3019, 1573, 35764, 382, 56511, 525, 78890, 518, 279, 4126, 315, 264, 64151, 31214, 17387, 501, 943, 315, 18730, 429, 5821, 98150, 518, 23998, 47612, 19488, 4532, 74057, 7548, 30188, 2163, 53233, 406, 89, 8168, 315, 3968, 17, 15, 13, 1913, 5461, 11, 825, 4843, 315, 1493, 4937, 6810, 66, 17270, 18730, 24491, 279, 31214, 9179, 14285, 13, 715, 785, 10578, 315, 279, 31214, 374, 220, 18, 15, 20044, 382, 3838, 53233, 406, 89, 8168, 374, 4362, 304, 1973, 311, 614, 911, 1378, 93137, 315, 1493, 18730, 18739, 279, 31214, 9179, 14285, 1939, 32, 8, 220, 20, 19, 198, 33, 8, 220, 17, 23, 198, 34, 8, 220, 19, 15, 198, 35, 8, 220, 21, 23, 151645, 198, 151644, 77091, 198]",,187,770,957,0.0,0.0
853e51ca-b26f-4ce5-913a-7b186c43ac47,7,30,"[151643, 151643, 151643, 151643, 151643, 151643, 151643, 151643, 151643, 151643, 151643, 151643, 151643, 151643, 151643, 151643, 151643, 151643, 151643, 151643, 151643, 151643, 151643, 151643, 151643, 151643, 151643, 151643, 151643, 151643, 151643, 151643, 151643, 151643, 151643, 151643, 151643, 151643, 151643, 151643, 151643, 151643, 151643, 151643, 151643, 151643, 151643, 151643, 151643, 151643, 151643, 151643, 151643, 151643, 151643, 151643, 151643, 151643, 151643, 151643, 151643, 151643, 151643, 151643, 151643, 151643, 151643, 151643, 151643, 151643, 151643, 151643, 151643, 151643, 151643, 151643, 151643, 151643, 151643, 151643, 151643, 151643, 151643, 151643, 151643, 151643, 151643, 151643, 151643, 151643, 151643, 151643, 151643, 151643, 151643, 151643, 151643, 151643, 151643, 151643, 151643, 151643, 151643, 151643, 151643, 151643, 151643, 151643, 151643, 151643, 151643, 151643, 151643, 151643, 151643, 151643, 151643, 151643, 151643, 151643, 151643, 151643, 151643, 151643, 151643, 151643, 151643, 151643, 151643, 151643, 151643, 151643, 151643, 151643, 151643, 151643, 151643, 151643, 151643, 151643, 151643, 151643, 151643, 151643, 151643, 151643, 151643, 151643, 151643, 151643, 151643, 151643, 151643, 151643, 151643, 151643, 151643, 151643, 151643, 151643, 151643, 151643, 151643, 151643, 151643, 151643, 151643, 151643, 151643, 151643, 151643, 151643, 151643, 151643, 151643, 151643, 151643, 151643, 151643, 151643, 151643, 151643, 151643, 151643, 151643, 151643, 151643, 151643, 151643, 151643, 151643, 151643, 151643, 151643, 151643, 151643, 151643, 151643, 151643, 151643, 151643, 151643, 151643, 151643, 151643, 151643, 151643, 151643, 151643, 151643, 151643, 151643, 151643, 151643, 151643, 151643, 151643, 151643, 151643, 151643, 151643, 151643, 151643, 151643, 151643, 151643, 151643, 151643, 151643, 151643, 151643, 151643, 151643, 151643, 151643, 151643, 151643, 151643, 151643, 151643, 151643, 151643, 151643, 151643, 151643, 151643, 151643, 151643, 151643, 151643, 151643, 151643, 151643, 151643, 151643, 151643, 151643, 151643, 151643, 151643, 151643, 151643, 151643, 151643, 151643, 151643, 151643, 151643, 151643, 151643, 151643, 151643, 151643, 151643, 151643, 151643, 151643, 151643, 151643, 151643, 151643, 151643, 151643, 151643, 151643, 151643, 151643, 151643, 151643, 151643, 151643, 151643, 151643, 151643, 151643, 151643, 151643, 151643, 151643, 151643, 151643, 151643, 151643, 151643, 151643, 151643, 151643, 151643, 151643, 151643, 151643, 151643, 151643, 151643, 151643, 151643, 151643, 151643, 151643, 151643, 151643, 151643, 151643, 151643, 151643, 151643, 151643, 151643, 151643, 151643, 151643, 151643, 151643, 151643, 151643, 151643, 151643, 151643, 151643, 151643, 151643, 151643, 151643, 151643, 151643, 151643, 151643, 151643, 151643, 151643, 151643, 151643, 151643, 151643, 151643, 151643, 151643, 151643, 151643, 151643, 151643, 151643, 151643, 151643, 151643, 151643, 151643, 151643, 151643, 151643, 151643, 151643, 151643, 151643, 151643, 151643, 151643, 151643, 151643, 151643, 151643, 151643, 151643, 151643, 151643, 151643, 151643, 151643, 151643, 151643, 151643, 151643, 151643, 151643, 151643, 151643, 151643, 151643, 151643, 151643, 151643, 151643, 151643, 151643, 151643, 151643, 151643, 151643, 151643, 151643, 151643, 151643, 151643, 151643, 151643, 151643, 151643, 151643, 151643, 151643, 151643, 151643, 151643, 151643, 151643, 151643, 151643, 151643, 151643, 151643, 151643, 151643, 151643, 151643, 151643, 151643, 151643, 151643, 151643, 151643, 151643, 151643, 151643, 151643, 151643, 151643, 151643, 151643, 151643, 151643, 151643, 151643, 151643, 151643, 151643, 151643, 151643, 151643, 151643, 151643, 151643, 151643, 151643, 151643, 151643, 151643, 151643, 151643, 151643, 151643, 151643, 151643, 151643, 151643, 151643, 151643, 151643, 151643, 151643, 151643, 151643, 151643, 151643, 151643, 151643, 151643, 151643, 151643, 151643, 151643, 151643, 151643, 151643, 151643, 151643, 151643, 151643, 151643, 151643, 151643, 151643, 151643, 151643, 151643, 151643, 151643, 151643, 151643, 151643, 151643, 151643, 151643, 151643, 151643, 151643, 151643, 151643, 151643, 151643, 151643, 151643, 151643, 151643, 151643, 151643, 151643, 151643, 151643, 151643, 151643, 151643, 151643, 151643, 151643, 151643, 151643, 151643, 151643, 151643, 151643, 151643, 151643, 151643, 151643, 151643, 151643, 151643, 151643, 151643, 151643, 151643, 151643, 151643, 151643, 151643, 151643, 151643, 151643, 151643, 151643, 151643, 151643, 151643, 151643, 151643, 151643, 151643, 151643, 151643, 151643, 151643, 151643, 151643, 151643, 151643, 151643, 151643, 151643, 151643, 151643, 151643, 151643, 151643, 151643, 151643, 151643, 151643, 151643, 151643, 151643, 151643, 151643, 151643, 151643, 151643, 151643, 151643, 151643, 151643, 151643, 151643, 151643, 151643, 151643, 151643, 151643, 151643, 151643, 151643, 151643, 151643, 151643, 151643, 151643, 151643, 151643, 151643, 151643, 151643, 151643, 151643, 151643, 151643, 151643, 151643, 151643, 151643, 151643, 151643, 151643, 151643, 151643, 151643, 151643, 151643, 151643, 151643, 151643, 151643, 151643, 151643, 151643, 151643, 151643, 151643, 151643, 151643, 151643, 151643, 151643, 151643, 151643, 151643, 151643, 151643, 151643, 151643, 151643, 151643, 151643, 151643, 151643, 151643, 151643, 151643, 151643, 151643, 151643, 151643, 151643, 151643, 151643, 151643, 151643, 151643, 151643, 151643, 151643, 151643, 151643, 151643, 151643, 151643, 151643, 151643, 151643, 151643, 151643, 151643, 151643, 151643, 151643, 151643, 151643, 151643, 151643, 151643, 151643, 151643, 151643, 151643, 151643, 151643, 151643, 151643, 151643, 151643, 151643, 151643, 151643, 151643, 151643, 151643, 151643, 151643, 151643, 151643, 151643, 151643, 151643, 151643, 151643, 151643, 151643, 151643, 151643, 151643, 151643, 151643, 151643, 151643, 151643, 151643, 151643, 151643, 151643, 151643, 151643, 151643, 151643, 151643, 151643, 151643, 151643, 151643, 151643, 151643, 151643, 151643, 151643, 151643, 151643, 151643, 151643, 151643, 151643, 151643, 151643, 151643, 151643, 151643, 151643, 151643, 151643, 151643, 151643, 151643, 151643, 151643, 151643, 151643, 151643, 151643, 151643, 151643, 151643, 151643, 151643, 151643, 151643, 151644, 8948, 198, 2610, 525, 1207, 16948, 11, 3465, 553, 54364, 14817, 13, 1446, 525, 264, 10950, 17847, 13, 151645, 198, 151644, 872, 198, 16141, 279, 2701, 5248, 5754, 3405, 13, 576, 1537, 1555, 315, 697, 2033, 1265, 387, 315, 279, 2701, 3561, 25, 364, 16141, 25, 400, 20756, 4198, 6, 320, 28996, 17194, 8, 1380, 44428, 374, 825, 315, 19360, 35, 13, 21149, 3019, 553, 3019, 1573, 35764, 382, 28301, 1437, 279, 23628, 356, 24, 39, 16, 16, 8996, 17, 1667, 279, 2661, 821, 624, 2801, 25, 11051, 311, 3746, 20612, 20892, 518, 220, 18, 19, 17, 15, 9961, 12, 16, 11, 220, 18, 18, 17, 20, 9961, 12, 16, 198, 4519, 7055, 518, 220, 16, 22, 17, 15, 9961, 12, 16, 198, 16, 39, 451, 18446, 25, 220, 16, 13, 17, 15, 63597, 320, 83, 11, 220, 18, 39, 1215, 220, 19, 13, 15, 63597, 320, 1279, 11, 220, 17, 39, 1215, 220, 19, 13, 20, 63597, 320, 80, 11, 220, 17, 39, 1215, 220, 22, 13, 15, 63597, 320, 67, 11, 220, 17, 39, 701, 220, 23, 13, 15, 63597, 320, 67, 11, 220, 17, 39, 3593, 32, 8, 220, 18, 12, 769, 60163, 7964, 89, 65696, 198, 33, 8, 8372, 3923, 220, 19, 12, 8608, 674, 268, 12738, 349, 198, 34, 8, 451, 8013, 19, 12, 769, 60163, 14769, 3923, 8, 627, 65696, 198, 35, 8, 220, 19, 12, 8608, 5127, 268, 3923, 2004, 84899, 151645, 198, 151644, 77091, 198]",,244,597,841,0.0,0.0
9e1247ce-cf90-4625-806c-e587aac3ecff,7,31,"[151643, 151643, 151643, 151643, 151643, 151643, 151643, 151643, 151643, 151643, 151643, 151643, 151643, 151643, 151643, 151643, 151643, 151643, 151643, 151643, 151643, 151643, 151643, 151643, 151643, 151643, 151643, 151643, 151643, 151643, 151643, 151643, 151643, 151643, 151643, 151643, 151643, 151643, 151643, 151643, 151643, 151643, 151643, 151643, 151643, 151643, 151643, 151643, 151643, 151643, 151643, 151643, 151643, 151643, 151643, 151643, 151643, 151643, 151643, 151643, 151643, 151643, 151643, 151643, 151643, 151643, 151643, 151643, 151643, 151643, 151643, 151643, 151643, 151643, 151643, 151643, 151643, 151643, 151643, 151643, 151643, 151643, 151643, 151643, 151643, 151643, 151643, 151643, 151643, 151643, 151643, 151643, 151643, 151643, 151643, 151643, 151643, 151643, 151643, 151643, 151643, 151643, 151643, 151643, 151643, 151643, 151643, 151643, 151643, 151643, 151643, 151643, 151643, 151643, 151643, 151643, 151643, 151643, 151643, 151643, 151643, 151643, 151643, 151643, 151643, 151643, 151643, 151643, 151643, 151643, 151643, 151643, 151643, 151643, 151643, 151643, 151643, 151643, 151643, 151643, 151643, 151643, 151643, 151643, 151643, 151643, 151643, 151643, 151643, 151643, 151643, 151643, 151643, 151643, 151643, 151643, 151643, 151643, 151643, 151643, 151643, 151643, 151643, 151643, 151643, 151643, 151643, 151643, 151643, 151643, 151643, 151643, 151643, 151643, 151643, 151643, 151643, 151643, 151643, 151643, 151643, 151643, 151643, 151643, 151643, 151643, 151643, 151643, 151643, 151643, 151643, 151643, 151643, 151643, 151643, 151643, 151643, 151643, 151643, 151643, 151643, 151643, 151643, 151643, 151643, 151643, 151643, 151643, 151643, 151643, 151643, 151643, 151643, 151643, 151643, 151643, 151643, 151643, 151643, 151643, 151643, 151643, 151643, 151643, 151643, 151643, 151643, 151643, 151643, 151643, 151643, 151643, 151643, 151643, 151643, 151643, 151643, 151643, 151643, 151643, 151643, 151643, 151643, 151643, 151643, 151643, 151643, 151643, 151643, 151643, 151643, 151643, 151643, 151643, 151643, 151643, 151643, 151643, 151643, 151643, 151643, 151643, 151643, 151643, 151643, 151643, 151643, 151643, 151643, 151643, 151643, 151643, 151643, 151643, 151643, 151643, 151643, 151643, 151643, 151643, 151643, 151643, 151643, 151643, 151643, 151643, 151643, 151643, 151643, 151643, 151643, 151643, 151643, 151643, 151643, 151643, 151643, 151643, 151643, 151643, 151643, 151643, 151643, 151643, 151643, 151643, 151643, 151643, 151643, 151643, 151643, 151643, 151643, 151643, 151643, 151643, 151643, 151643, 151643, 151643, 151643, 151643, 151643, 151643, 151643, 151643, 151643, 151643, 151643, 151643, 151643, 151643, 151643, 151643, 151643, 151643, 151643, 151643, 151643, 151643, 151643, 151643, 151643, 151643, 151643, 151643, 151643, 151643, 151643, 151643, 151643, 151643, 151643, 151643, 151643, 151643, 151643, 151643, 151643, 151643, 151643, 151643, 151643, 151643, 151643, 151643, 151643, 151643, 151643, 151643, 151643, 151643, 151643, 151643, 151643, 151643, 151643, 151643, 151643, 151643, 151643, 151643, 151643, 151643, 151643, 151643, 151643, 151643, 151643, 151643, 151643, 151643, 151643, 151643, 151643, 151643, 151643, 151643, 151643, 151643, 151643, 151643, 151643, 151643, 151643, 151643, 151643, 151643, 151643, 151643, 151643, 151643, 151643, 151643, 151643, 151643, 151643, 151643, 151643, 151643, 151643, 151643, 151643, 151643, 151643, 151643, 151643, 151643, 151643, 151643, 151643, 151643, 151643, 151643, 151643, 151643, 151643, 151643, 151643, 151643, 151643, 151643, 151643, 151643, 151643, 151643, 151643, 151643, 151643, 151643, 151643, 151643, 151643, 151643, 151643, 151643, 151643, 151643, 151643, 151643, 151643, 151643, 151643, 151643, 151643, 151643, 151643, 151643, 151643, 151643, 151643, 151643, 151643, 151643, 151643, 151643, 151643, 151643, 151643, 151643, 151643, 151643, 151643, 151643, 151643, 151643, 151643, 151643, 151643, 151643, 151643, 151643, 151643, 151643, 151643, 151643, 151643, 151643, 151643, 151643, 151643, 151643, 151643, 151643, 151643, 151643, 151643, 151643, 151643, 151643, 151643, 151643, 151643, 151643, 151643, 151643, 151643, 151643, 151643, 151643, 151643, 151643, 151643, 151643, 151643, 151643, 151643, 151643, 151643, 151643, 151643, 151643, 151643, 151643, 151643, 151643, 151643, 151643, 151643, 151643, 151643, 151643, 151643, 151643, 151643, 151643, 151643, 151643, 151643, 151643, 151643, 151643, 151643, 151643, 151643, 151643, 151643, 151643, 151643, 151643, 151643, 151643, 151643, 151643, 151643, 151643, 151643, 151643, 151643, 151643, 151643, 151643, 151643, 151643, 151643, 151643, 151643, 151643, 151643, 151643, 151643, 151643, 151643, 151643, 151643, 151643, 151643, 151643, 151643, 151643, 151643, 151643, 151643, 151643, 151643, 151643, 151643, 151643, 151643, 151643, 151643, 151643, 151643, 151643, 151643, 151643, 151643, 151643, 151643, 151643, 151643, 151643, 151643, 151643, 151643, 151643, 151643, 151643, 151643, 151643, 151643, 151643, 151643, 151643, 151643, 151643, 151643, 151643, 151643, 151643, 151643, 151643, 151643, 151643, 151643, 151643, 151643, 151643, 151643, 151643, 151643, 151643, 151643, 151643, 151643, 151643, 151643, 151643, 151643, 151643, 151643, 151643, 151643, 151643, 151643, 151643, 151643, 151643, 151643, 151643, 151643, 151643, 151643, 151643, 151643, 151643, 151643, 151643, 151643, 151643, 151643, 151643, 151643, 151643, 151643, 151643, 151643, 151643, 151643, 151643, 151643, 151643, 151643, 151643, 151643, 151643, 151643, 151643, 151643, 151643, 151643, 151643, 151643, 151643, 151643, 151643, 151643, 151643, 151643, 151643, 151643, 151643, 151643, 151643, 151643, 151643, 151643, 151643, 151643, 151643, 151643, 151643, 151643, 151643, 151643, 151643, 151643, 151643, 151643, 151643, 151643, 151643, 151643, 151643, 151643, 151643, 151643, 151643, 151643, 151643, 151644, 8948, 198, 2610, 525, 1207, 16948, 11, 3465, 553, 54364, 14817, 13, 1446, 525, 264, 10950, 17847, 13, 151645, 198, 151644, 872, 198, 16141, 279, 2701, 5248, 5754, 3405, 13, 576, 1537, 1555, 315, 697, 2033, 1265, 387, 315, 279, 2701, 3561, 25, 364, 16141, 25, 400, 20756, 4198, 6, 320, 28996, 17194, 8, 1380, 44428, 374, 825, 315, 19360, 35, 13, 21149, 3019, 553, 3019, 1573, 35764, 382, 43134, 362, 4933, 1378, 17289, 304, 279, 81486, 451, 18446, 11, 264, 98709, 518, 220, 15, 13, 24, 63597, 369, 220, 21, 39, 323, 264, 40276, 295, 518, 220, 16, 13, 18, 63597, 369, 220, 19, 39, 13, 1084, 36671, 288, 1615, 674, 441, 2554, 311, 1352, 23628, 425, 13, 425, 68845, 448, 55361, 37512, 39, 311, 1352, 356, 11, 892, 702, 1378, 67986, 12108, 374, 68538, 13, 576, 66404, 30430, 25359, 315, 356, 68845, 448, 320, 16, 36, 11, 18, 36, 7287, 79, 16576, 12, 16, 11, 18, 1737, 3591, 12, 16, 12, 337, 311, 8193, 23628, 422, 13, 64547, 23628, 422, 382, 32, 8, 320, 16, 50, 11, 19, 49, 11, 20, 50, 11, 21, 50, 7287, 19, 11, 20, 11, 21, 10188, 318, 41872, 66, 3337, 385, 17308, 12, 17, 20767, 337, 198, 33, 8, 320, 16, 50, 11, 19, 49, 7287, 19, 11, 21, 11, 21, 10188, 318, 41872, 66, 3337, 385, 17308, 12, 17, 20767, 337, 198, 34, 8, 320, 16, 50, 11, 19, 50, 7287, 19, 11, 21, 11, 21, 10188, 318, 41872, 66, 3337, 385, 17308, 12, 17, 20767, 337, 198, 35, 8, 320, 16, 50, 11, 19, 49, 11, 20, 50, 11, 21, 49, 7287, 19, 11, 20, 11, 21, 10188, 318, 41872, 66, 3337, 385, 17308, 12, 17, 20767, 337, 151645, 198, 151644, 77091, 198]",,294,501,795,0.0,0.0
399210c4-3ebd-4bee-b18d-e612b8390fa2,7,32,"[151643, 151643, 151643, 151643, 151643, 151643, 151643, 151643, 151643, 151643, 151643, 151643, 151643, 151643, 151643, 151643, 151643, 151643, 151643, 151643, 151643, 151643, 151643, 151643, 151643, 151643, 151643, 151643, 151643, 151643, 151643, 151643, 151643, 151643, 151643, 151643, 151643, 151643, 151643, 151643, 151643, 151643, 151643, 151643, 151643, 151643, 151643, 151643, 151643, 151643, 151643, 151643, 151643, 151643, 151643, 151643, 151643, 151643, 151643, 151643, 151643, 151643, 151643, 151643, 151643, 151643, 151643, 151643, 151643, 151643, 151643, 151643, 151643, 151643, 151643, 151643, 151643, 151643, 151643, 151643, 151643, 151643, 151643, 151643, 151643, 151643, 151643, 151643, 151643, 151643, 151643, 151643, 151643, 151643, 151643, 151643, 151643, 151643, 151643, 151643, 151643, 151643, 151643, 151643, 151643, 151643, 151643, 151643, 151643, 151643, 151643, 151643, 151643, 151643, 151643, 151643, 151643, 151643, 151643, 151643, 151643, 151643, 151643, 151643, 151643, 151643, 151643, 151643, 151643, 151643, 151643, 151643, 151643, 151643, 151643, 151643, 151643, 151643, 151643, 151643, 151643, 151643, 151643, 151643, 151643, 151643, 151643, 151643, 151643, 151643, 151643, 151643, 151643, 151643, 151643, 151643, 151643, 151643, 151643, 151643, 151643, 151643, 151643, 151643, 151643, 151643, 151643, 151643, 151643, 151643, 151643, 151643, 151643, 151643, 151643, 151643, 151643, 151643, 151643, 151643, 151643, 151643, 151643, 151643, 151643, 151643, 151643, 151643, 151643, 151643, 151643, 151643, 151643, 151643, 151643, 151643, 151643, 151643, 151643, 151643, 151643, 151643, 151643, 151643, 151643, 151643, 151643, 151643, 151643, 151643, 151643, 151643, 151643, 151643, 151643, 151643, 151643, 151643, 151643, 151643, 151643, 151643, 151643, 151643, 151643, 151643, 151643, 151643, 151643, 151643, 151643, 151643, 151643, 151643, 151643, 151643, 151643, 151643, 151643, 151643, 151643, 151643, 151643, 151643, 151643, 151643, 151643, 151643, 151643, 151643, 151643, 151643, 151643, 151643, 151643, 151643, 151643, 151643, 151643, 151643, 151643, 151643, 151643, 151643, 151643, 151643, 151643, 151643, 151643, 151643, 151643, 151643, 151643, 151643, 151643, 151643, 151643, 151643, 151643, 151643, 151643, 151643, 151643, 151643, 151643, 151643, 151643, 151643, 151643, 151643, 151643, 151643, 151643, 151643, 151643, 151643, 151643, 151643, 151643, 151643, 151643, 151643, 151643, 151643, 151643, 151643, 151643, 151643, 151643, 151643, 151643, 151643, 151643, 151643, 151643, 151643, 151643, 151643, 151643, 151643, 151643, 151643, 151643, 151643, 151643, 151643, 151643, 151643, 151643, 151643, 151643, 151643, 151643, 151643, 151643, 151643, 151643, 151643, 151643, 151643, 151643, 151643, 151643, 151643, 151643, 151643, 151643, 151643, 151643, 151643, 151643, 151643, 151643, 151643, 151643, 151643, 151643, 151643, 151643, 151643, 151643, 151643, 151643, 151643, 151643, 151643, 151643, 151643, 151643, 151643, 151643, 151643, 151643, 151643, 151643, 151643, 151643, 151643, 151643, 151643, 151643, 151643, 151643, 151643, 151643, 151643, 151643, 151643, 151643, 151643, 151643, 151643, 151643, 151643, 151643, 151643, 151643, 151643, 151643, 151643, 151643, 151643, 151643, 151643, 151643, 151643, 151643, 151643, 151643, 151643, 151643, 151643, 151643, 151643, 151643, 151643, 151643, 151643, 151643, 151643, 151643, 151643, 151643, 151643, 151643, 151643, 151643, 151643, 151643, 151643, 151643, 151643, 151643, 151643, 151643, 151643, 151643, 151643, 151643, 151643, 151643, 151643, 151643, 151643, 151643, 151643, 151643, 151643, 151643, 151643, 151643, 151643, 151643, 151643, 151643, 151643, 151643, 151643, 151643, 151643, 151643, 151643, 151643, 151643, 151643, 151643, 151643, 151643, 151643, 151643, 151643, 151643, 151643, 151643, 151643, 151643, 151643, 151643, 151643, 151643, 151643, 151643, 151643, 151643, 151643, 151643, 151643, 151643, 151643, 151643, 151643, 151643, 151643, 151643, 151643, 151643, 151643, 151643, 151643, 151643, 151643, 151643, 151643, 151643, 151643, 151643, 151643, 151643, 151643, 151643, 151643, 151643, 151643, 151643, 151643, 151643, 151643, 151643, 151643, 151643, 151643, 151643, 151643, 151643, 151643, 151643, 151643, 151643, 151643, 151643, 151643, 151643, 151643, 151643, 151643, 151643, 151643, 151643, 151643, 151643, 151643, 151643, 151643, 151643, 151643, 151643, 151643, 151643, 151643, 151643, 151643, 151643, 151643, 151643, 151643, 151643, 151643, 151643, 151643, 151643, 151643, 151643, 151643, 151643, 151643, 151643, 151643, 151643, 151643, 151643, 151643, 151643, 151643, 151643, 151643, 151643, 151643, 151643, 151643, 151643, 151643, 151643, 151643, 151643, 151643, 151643, 151643, 151643, 151643, 151643, 151643, 151643, 151643, 151643, 151643, 151643, 151643, 151643, 151643, 151643, 151643, 151643, 151643, 151643, 151643, 151643, 151643, 151643, 151643, 151643, 151643, 151643, 151643, 151643, 151643, 151643, 151643, 151643, 151643, 151643, 151643, 151643, 151643, 151643, 151643, 151643, 151643, 151643, 151643, 151643, 151643, 151643, 151643, 151643, 151643, 151643, 151643, 151643, 151643, 151643, 151643, 151643, 151643, 151643, 151643, 151643, 151643, 151643, 151643, 151643, 151643, 151643, 151643, 151643, 151643, 151643, 151643, 151643, 151643, 151643, 151643, 151643, 151643, 151643, 151643, 151643, 151643, 151643, 151643, 151643, 151643, 151643, 151643, 151643, 151643, 151643, 151643, 151643, 151643, 151643, 151643, 151643, 151643, 151643, 151643, 151643, 151643, 151643, 151643, 151643, 151643, 151643, 151643, 151643, 151643, 151644, 8948, 198, 2610, 525, 1207, 16948, 11, 3465, 553, 54364, 14817, 13, 1446, 525, 264, 10950, 17847, 13, 151645, 198, 151644, 872, 198, 16141, 279, 2701, 5248, 5754, 3405, 13, 576, 1537, 1555, 315, 697, 2033, 1265, 387, 315, 279, 2701, 3561, 25, 364, 16141, 25, 400, 20756, 4198, 6, 320, 28996, 17194, 8, 1380, 44428, 374, 825, 315, 19360, 35, 13, 21149, 3019, 553, 3019, 1573, 35764, 382, 59110, 525, 19405, 311, 11140, 1356, 1199, 315, 1378, 9237, 12681, 32875, 25, 28835, 62, 16, 323, 28835, 62, 17, 13, 2379, 614, 7199, 44971, 882, 323, 1366, 311, 22986, 279, 825, 429, 702, 279, 8426, 18927, 315, 1356, 5853, 13, 11733, 315, 1493, 32875, 614, 2669, 1012, 16507, 4566, 279, 32470, 1714, 11, 10693, 601, 311, 1414, 862, 8028, 31638, 323, 64591, 18346, 13, 10328, 2176, 32875, 4332, 279, 1852, 31638, 11, 279, 64591, 4168, 315, 28835, 62, 16, 374, 2326, 3039, 23327, 1091, 429, 315, 28835, 62, 17, 13, 57503, 11, 807, 2176, 614, 26931, 85128, 13, 23405, 11, 582, 1414, 279, 31638, 323, 11900, 72, 315, 279, 3468, 9759, 315, 1493, 1378, 32875, 13, 576, 6774, 19678, 28835, 62, 16, 702, 264, 3072, 429, 374, 10917, 429, 315, 279, 3468, 6774, 315, 28835, 62, 17, 13, 1634, 279, 3468, 315, 28835, 62, 17, 374, 10078, 27895, 11, 2176, 3468, 9759, 614, 279, 1852, 11900, 72, 13, 20205, 389, 279, 3897, 1995, 11, 279, 11811, 614, 11882, 311, 22986, 1447, 32, 8, 28835, 62, 16, 374, 14890, 4152, 311, 1181, 3968, 16, 13, 21, 20, 3039, 5080, 18927, 311, 24065, 624, 33, 8, 28835, 62, 17, 374, 14890, 4152, 311, 1181, 3968, 17, 13, 17, 20, 3039, 5080, 18927, 311, 24065, 624, 34, 8, 28835, 62, 17, 374, 14890, 4152, 311, 1181, 3968, 16, 13, 20, 3039, 5080, 18927, 311, 24065, 624, 35, 8, 28835, 62, 16, 374, 14890, 4152, 311, 1181, 3968, 17, 13, 22, 3039, 5080, 18927, 311, 24065, 13, 151645, 198, 151644, 77091, 198]",,329,450,779,0.0,0.0
21810508-058f-4f75-a844-826ebea17675,7,33,"[151643, 151643, 151643, 151643, 151643, 151643, 151643, 151643, 151643, 151643, 151643, 151643, 151643, 151643, 151643, 151643, 151643, 151643, 151643, 151643, 151643, 151643, 151643, 151643, 151643, 151643, 151643, 151643, 151643, 151643, 151643, 151643, 151643, 151643, 151643, 151643, 151643, 151643, 151643, 151643, 151643, 151643, 151643, 151643, 151643, 151643, 151643, 151643, 151643, 151643, 151643, 151643, 151643, 151643, 151643, 151643, 151643, 151643, 151643, 151643, 151643, 151643, 151643, 151643, 151643, 151643, 151643, 151643, 151643, 151643, 151643, 151643, 151643, 151643, 151643, 151643, 151643, 151643, 151643, 151643, 151643, 151643, 151643, 151643, 151643, 151643, 151643, 151643, 151643, 151643, 151643, 151643, 151643, 151643, 151643, 151643, 151643, 151643, 151643, 151643, 151643, 151643, 151643, 151643, 151643, 151643, 151643, 151643, 151643, 151643, 151643, 151643, 151643, 151643, 151643, 151643, 151643, 151643, 151643, 151643, 151643, 151643, 151643, 151643, 151643, 151643, 151643, 151643, 151643, 151643, 151643, 151643, 151643, 151643, 151643, 151643, 151643, 151643, 151643, 151643, 151643, 151643, 151643, 151643, 151643, 151643, 151643, 151643, 151643, 151643, 151643, 151643, 151643, 151643, 151643, 151643, 151643, 151643, 151643, 151643, 151643, 151643, 151643, 151643, 151643, 151643, 151643, 151643, 151643, 151643, 151643, 151643, 151643, 151643, 151643, 151643, 151643, 151643, 151643, 151643, 151643, 151643, 151643, 151643, 151643, 151643, 151643, 151643, 151643, 151643, 151643, 151643, 151643, 151643, 151643, 151643, 151643, 151643, 151643, 151643, 151643, 151643, 151643, 151643, 151643, 151643, 151643, 151643, 151643, 151643, 151643, 151643, 151643, 151643, 151643, 151643, 151643, 151643, 151643, 151643, 151643, 151643, 151643, 151643, 151643, 151643, 151643, 151643, 151643, 151643, 151643, 151643, 151643, 151643, 151643, 151643, 151643, 151643, 151643, 151643, 151643, 151643, 151643, 151643, 151643, 151643, 151643, 151643, 151643, 151643, 151643, 151643, 151643, 151643, 151643, 151643, 151643, 151643, 151643, 151643, 151643, 151643, 151643, 151643, 151643, 151643, 151643, 151643, 151643, 151643, 151643, 151643, 151643, 151643, 151643, 151643, 151643, 151643, 151643, 151643, 151643, 151643, 151643, 151643, 151643, 151643, 151643, 151643, 151643, 151643, 151643, 151643, 151643, 151643, 151643, 151643, 151643, 151643, 151643, 151643, 151643, 151643, 151643, 151643, 151643, 151643, 151643, 151643, 151643, 151643, 151643, 151643, 151643, 151643, 151643, 151643, 151643, 151643, 151643, 151643, 151643, 151643, 151643, 151643, 151643, 151643, 151643, 151643, 151643, 151643, 151643, 151643, 151643, 151643, 151643, 151643, 151643, 151643, 151643, 151643, 151643, 151643, 151643, 151643, 151643, 151643, 151643, 151643, 151643, 151643, 151643, 151643, 151643, 151643, 151643, 151643, 151643, 151643, 151643, 151643, 151643, 151643, 151643, 151643, 151643, 151643, 151643, 151643, 151643, 151643, 151643, 151643, 151643, 151643, 151643, 151643, 151643, 151643, 151643, 151643, 151643, 151643, 151643, 151643, 151643, 151643, 151643, 151643, 151643, 151643, 151643, 151643, 151643, 151643, 151643, 151643, 151643, 151643, 151643, 151643, 151643, 151643, 151643, 151643, 151643, 151643, 151643, 151643, 151643, 151643, 151643, 151643, 151643, 151643, 151643, 151643, 151643, 151643, 151643, 151643, 151643, 151643, 151643, 151643, 151643, 151643, 151643, 151643, 151643, 151643, 151643, 151643, 151643, 151643, 151643, 151643, 151643, 151643, 151643, 151643, 151643, 151643, 151643, 151643, 151643, 151643, 151643, 151643, 151643, 151643, 151643, 151643, 151643, 151643, 151643, 151643, 151643, 151643, 151643, 151643, 151643, 151643, 151643, 151643, 151643, 151643, 151643, 151643, 151643, 151643, 151643, 151643, 151643, 151643, 151643, 151643, 151643, 151643, 151643, 151643, 151643, 151643, 151643, 151643, 151643, 151643, 151643, 151643, 151643, 151643, 151643, 151643, 151643, 151643, 151643, 151643, 151643, 151643, 151643, 151643, 151643, 151643, 151643, 151643, 151643, 151643, 151643, 151643, 151643, 151643, 151643, 151643, 151643, 151643, 151643, 151643, 151643, 151643, 151643, 151643, 151643, 151643, 151643, 151643, 151643, 151643, 151643, 151643, 151643, 151643, 151643, 151643, 151643, 151643, 151643, 151643, 151643, 151643, 151643, 151643, 151643, 151643, 151643, 151643, 151643, 151643, 151643, 151643, 151643, 151643, 151643, 151643, 151643, 151643, 151643, 151643, 151643, 151643, 151643, 151643, 151643, 151643, 151643, 151643, 151643, 151643, 151643, 151643, 151643, 151643, 151643, 151643, 151643, 151643, 151643, 151643, 151643, 151643, 151643, 151643, 151643, 151643, 151643, 151643, 151643, 151643, 151643, 151643, 151643, 151643, 151643, 151643, 151643, 151643, 151643, 151643, 151643, 151643, 151643, 151643, 151643, 151643, 151643, 151643, 151643, 151643, 151643, 151643, 151643, 151643, 151643, 151643, 151643, 151643, 151643, 151643, 151643, 151643, 151643, 151643, 151643, 151643, 151643, 151643, 151643, 151643, 151643, 151643, 151643, 151643, 151643, 151643, 151643, 151643, 151643, 151643, 151643, 151643, 151643, 151643, 151643, 151643, 151643, 151643, 151643, 151643, 151643, 151643, 151643, 151643, 151643, 151643, 151643, 151643, 151643, 151643, 151643, 151643, 151643, 151643, 151643, 151643, 151643, 151643, 151643, 151643, 151643, 151643, 151643, 151643, 151643, 151643, 151643, 151643, 151643, 151643, 151643, 151643, 151643, 151643, 151643, 151643, 151643, 151643, 151643, 151643, 151643, 151643, 151643, 151643, 151643, 151643, 151643, 151643, 151643, 151643, 151643, 151643, 151643, 151643, 151643, 151643, 151643, 151643, 151643, 151643, 151643, 151643, 151643, 151643, 151643, 151643, 151643, 151643, 151643, 151643, 151643, 151643, 151643, 151643, 151643, 151643, 151643, 151643, 151643, 151643, 151643, 151643, 151643, 151643, 151643, 151643, 151643, 151643, 151643, 151643, 151643, 151643, 151643, 151643, 151643, 151643, 151643, 151643, 151643, 151643, 151643, 151643, 151643, 151643, 151643, 151643, 151643, 151643, 151643, 151643, 151643, 151643, 151643, 151643, 151643, 151643, 151643, 151643, 151643, 151643, 151643, 151643, 151643, 151643, 151643, 151643, 151643, 151643, 151643, 151643, 151643, 151643, 151643, 151643, 151643, 151643, 151643, 151643, 151643, 151643, 151643, 151643, 151643, 151643, 151643, 151643, 151643, 151644, 8948, 198, 2610, 525, 1207, 16948, 11, 3465, 553, 54364, 14817, 13, 1446, 525, 264, 10950, 17847, 13, 151645, 198, 151644, 872, 198, 16141, 279, 2701, 5248, 5754, 3405, 13, 576, 1537, 1555, 315, 697, 2033, 1265, 387, 315, 279, 2701, 3561, 25, 364, 16141, 25, 400, 20756, 4198, 6, 320, 28996, 17194, 8, 1380, 44428, 374, 825, 315, 19360, 35, 13, 21149, 3019, 553, 3019, 1573, 35764, 382, 32, 495, 14274, 388, 525, 44971, 264, 11580, 448, 264, 10578, 315, 220, 16, 9237, 10578, 304, 264, 26931, 26507, 11, 448, 264, 24065, 5421, 5733, 315, 220, 15, 13, 17, 11, 2163, 264, 6774, 429, 702, 264, 10578, 220, 16, 13, 20, 3039, 429, 315, 279, 8059, 13, 1096, 11580, 702, 458, 64591, 4168, 315, 220, 18, 2849, 13, 3555, 374, 279, 7192, 64591, 4168, 315, 264, 2086, 11580, 11, 448, 264, 10578, 315, 220, 17, 13, 20, 3039, 429, 315, 9237, 11, 304, 279, 1852, 1849, 429, 686, 30224, 2176, 24065, 323, 73826, 367, 4357, 30, 62197, 429, 279, 2086, 11580, 1083, 702, 264, 26931, 26507, 323, 13248, 279, 1852, 64591, 11031, 438, 279, 8597, 9733, 1356, 5853, 11580, 382, 32, 8, 3968, 220, 18, 18, 13, 20, 198, 33, 8, 3968, 220, 16, 17, 13, 20, 198, 34, 8, 3968, 220, 18, 22, 13, 20, 198, 35, 8, 3968, 220, 22, 13, 20, 151645, 198, 151644, 77091, 198]",,231,681,912,0.0,0.0
e8b44629-a2a3-40f5-a32d-6db2349ff991,7,34,"[151643, 151643, 151643, 151643, 151643, 151643, 151643, 151643, 151643, 151643, 151643, 151643, 151643, 151643, 151643, 151643, 151643, 151643, 151643, 151643, 151643, 151643, 151643, 151643, 151643, 151643, 151643, 151643, 151643, 151643, 151643, 151643, 151643, 151643, 151643, 151643, 151643, 151643, 151643, 151643, 151643, 151643, 151643, 151643, 151643, 151643, 151643, 151643, 151643, 151643, 151643, 151643, 151643, 151643, 151643, 151643, 151643, 151643, 151643, 151643, 151643, 151643, 151643, 151643, 151643, 151643, 151643, 151643, 151643, 151643, 151643, 151643, 151643, 151643, 151643, 151643, 151643, 151643, 151643, 151643, 151643, 151643, 151643, 151643, 151643, 151643, 151643, 151643, 151643, 151643, 151643, 151643, 151643, 151643, 151643, 151643, 151643, 151643, 151643, 151643, 151643, 151643, 151643, 151643, 151643, 151643, 151643, 151643, 151643, 151643, 151643, 151643, 151643, 151643, 151643, 151643, 151643, 151643, 151643, 151643, 151643, 151643, 151643, 151643, 151643, 151643, 151643, 151643, 151643, 151643, 151643, 151643, 151643, 151643, 151643, 151643, 151643, 151643, 151643, 151643, 151643, 151643, 151643, 151643, 151643, 151643, 151643, 151643, 151643, 151643, 151643, 151643, 151643, 151643, 151643, 151643, 151643, 151643, 151643, 151643, 151643, 151643, 151643, 151643, 151643, 151643, 151643, 151643, 151643, 151643, 151643, 151643, 151643, 151643, 151643, 151643, 151643, 151643, 151643, 151643, 151643, 151643, 151643, 151643, 151643, 151643, 151643, 151643, 151643, 151643, 151643, 151643, 151643, 151643, 151643, 151643, 151643, 151643, 151643, 151643, 151643, 151643, 151643, 151643, 151643, 151643, 151643, 151643, 151643, 151643, 151643, 151643, 151643, 151643, 151643, 151643, 151643, 151643, 151643, 151643, 151643, 151643, 151643, 151643, 151643, 151643, 151643, 151643, 151643, 151643, 151643, 151643, 151643, 151643, 151643, 151643, 151643, 151643, 151643, 151643, 151643, 151643, 151643, 151643, 151643, 151643, 151643, 151643, 151643, 151643, 151643, 151643, 151643, 151643, 151643, 151643, 151643, 151643, 151643, 151643, 151643, 151643, 151643, 151643, 151643, 151643, 151643, 151643, 151643, 151643, 151643, 151643, 151643, 151643, 151643, 151643, 151643, 151643, 151643, 151643, 151643, 151643, 151643, 151643, 151643, 151643, 151643, 151643, 151643, 151643, 151643, 151643, 151643, 151643, 151643, 151643, 151643, 151643, 151643, 151643, 151643, 151643, 151643, 151643, 151643, 151643, 151643, 151643, 151643, 151643, 151643, 151643, 151643, 151643, 151643, 151643, 151643, 151643, 151643, 151643, 151643, 151643, 151643, 151643, 151643, 151643, 151643, 151643, 151643, 151643, 151643, 151643, 151643, 151643, 151643, 151643, 151643, 151643, 151643, 151643, 151643, 151643, 151643, 151643, 151643, 151643, 151643, 151643, 151643, 151643, 151643, 151643, 151643, 151643, 151643, 151643, 151643, 151643, 151643, 151643, 151643, 151643, 151643, 151643, 151643, 151643, 151643, 151643, 151643, 151643, 151643, 151643, 151643, 151643, 151643, 151643, 151643, 151643, 151643, 151643, 151643, 151643, 151643, 151643, 151643, 151643, 151643, 151643, 151643, 151643, 151643, 151643, 151643, 151643, 151643, 151643, 151643, 151643, 151643, 151643, 151643, 151643, 151643, 151643, 151643, 151643, 151643, 151643, 151643, 151643, 151643, 151643, 151643, 151643, 151643, 151643, 151643, 151643, 151643, 151643, 151643, 151643, 151643, 151643, 151643, 151643, 151643, 151643, 151643, 151643, 151643, 151643, 151643, 151643, 151643, 151643, 151643, 151643, 151643, 151643, 151643, 151643, 151643, 151643, 151643, 151643, 151643, 151643, 151643, 151643, 151643, 151643, 151643, 151643, 151643, 151643, 151643, 151643, 151643, 151643, 151643, 151643, 151643, 151643, 151643, 151643, 151643, 151643, 151643, 151643, 151643, 151643, 151643, 151643, 151643, 151643, 151643, 151643, 151643, 151643, 151643, 151643, 151643, 151643, 151643, 151643, 151643, 151643, 151643, 151643, 151643, 151643, 151643, 151643, 151643, 151643, 151643, 151643, 151643, 151643, 151643, 151643, 151643, 151643, 151643, 151643, 151643, 151643, 151643, 151643, 151643, 151643, 151643, 151643, 151643, 151643, 151643, 151643, 151643, 151643, 151643, 151643, 151643, 151643, 151643, 151643, 151643, 151643, 151643, 151643, 151643, 151643, 151643, 151643, 151643, 151643, 151643, 151643, 151643, 151643, 151643, 151643, 151643, 151643, 151643, 151643, 151643, 151643, 151643, 151643, 151643, 151643, 151643, 151643, 151643, 151643, 151643, 151643, 151643, 151643, 151643, 151643, 151643, 151643, 151643, 151643, 151643, 151643, 151643, 151643, 151643, 151643, 151643, 151643, 151643, 151643, 151643, 151643, 151643, 151643, 151643, 151643, 151643, 151643, 151643, 151643, 151643, 151643, 151643, 151643, 151643, 151643, 151643, 151643, 151643, 151643, 151643, 151643, 151643, 151643, 151643, 151643, 151643, 151643, 151643, 151643, 151643, 151643, 151643, 151643, 151643, 151643, 151643, 151643, 151643, 151643, 151643, 151643, 151643, 151643, 151643, 151643, 151643, 151643, 151643, 151643, 151643, 151643, 151643, 151643, 151643, 151643, 151643, 151643, 151643, 151643, 151643, 151643, 151643, 151643, 151643, 151643, 151643, 151643, 151643, 151643, 151643, 151643, 151643, 151643, 151643, 151643, 151643, 151643, 151643, 151643, 151643, 151643, 151643, 151643, 151643, 151643, 151643, 151643, 151643, 151643, 151643, 151643, 151643, 151643, 151643, 151643, 151643, 151643, 151643, 151643, 151643, 151643, 151643, 151643, 151643, 151643, 151643, 151643, 151643, 151643, 151643, 151643, 151643, 151643, 151643, 151643, 151643, 151643, 151643, 151643, 151643, 151643, 151643, 151643, 151643, 151643, 151643, 151643, 151643, 151643, 151643, 151643, 151643, 151643, 151643, 151643, 151643, 151643, 151643, 151643, 151643, 151643, 151643, 151643, 151643, 151643, 151643, 151643, 151643, 151643, 151643, 151643, 151643, 151643, 151643, 151643, 151643, 151643, 151643, 151643, 151643, 151643, 151643, 151643, 151643, 151643, 151643, 151643, 151643, 151643, 151643, 151643, 151643, 151643, 151643, 151643, 151643, 151643, 151643, 151643, 151643, 151643, 151643, 151643, 151643, 151643, 151643, 151643, 151643, 151643, 151643, 151643, 151643, 151643, 151643, 151643, 151643, 151643, 151643, 151643, 151644, 8948, 198, 2610, 525, 1207, 16948, 11, 3465, 553, 54364, 14817, 13, 1446, 525, 264, 10950, 17847, 13, 151645, 198, 151644, 872, 198, 16141, 279, 2701, 5248, 5754, 3405, 13, 576, 1537, 1555, 315, 697, 2033, 1265, 387, 315, 279, 2701, 3561, 25, 364, 16141, 25, 400, 20756, 4198, 6, 320, 28996, 17194, 8, 1380, 44428, 374, 825, 315, 19360, 35, 13, 21149, 3019, 553, 3019, 1573, 35764, 382, 32, 5458, 10660, 458, 13621, 1786, 4212, 88, 15905, 12720, 315, 220, 18, 1448, 41872, 3288, 81, 1080, 89973, 448, 23628, 362, 11, 279, 1590, 1985, 315, 279, 12720, 374, 220, 16, 8013, 66, 3337, 385, 17308, 3923, 12487, 336, 41872, 7287, 18, 1448, 41872, 3288, 81, 1080, 89973, 13, 8427, 279, 14452, 312, 8092, 320, 32, 8, 323, 50383, 320, 33, 8, 369, 279, 12720, 624, 18, 1448, 41872, 3288, 81, 1080, 89973, 488, 362, 320, 33, 11, 26070, 11, 68896, 8, 69726, 220, 16, 8013, 66, 3337, 385, 17308, 3923, 12487, 336, 41872, 7287, 18, 1448, 41872, 3288, 81, 1080, 89973, 271, 32, 8, 362, 284, 33449, 66, 3337, 385, 17308, 2145, 11, 425, 284, 25076, 46761, 198, 33, 8, 362, 284, 33449, 66, 3337, 385, 17308, 2145, 11, 425, 284, 6381, 5298, 13621, 198, 34, 8, 362, 284, 43348, 385, 17308, 276, 757, 277, 13313, 85736, 11, 425, 284, 25076, 46761, 198, 35, 8, 362, 284, 43348, 385, 17308, 276, 757, 277, 13313, 85736, 11, 425, 284, 6381, 5298, 13621, 151645, 198, 151644, 77091, 198]",,248,329,577,1.0,1.0
c986c440-5c5f-4bbf-9e53-f16f8c2b47f9,7,35,"[151643, 151643, 151643, 151643, 151643, 151643, 151643, 151643, 151643, 151643, 151643, 151643, 151643, 151643, 151643, 151643, 151643, 151643, 151643, 151643, 151643, 151643, 151643, 151643, 151643, 151643, 151643, 151643, 151643, 151643, 151643, 151643, 151643, 151643, 151643, 151643, 151643, 151643, 151643, 151643, 151643, 151643, 151643, 151643, 151643, 151643, 151643, 151643, 151643, 151643, 151643, 151643, 151643, 151643, 151643, 151643, 151643, 151643, 151643, 151643, 151643, 151643, 151643, 151643, 151643, 151643, 151643, 151643, 151643, 151643, 151643, 151643, 151643, 151643, 151643, 151643, 151643, 151643, 151643, 151643, 151643, 151643, 151643, 151643, 151643, 151643, 151643, 151643, 151643, 151643, 151643, 151643, 151643, 151643, 151643, 151643, 151643, 151643, 151643, 151643, 151643, 151643, 151643, 151643, 151643, 151643, 151643, 151643, 151643, 151643, 151643, 151643, 151643, 151643, 151643, 151643, 151643, 151643, 151643, 151643, 151643, 151643, 151643, 151643, 151643, 151643, 151643, 151643, 151643, 151643, 151643, 151643, 151643, 151643, 151643, 151643, 151643, 151643, 151643, 151643, 151643, 151643, 151643, 151643, 151643, 151643, 151643, 151643, 151643, 151643, 151643, 151643, 151643, 151643, 151643, 151643, 151643, 151643, 151643, 151643, 151643, 151643, 151643, 151643, 151643, 151643, 151643, 151643, 151643, 151643, 151643, 151643, 151643, 151643, 151643, 151643, 151643, 151643, 151643, 151643, 151643, 151643, 151643, 151643, 151643, 151643, 151643, 151643, 151643, 151643, 151643, 151643, 151643, 151643, 151643, 151643, 151643, 151643, 151643, 151643, 151643, 151643, 151643, 151643, 151643, 151643, 151643, 151643, 151643, 151643, 151643, 151643, 151643, 151643, 151643, 151643, 151643, 151643, 151643, 151643, 151643, 151643, 151643, 151643, 151643, 151643, 151643, 151643, 151643, 151643, 151643, 151643, 151643, 151643, 151643, 151643, 151643, 151643, 151643, 151643, 151643, 151643, 151643, 151643, 151643, 151643, 151643, 151643, 151643, 151643, 151643, 151643, 151643, 151643, 151643, 151643, 151643, 151643, 151643, 151643, 151643, 151643, 151643, 151643, 151643, 151643, 151643, 151643, 151643, 151643, 151643, 151643, 151643, 151643, 151643, 151643, 151643, 151643, 151643, 151643, 151643, 151643, 151643, 151643, 151643, 151643, 151643, 151643, 151643, 151643, 151643, 151643, 151643, 151643, 151643, 151643, 151643, 151643, 151643, 151643, 151643, 151643, 151643, 151643, 151643, 151643, 151643, 151643, 151643, 151643, 151643, 151643, 151643, 151643, 151643, 151643, 151643, 151643, 151643, 151643, 151643, 151643, 151643, 151643, 151643, 151643, 151643, 151643, 151643, 151643, 151643, 151643, 151643, 151643, 151643, 151643, 151643, 151643, 151643, 151643, 151643, 151643, 151643, 151643, 151643, 151643, 151643, 151643, 151643, 151643, 151643, 151643, 151643, 151643, 151643, 151643, 151643, 151643, 151643, 151643, 151643, 151643, 151643, 151643, 151643, 151643, 151643, 151643, 151643, 151643, 151643, 151643, 151643, 151643, 151643, 151643, 151643, 151643, 151643, 151643, 151643, 151643, 151643, 151643, 151643, 151643, 151643, 151643, 151643, 151643, 151643, 151643, 151643, 151643, 151643, 151643, 151643, 151643, 151643, 151643, 151643, 151643, 151643, 151643, 151643, 151643, 151643, 151643, 151643, 151643, 151643, 151643, 151643, 151643, 151643, 151643, 151643, 151643, 151643, 151643, 151643, 151643, 151643, 151643, 151643, 151643, 151643, 151643, 151643, 151643, 151643, 151643, 151643, 151643, 151643, 151643, 151643, 151643, 151643, 151643, 151643, 151643, 151643, 151643, 151643, 151643, 151643, 151643, 151643, 151643, 151643, 151643, 151643, 151643, 151643, 151643, 151643, 151643, 151643, 151643, 151643, 151643, 151643, 151643, 151643, 151643, 151643, 151643, 151643, 151643, 151643, 151643, 151643, 151643, 151643, 151643, 151643, 151643, 151643, 151643, 151643, 151643, 151643, 151643, 151643, 151643, 151643, 151643, 151643, 151643, 151643, 151643, 151643, 151643, 151643, 151643, 151643, 151643, 151643, 151643, 151643, 151643, 151643, 151643, 151643, 151643, 151643, 151643, 151643, 151643, 151643, 151643, 151643, 151643, 151643, 151643, 151643, 151643, 151643, 151643, 151643, 151643, 151643, 151643, 151643, 151643, 151643, 151643, 151643, 151643, 151643, 151643, 151643, 151643, 151643, 151643, 151643, 151643, 151643, 151643, 151643, 151643, 151643, 151643, 151643, 151643, 151643, 151643, 151643, 151643, 151643, 151643, 151643, 151643, 151643, 151643, 151643, 151643, 151643, 151643, 151643, 151643, 151643, 151643, 151643, 151643, 151643, 151643, 151643, 151643, 151643, 151643, 151643, 151643, 151643, 151643, 151643, 151643, 151643, 151643, 151643, 151643, 151643, 151643, 151643, 151643, 151643, 151643, 151643, 151643, 151643, 151643, 151643, 151643, 151643, 151643, 151643, 151643, 151643, 151643, 151643, 151643, 151643, 151643, 151643, 151643, 151643, 151643, 151643, 151643, 151643, 151643, 151643, 151643, 151643, 151643, 151643, 151643, 151643, 151643, 151643, 151643, 151643, 151643, 151643, 151643, 151643, 151643, 151643, 151643, 151643, 151643, 151643, 151643, 151643, 151643, 151643, 151643, 151643, 151643, 151643, 151643, 151643, 151643, 151643, 151643, 151643, 151643, 151643, 151643, 151643, 151643, 151643, 151643, 151643, 151643, 151643, 151643, 151643, 151643, 151643, 151643, 151643, 151643, 151643, 151643, 151643, 151643, 151643, 151643, 151643, 151643, 151643, 151643, 151643, 151643, 151643, 151643, 151643, 151643, 151643, 151643, 151643, 151643, 151643, 151643, 151643, 151643, 151643, 151643, 151643, 151643, 151643, 151643, 151643, 151643, 151643, 151643, 151643, 151643, 151643, 151643, 151643, 151643, 151643, 151643, 151643, 151643, 151643, 151643, 151643, 151643, 151643, 151643, 151643, 151643, 151643, 151643, 151643, 151643, 151643, 151643, 151643, 151643, 151643, 151643, 151643, 151643, 151643, 151643, 151643, 151643, 151643, 151643, 151643, 151643, 151643, 151643, 151643, 151643, 151643, 151643, 151644, 8948, 198, 2610, 525, 1207, 16948, 11, 3465, 553, 54364, 14817, 13, 1446, 525, 264, 10950, 17847, 13, 151645, 198, 151644, 872, 198, 16141, 279, 2701, 5248, 5754, 3405, 13, 576, 1537, 1555, 315, 697, 2033, 1265, 387, 315, 279, 2701, 3561, 25, 364, 16141, 25, 400, 20756, 4198, 6, 320, 28996, 17194, 8, 1380, 44428, 374, 825, 315, 19360, 35, 13, 21149, 3019, 553, 3019, 1573, 35764, 382, 18, 11, 18, 11, 21, 10188, 318, 41872, 383, 51591, 12, 16, 11, 20, 1737, 3591, 12, 19, 18589, 374, 11758, 448, 220, 16, 13578, 315, 8823, 11582, 9566, 3296, 7964, 12738, 292, 13621, 13, 9043, 2155, 3871, 525, 14122, 11, 304, 13187, 264, 220, 16, 25, 16, 11341, 382, 641, 264, 8651, 26182, 11, 56075, 24705, 410, 2356, 374, 11758, 448, 23285, 8972, 8, 3127, 577, 13, 458, 13623, 315, 279, 12942, 6291, 374, 13970, 3694, 311, 279, 1985, 20980, 315, 279, 1156, 12720, 13, 3988, 825, 1985, 429, 686, 387, 14122, 553, 419, 12720, 1447, 32, 8, 220, 17, 11, 18, 11, 19, 11, 20, 11, 20, 2268, 306, 309, 41872, 383, 417, 12, 21, 12, 1952, 12, 17, 11, 19, 1737, 24903, 198, 33, 8, 220, 19, 11, 19, 11, 20, 11, 22, 11, 22, 2268, 306, 309, 769, 88, 385, 302, 2145, 12, 18, 11, 20, 1737, 24903, 198, 34, 8, 220, 20, 2832, 67007, 4130, 12, 18, 11, 18, 11, 21, 11, 21, 2385, 295, 2396, 41872, 383, 417, 12, 16, 20767, 12, 19, 18589, 198, 35, 8, 220, 21, 2832, 67007, 4130, 12, 17, 11, 17, 11, 20, 11, 20, 2385, 295, 2396, 769, 88, 385, 302, 276, 12, 19, 18589, 151645, 198, 151644, 77091, 198]",,282,529,811,0.0,0.0
6fba8557-db5c-437b-94de-746a09ed1a67,7,36,"[151643, 151643, 151643, 151643, 151643, 151643, 151643, 151643, 151643, 151643, 151643, 151643, 151643, 151643, 151643, 151643, 151643, 151643, 151643, 151643, 151643, 151643, 151643, 151643, 151643, 151643, 151643, 151643, 151643, 151643, 151643, 151643, 151643, 151643, 151643, 151643, 151643, 151643, 151643, 151643, 151643, 151643, 151643, 151643, 151643, 151643, 151643, 151643, 151643, 151643, 151643, 151643, 151643, 151643, 151643, 151643, 151643, 151643, 151643, 151643, 151643, 151643, 151643, 151643, 151643, 151643, 151643, 151643, 151643, 151643, 151643, 151643, 151643, 151643, 151643, 151643, 151643, 151643, 151643, 151643, 151643, 151643, 151643, 151643, 151643, 151643, 151643, 151643, 151643, 151643, 151643, 151643, 151643, 151643, 151643, 151643, 151643, 151643, 151643, 151643, 151643, 151643, 151643, 151643, 151643, 151643, 151643, 151643, 151643, 151643, 151643, 151643, 151643, 151643, 151643, 151643, 151643, 151643, 151643, 151643, 151643, 151643, 151643, 151643, 151643, 151643, 151643, 151643, 151643, 151643, 151643, 151643, 151643, 151643, 151643, 151643, 151643, 151643, 151643, 151643, 151643, 151643, 151643, 151643, 151643, 151643, 151643, 151643, 151643, 151643, 151643, 151643, 151643, 151643, 151643, 151643, 151643, 151643, 151643, 151643, 151643, 151643, 151643, 151643, 151643, 151643, 151643, 151643, 151643, 151643, 151643, 151643, 151643, 151643, 151643, 151643, 151643, 151643, 151643, 151643, 151643, 151643, 151643, 151643, 151643, 151643, 151643, 151643, 151643, 151643, 151643, 151643, 151643, 151643, 151643, 151643, 151643, 151643, 151643, 151643, 151643, 151643, 151643, 151643, 151643, 151643, 151643, 151643, 151643, 151643, 151643, 151643, 151643, 151643, 151643, 151643, 151643, 151643, 151643, 151643, 151643, 151643, 151643, 151643, 151643, 151643, 151643, 151643, 151643, 151643, 151643, 151643, 151643, 151643, 151643, 151643, 151643, 151643, 151643, 151643, 151643, 151643, 151643, 151643, 151643, 151643, 151643, 151643, 151643, 151643, 151643, 151643, 151643, 151643, 151643, 151643, 151643, 151643, 151643, 151643, 151643, 151643, 151643, 151643, 151643, 151643, 151643, 151643, 151643, 151643, 151643, 151643, 151643, 151643, 151643, 151643, 151643, 151643, 151643, 151643, 151643, 151643, 151643, 151643, 151643, 151643, 151643, 151643, 151643, 151643, 151643, 151643, 151643, 151643, 151643, 151643, 151643, 151643, 151643, 151643, 151643, 151643, 151643, 151643, 151643, 151643, 151643, 151643, 151643, 151643, 151643, 151643, 151643, 151643, 151643, 151643, 151643, 151643, 151643, 151643, 151643, 151643, 151643, 151643, 151643, 151643, 151643, 151643, 151643, 151643, 151643, 151643, 151643, 151643, 151643, 151643, 151643, 151643, 151643, 151643, 151643, 151643, 151643, 151643, 151643, 151643, 151643, 151643, 151643, 151643, 151643, 151643, 151643, 151643, 151643, 151643, 151643, 151643, 151643, 151643, 151643, 151643, 151643, 151643, 151643, 151643, 151643, 151643, 151643, 151643, 151643, 151643, 151643, 151643, 151643, 151643, 151643, 151643, 151643, 151643, 151643, 151643, 151643, 151643, 151643, 151643, 151643, 151643, 151643, 151643, 151643, 151643, 151643, 151643, 151643, 151643, 151643, 151643, 151643, 151643, 151643, 151643, 151643, 151643, 151643, 151643, 151643, 151643, 151643, 151643, 151643, 151643, 151643, 151643, 151643, 151643, 151643, 151643, 151643, 151643, 151643, 151643, 151643, 151643, 151643, 151643, 151643, 151643, 151643, 151643, 151643, 151643, 151643, 151643, 151643, 151643, 151643, 151643, 151643, 151643, 151643, 151643, 151643, 151643, 151643, 151643, 151643, 151643, 151643, 151643, 151643, 151643, 151643, 151643, 151643, 151643, 151643, 151643, 151643, 151643, 151643, 151643, 151643, 151643, 151643, 151643, 151643, 151643, 151643, 151643, 151643, 151643, 151643, 151643, 151643, 151643, 151643, 151643, 151643, 151643, 151643, 151643, 151643, 151643, 151643, 151643, 151643, 151643, 151643, 151643, 151643, 151643, 151643, 151643, 151643, 151643, 151643, 151643, 151643, 151643, 151643, 151643, 151643, 151643, 151643, 151643, 151643, 151643, 151643, 151643, 151643, 151643, 151643, 151643, 151643, 151643, 151643, 151643, 151643, 151643, 151643, 151643, 151643, 151643, 151643, 151643, 151643, 151643, 151643, 151643, 151643, 151643, 151643, 151643, 151643, 151643, 151643, 151643, 151643, 151643, 151643, 151643, 151643, 151643, 151643, 151643, 151643, 151643, 151643, 151643, 151643, 151643, 151643, 151643, 151643, 151643, 151643, 151643, 151643, 151643, 151643, 151643, 151643, 151643, 151643, 151643, 151643, 151643, 151643, 151643, 151643, 151643, 151643, 151643, 151643, 151643, 151643, 151643, 151643, 151643, 151643, 151643, 151643, 151643, 151643, 151643, 151643, 151643, 151643, 151643, 151643, 151643, 151643, 151643, 151643, 151643, 151643, 151643, 151643, 151643, 151643, 151643, 151643, 151643, 151643, 151643, 151643, 151643, 151643, 151643, 151643, 151643, 151643, 151643, 151643, 151643, 151643, 151643, 151643, 151643, 151643, 151643, 151643, 151643, 151643, 151643, 151643, 151643, 151643, 151643, 151643, 151643, 151643, 151643, 151643, 151643, 151643, 151643, 151643, 151643, 151643, 151643, 151643, 151643, 151643, 151643, 151643, 151643, 151643, 151643, 151643, 151643, 151643, 151643, 151643, 151643, 151643, 151643, 151643, 151643, 151643, 151643, 151643, 151643, 151643, 151643, 151643, 151643, 151643, 151643, 151643, 151643, 151643, 151643, 151643, 151643, 151643, 151643, 151643, 151643, 151643, 151643, 151643, 151643, 151643, 151643, 151643, 151643, 151643, 151643, 151643, 151643, 151643, 151643, 151643, 151643, 151643, 151643, 151643, 151643, 151643, 151643, 151643, 151643, 151643, 151643, 151643, 151643, 151643, 151643, 151643, 151643, 151643, 151643, 151643, 151643, 151643, 151643, 151643, 151643, 151643, 151643, 151643, 151643, 151643, 151643, 151643, 151643, 151643, 151643, 151643, 151643, 151643, 151643, 151643, 151643, 151643, 151643, 151643, 151643, 151643, 151643, 151643, 151643, 151643, 151643, 151643, 151643, 151643, 151643, 151643, 151643, 151643, 151643, 151643, 151643, 151643, 151643, 151643, 151643, 151643, 151643, 151643, 151643, 151643, 151643, 151643, 151643, 151643, 151643, 151643, 151643, 151643, 151643, 151643, 151643, 151643, 151643, 151643, 151643, 151643, 151643, 151643, 151643, 151643, 151643, 151643, 151643, 151643, 151643, 151643, 151643, 151643, 151643, 151643, 151643, 151643, 151643, 151643, 151643, 151644, 8948, 198, 2610, 525, 1207, 16948, 11, 3465, 553, 54364, 14817, 13, 1446, 525, 264, 10950, 17847, 13, 151645, 198, 151644, 872, 198, 16141, 279, 2701, 5248, 5754, 3405, 13, 576, 1537, 1555, 315, 697, 2033, 1265, 387, 315, 279, 2701, 3561, 25, 364, 16141, 25, 400, 20756, 4198, 6, 320, 28996, 17194, 8, 1380, 44428, 374, 825, 315, 19360, 35, 13, 21149, 3019, 553, 3019, 1573, 35764, 382, 32, 4185, 56204, 1865, 304, 1657, 9350, 11249, 28117, 315, 1045, 16230, 320, 1958, 3110, 458, 4045, 651, 68, 585, 16230, 8, 374, 311, 22477, 429, 30384, 2382, 304, 264, 61507, 35692, 304, 279, 1852, 1616, 438, 1910, 30384, 2382, 13, 15920, 315, 279, 2701, 3040, 31846, 52158, 33508, 419, 1591, 6664, 17217, 3014, 56204, 1939, 16, 13, 576, 16230, 1482, 1172, 83161, 448, 3842, 30384, 2382, 624, 17, 13, 576, 61507, 374, 17821, 10747, 504, 279, 4091, 30384, 263, 624, 18, 13, 576, 922, 7193, 5306, 311, 279, 4091, 30384, 263, 525, 2477, 47612, 19488, 4532, 624, 19, 13, 576, 16230, 33455, 438, 421, 279, 4091, 30384, 263, 11449, 902, 10970, 8437, 382, 32, 8, 220, 17, 11, 18, 11, 19, 198, 33, 8, 220, 16, 11, 17, 11, 18, 198, 34, 8, 220, 16, 11, 17, 11, 19, 198, 35, 8, 220, 16, 11, 18, 11, 19, 151645, 198, 151644, 77091, 198]",,224,279,503,1.0,1.0
7b794707-b9a5-4aa5-87d0-1b33026119f8,7,37,"[151643, 151643, 151643, 151643, 151643, 151643, 151643, 151643, 151643, 151643, 151643, 151643, 151643, 151643, 151643, 151643, 151643, 151643, 151643, 151643, 151643, 151643, 151643, 151643, 151643, 151643, 151643, 151643, 151643, 151643, 151643, 151643, 151643, 151643, 151643, 151643, 151643, 151643, 151643, 151643, 151643, 151643, 151643, 151643, 151643, 151643, 151643, 151643, 151643, 151643, 151643, 151643, 151643, 151643, 151643, 151643, 151643, 151643, 151643, 151643, 151643, 151643, 151643, 151643, 151643, 151643, 151643, 151643, 151643, 151643, 151643, 151643, 151643, 151643, 151643, 151643, 151643, 151643, 151643, 151643, 151643, 151643, 151643, 151643, 151643, 151643, 151643, 151643, 151643, 151643, 151643, 151643, 151643, 151643, 151643, 151643, 151643, 151643, 151643, 151643, 151643, 151643, 151643, 151643, 151643, 151643, 151643, 151643, 151643, 151643, 151643, 151643, 151643, 151643, 151643, 151643, 151643, 151643, 151643, 151643, 151643, 151643, 151643, 151643, 151643, 151643, 151643, 151643, 151643, 151643, 151643, 151643, 151643, 151643, 151643, 151643, 151643, 151643, 151643, 151643, 151643, 151643, 151643, 151643, 151643, 151643, 151643, 151643, 151643, 151643, 151643, 151643, 151643, 151643, 151643, 151643, 151643, 151643, 151643, 151643, 151643, 151643, 151643, 151643, 151643, 151643, 151643, 151643, 151643, 151643, 151643, 151643, 151643, 151643, 151643, 151643, 151643, 151643, 151643, 151643, 151643, 151643, 151643, 151643, 151643, 151643, 151643, 151643, 151643, 151643, 151643, 151643, 151643, 151643, 151643, 151643, 151643, 151643, 151643, 151643, 151643, 151643, 151643, 151643, 151643, 151643, 151643, 151643, 151643, 151643, 151643, 151643, 151643, 151643, 151643, 151643, 151643, 151643, 151643, 151643, 151643, 151643, 151643, 151643, 151643, 151643, 151643, 151643, 151643, 151643, 151643, 151643, 151643, 151643, 151643, 151643, 151643, 151643, 151643, 151643, 151643, 151643, 151643, 151643, 151643, 151643, 151643, 151643, 151643, 151643, 151643, 151643, 151643, 151643, 151643, 151643, 151643, 151643, 151643, 151643, 151643, 151643, 151643, 151643, 151643, 151643, 151643, 151643, 151643, 151643, 151643, 151643, 151643, 151643, 151643, 151643, 151643, 151643, 151643, 151643, 151643, 151643, 151643, 151643, 151643, 151643, 151643, 151643, 151643, 151643, 151643, 151643, 151643, 151643, 151643, 151643, 151643, 151643, 151643, 151643, 151643, 151643, 151643, 151643, 151643, 151643, 151643, 151643, 151643, 151643, 151643, 151643, 151643, 151643, 151643, 151643, 151643, 151643, 151643, 151643, 151643, 151643, 151643, 151643, 151643, 151643, 151643, 151643, 151643, 151643, 151643, 151643, 151643, 151643, 151643, 151643, 151643, 151643, 151643, 151643, 151643, 151643, 151643, 151643, 151643, 151643, 151643, 151643, 151643, 151643, 151643, 151643, 151643, 151643, 151643, 151643, 151643, 151643, 151643, 151643, 151643, 151643, 151643, 151643, 151643, 151643, 151643, 151643, 151643, 151643, 151643, 151643, 151643, 151643, 151643, 151643, 151643, 151643, 151643, 151643, 151643, 151643, 151643, 151643, 151643, 151643, 151643, 151643, 151643, 151643, 151643, 151643, 151643, 151643, 151643, 151643, 151643, 151643, 151643, 151643, 151643, 151643, 151643, 151643, 151643, 151643, 151643, 151643, 151643, 151643, 151643, 151643, 151643, 151643, 151643, 151643, 151643, 151643, 151643, 151643, 151643, 151643, 151643, 151643, 151643, 151643, 151643, 151643, 151643, 151643, 151643, 151643, 151643, 151643, 151643, 151643, 151643, 151643, 151643, 151643, 151643, 151643, 151643, 151643, 151643, 151643, 151643, 151643, 151643, 151643, 151643, 151643, 151643, 151643, 151643, 151643, 151643, 151643, 151643, 151643, 151643, 151643, 151643, 151643, 151643, 151643, 151643, 151643, 151643, 151643, 151643, 151643, 151643, 151643, 151643, 151643, 151643, 151643, 151643, 151643, 151643, 151643, 151643, 151643, 151643, 151643, 151643, 151643, 151643, 151643, 151643, 151643, 151643, 151643, 151643, 151643, 151643, 151643, 151643, 151643, 151643, 151643, 151643, 151643, 151643, 151643, 151643, 151643, 151643, 151643, 151643, 151643, 151643, 151643, 151643, 151643, 151643, 151643, 151643, 151643, 151643, 151643, 151643, 151643, 151643, 151643, 151643, 151643, 151643, 151643, 151643, 151643, 151643, 151643, 151643, 151643, 151643, 151643, 151643, 151643, 151643, 151643, 151643, 151643, 151643, 151643, 151643, 151643, 151643, 151643, 151643, 151643, 151643, 151643, 151643, 151643, 151643, 151643, 151643, 151643, 151643, 151643, 151643, 151643, 151643, 151643, 151643, 151643, 151643, 151643, 151643, 151643, 151643, 151643, 151643, 151643, 151643, 151643, 151643, 151643, 151643, 151643, 151643, 151643, 151643, 151643, 151643, 151643, 151643, 151643, 151643, 151643, 151643, 151643, 151643, 151643, 151643, 151643, 151643, 151643, 151643, 151643, 151643, 151643, 151643, 151643, 151643, 151643, 151643, 151643, 151643, 151643, 151643, 151643, 151643, 151643, 151643, 151643, 151643, 151643, 151643, 151643, 151643, 151643, 151643, 151643, 151643, 151643, 151643, 151643, 151643, 151643, 151643, 151643, 151643, 151643, 151643, 151643, 151643, 151643, 151643, 151643, 151643, 151643, 151643, 151643, 151643, 151643, 151643, 151643, 151643, 151643, 151643, 151643, 151643, 151643, 151643, 151643, 151643, 151643, 151643, 151643, 151643, 151643, 151643, 151643, 151643, 151643, 151643, 151643, 151643, 151643, 151643, 151643, 151643, 151643, 151643, 151643, 151643, 151643, 151643, 151643, 151643, 151643, 151643, 151643, 151643, 151643, 151643, 151643, 151643, 151643, 151643, 151643, 151643, 151643, 151643, 151643, 151643, 151643, 151643, 151643, 151643, 151643, 151643, 151643, 151643, 151643, 151643, 151643, 151643, 151643, 151643, 151643, 151643, 151643, 151643, 151643, 151643, 151643, 151643, 151643, 151643, 151643, 151643, 151643, 151643, 151643, 151643, 151643, 151643, 151643, 151643, 151643, 151643, 151643, 151643, 151643, 151643, 151643, 151643, 151643, 151643, 151643, 151643, 151643, 151643, 151643, 151643, 151643, 151643, 151643, 151643, 151643, 151643, 151643, 151643, 151643, 151643, 151643, 151643, 151643, 151643, 151643, 151643, 151643, 151643, 151643, 151643, 151643, 151643, 151643, 151643, 151643, 151643, 151643, 151643, 151643, 151643, 151643, 151643, 151643, 151643, 151643, 151643, 151643, 151643, 151643, 151643, 151643, 151643, 151643, 151643, 151643, 151643, 151643, 151643, 151643, 151643, 151643, 151643, 151643, 151643, 151643, 151643, 151643, 151643, 151643, 151643, 151643, 151643, 151643, 151643, 151643, 151643, 151643, 151643, 151643, 151643, 151643, 151643, 151643, 151643, 151643, 151643, 151643, 151643, 151643, 151643, 151643, 151643, 151643, 151643, 151643, 151643, 151643, 151643, 151643, 151643, 151643, 151643, 151643, 151643, 151643, 151643, 151643, 151643, 151643, 151643, 151643, 151643, 151643, 151643, 151643, 151643, 151643, 151643, 151643, 151643, 151643, 151643, 151643, 151643, 151643, 151644, 8948, 198, 2610, 525, 1207, 16948, 11, 3465, 553, 54364, 14817, 13, 1446, 525, 264, 10950, 17847, 13, 151645, 198, 151644, 872, 198, 16141, 279, 2701, 5248, 5754, 3405, 13, 576, 1537, 1555, 315, 697, 2033, 1265, 387, 315, 279, 2701, 3561, 25, 364, 16141, 25, 400, 20756, 4198, 6, 320, 28996, 17194, 8, 1380, 44428, 374, 825, 315, 19360, 35, 13, 21149, 3019, 553, 3019, 1573, 35764, 382, 23085, 315, 279, 2701, 4714, 525, 279, 1429, 4185, 8173, 315, 5000, 4686, 97580, 76672, 3059, 7907, 304, 4081, 23320, 821, 6358, 1447, 12, 31228, 1832, 52824, 821, 19856, 198, 12, 576, 330, 16789, 1, 608, 330, 2152, 28131, 1, 21340, 198, 12, 17207, 14614, 35301, 198, 12, 81857, 3034, 14409, 271, 32, 8, 2009, 315, 279, 3403, 198, 33, 8, 220, 17, 11, 220, 18, 323, 220, 19, 198, 34, 8, 220, 18, 323, 220, 19, 198, 35, 8, 220, 17, 323, 220, 18, 151645, 198, 151644, 77091, 198]",,160,247,407,0.0,0.0
930f7994-90b8-4520-bac9-64f854321c27,7,38,"[151643, 151643, 151643, 151643, 151643, 151643, 151643, 151643, 151643, 151643, 151643, 151643, 151643, 151643, 151643, 151643, 151643, 151643, 151643, 151643, 151643, 151643, 151643, 151643, 151643, 151643, 151643, 151643, 151643, 151643, 151643, 151643, 151643, 151643, 151643, 151643, 151643, 151643, 151643, 151643, 151643, 151643, 151643, 151643, 151643, 151643, 151643, 151643, 151643, 151643, 151643, 151643, 151643, 151643, 151643, 151643, 151643, 151643, 151643, 151643, 151643, 151643, 151643, 151643, 151643, 151643, 151643, 151643, 151643, 151643, 151643, 151643, 151643, 151643, 151643, 151643, 151643, 151643, 151643, 151643, 151643, 151643, 151643, 151643, 151643, 151643, 151643, 151643, 151643, 151643, 151643, 151643, 151643, 151643, 151643, 151643, 151643, 151643, 151643, 151643, 151643, 151643, 151643, 151643, 151643, 151643, 151643, 151643, 151643, 151643, 151643, 151643, 151643, 151643, 151643, 151643, 151643, 151643, 151643, 151643, 151643, 151643, 151643, 151643, 151643, 151643, 151643, 151643, 151643, 151643, 151643, 151643, 151643, 151643, 151643, 151643, 151643, 151643, 151643, 151643, 151643, 151643, 151643, 151643, 151643, 151643, 151643, 151643, 151643, 151643, 151643, 151643, 151643, 151643, 151643, 151643, 151643, 151643, 151643, 151643, 151643, 151643, 151643, 151643, 151643, 151643, 151643, 151643, 151643, 151643, 151643, 151643, 151643, 151643, 151643, 151643, 151643, 151643, 151643, 151643, 151643, 151643, 151643, 151643, 151643, 151643, 151643, 151643, 151643, 151643, 151643, 151643, 151643, 151644, 8948, 198, 2610, 525, 1207, 16948, 11, 3465, 553, 54364, 14817, 13, 1446, 525, 264, 10950, 17847, 13, 151645, 198, 151644, 872, 198, 16141, 279, 2701, 5248, 5754, 3405, 13, 576, 1537, 1555, 315, 697, 2033, 1265, 387, 315, 279, 2701, 3561, 25, 364, 16141, 25, 400, 20756, 4198, 6, 320, 28996, 17194, 8, 1380, 44428, 374, 825, 315, 19360, 35, 13, 21149, 3019, 553, 3019, 1573, 35764, 382, 66, 3337, 385, 41692, 266, 295, 956, 1952, 572, 31713, 448, 8593, 292, 458, 8503, 67, 1399, 304, 264, 220, 16, 25, 16, 11341, 11, 29064, 1985, 220, 16, 624, 16, 572, 31713, 448, 21068, 77, 337, 323, 264, 2613, 3311, 315, 71491, 292, 13621, 11, 29064, 1985, 220, 17, 624, 17, 572, 31713, 448, 43348, 22288, 306, 2767, 1952, 11, 29064, 1590, 1985, 220, 18, 624, 12555, 374, 279, 5944, 315, 279, 3598, 374, 25359, 315, 1985, 220, 18, 1939, 32, 8, 829, 25, 5103, 41872, 320, 16, 49, 11, 19, 50, 11, 19, 64, 50, 11, 19, 65, 49, 11, 20, 50, 11, 23, 49, 11, 23, 64, 50, 11, 23, 65, 49, 11, 16, 15, 50, 11, 16, 16, 49, 7287, 16, 11, 19, 11, 19, 64, 11, 19, 65, 11, 20, 11, 23, 11, 23, 64, 11, 23, 65, 16022, 302, 1466, 67007, 12, 16, 11, 19, 12, 769, 5652, 12, 20, 11, 23, 1448, 769, 276, 674, 573, 12032, 63551, 12, 16, 15, 11, 16, 16, 1737, 292, 277, 2011, 3923, 349, 271, 9501, 45978, 25, 506, 40917, 7, 7612, 6620, 34, 31, 39, 60, 16, 43504, 19191, 39, 9533, 34, 40917, 17, 6620, 34, 19191, 39, 60, 18, 43504, 19191, 39, 60, 2561, 34, 19191, 39, 60, 19, 43504, 31, 39, 60, 18, 43504, 19191, 39, 60, 20, 34, 40917, 43504, 31, 39, 60, 19, 34, 20, 6620, 34, 19191, 39, 60, 17, 43504, 31, 39, 60, 16, 34, 7, 7612, 11730, 46, 198, 33, 8, 829, 25, 5103, 41872, 320, 16, 49, 11, 19, 50, 11, 19, 64, 49, 11, 19, 65, 49, 11, 20, 49, 11, 23, 50, 11, 23, 64, 50, 11, 23, 65, 50, 11, 16, 15, 50, 11, 16, 16, 49, 7287, 16, 11, 19, 11, 19, 64, 11, 19, 65, 11, 20, 11, 23, 11, 23, 64, 11, 23, 65, 16022, 302, 1466, 67007, 12, 16, 11, 19, 12, 769, 5652, 12, 20, 11, 23, 1448, 769, 276, 674, 573, 12032, 63551, 12, 16, 15, 11, 16, 16, 1737, 292, 277, 2011, 3923, 349, 271, 9501, 45978, 25, 506, 40917, 7, 7612, 6620, 34, 19191, 39, 60, 16, 43504, 31, 39, 9533, 34, 40917, 17, 6620, 34, 19191, 39, 60, 18, 43504, 19191, 39, 60, 2561, 34, 31, 39, 60, 19, 43504, 19191, 39, 60, 18, 43504, 19191, 39, 60, 20, 34, 40917, 43504, 31, 39, 60, 19, 34, 20, 6620, 34, 31, 39, 60, 17, 43504, 19191, 39, 60, 16, 34, 7, 7612, 11730, 46, 198, 34, 8, 829, 25, 5103, 41872, 320, 16, 50, 11, 19, 49, 11, 19, 64, 49, 11, 19, 65, 49, 11, 20, 50, 11, 23, 49, 11, 23, 64, 50, 11, 23, 65, 50, 11, 16, 15, 50, 11, 16, 16, 49, 7287, 16, 11, 19, 11, 19, 64, 11, 19, 65, 11, 20, 11, 23, 11, 23, 64, 11, 23, 65, 16022, 302, 1466, 67007, 12, 16, 11, 19, 12, 769, 5652, 12, 20, 11, 23, 1448, 769, 276, 674, 573, 12032, 63551, 12, 16, 15, 11, 16, 16, 1737, 292, 277, 2011, 3923, 349, 271, 9501, 45978, 25, 506, 40917, 7, 7612, 6620, 34, 19191, 39, 60, 16, 43504, 19191, 39, 9533, 34, 40917, 17, 6620, 34, 19191, 39, 60, 18, 43504, 19191, 39, 60, 2561, 34, 31, 39, 60, 19, 43504, 19191, 39, 60, 18, 43504, 31, 39, 60, 20, 34, 40917, 43504, 19191, 39, 60, 19, 34, 20, 6620, 34, 19191, 39, 60, 17, 43504, 19191, 39, 60, 16, 34, 7, 7612, 11730, 46, 198, 35, 8, 829, 25, 5103, 41872, 320, 16, 49, 11, 19, 50, 11, 19, 64, 50, 11, 19, 65, 49, 11, 20, 49, 11, 23, 50, 11, 23, 64, 50, 11, 23, 65, 49, 11, 16, 15, 49, 11, 16, 16, 49, 7287, 16, 11, 19, 11, 19, 64, 11, 19, 65, 11, 20, 11, 23, 11, 23, 64, 11, 23, 65, 16022, 302, 1466, 67007, 12, 16, 11, 19, 12, 769, 5652, 12, 20, 11, 23, 1448, 769, 276, 674, 573, 12032, 63551, 12, 16, 15, 11, 16, 16, 1737, 292, 277, 2011, 3923, 349, 271, 9501, 45978, 25, 506, 40917, 7, 7612, 6620, 34, 19191, 39, 60, 16, 43504, 19191, 39, 9533, 34, 40917, 17, 6620, 34, 19191, 39, 60, 18, 43504, 19191, 39, 60, 2561, 34, 19191, 39, 60, 19, 43504, 31, 39, 60, 18, 43504, 31, 39, 60, 20, 34, 40917, 43504, 19191, 39, 60, 19, 34, 20, 6620, 34, 19191, 39, 60, 17, 43504, 31, 39, 60, 16, 34, 7, 7612, 11730, 46, 151645, 198, 151644, 77091, 198]",,831,390,1221,0.0,0.0
e17fea14-ed4f-48fa-9b07-5d47b5e8c3d0,7,39,"[151643, 151643, 151643, 151643, 151643, 151643, 151643, 151643, 151643, 151643, 151643, 151643, 151643, 151643, 151643, 151643, 151643, 151643, 151643, 151643, 151643, 151643, 151643, 151643, 151643, 151643, 151643, 151643, 151643, 151643, 151643, 151643, 151643, 151643, 151643, 151643, 151643, 151643, 151643, 151643, 151643, 151643, 151643, 151643, 151643, 151643, 151643, 151643, 151643, 151643, 151643, 151643, 151643, 151643, 151643, 151643, 151643, 151643, 151643, 151643, 151643, 151643, 151643, 151643, 151643, 151643, 151643, 151643, 151643, 151643, 151643, 151643, 151643, 151643, 151643, 151643, 151643, 151643, 151643, 151643, 151643, 151643, 151643, 151643, 151643, 151643, 151643, 151643, 151643, 151643, 151643, 151643, 151643, 151643, 151643, 151643, 151643, 151643, 151643, 151643, 151643, 151643, 151643, 151643, 151643, 151643, 151643, 151643, 151643, 151643, 151643, 151643, 151643, 151643, 151643, 151643, 151643, 151643, 151643, 151643, 151643, 151643, 151643, 151643, 151643, 151643, 151643, 151643, 151643, 151643, 151643, 151643, 151643, 151643, 151643, 151643, 151643, 151643, 151643, 151643, 151643, 151643, 151643, 151643, 151643, 151643, 151643, 151643, 151643, 151643, 151643, 151643, 151643, 151643, 151643, 151643, 151643, 151643, 151643, 151643, 151643, 151643, 151643, 151643, 151643, 151643, 151643, 151643, 151643, 151643, 151643, 151643, 151643, 151643, 151643, 151643, 151643, 151643, 151643, 151643, 151643, 151643, 151643, 151643, 151643, 151643, 151643, 151643, 151643, 151643, 151643, 151643, 151643, 151643, 151643, 151643, 151643, 151643, 151643, 151643, 151643, 151643, 151643, 151643, 151643, 151643, 151643, 151643, 151643, 151643, 151643, 151643, 151643, 151643, 151643, 151643, 151643, 151643, 151643, 151643, 151643, 151643, 151643, 151643, 151643, 151643, 151643, 151643, 151643, 151643, 151643, 151643, 151643, 151643, 151643, 151643, 151643, 151643, 151643, 151643, 151643, 151643, 151643, 151643, 151643, 151643, 151643, 151643, 151643, 151643, 151643, 151643, 151643, 151643, 151643, 151643, 151643, 151643, 151643, 151643, 151643, 151643, 151643, 151643, 151643, 151643, 151643, 151643, 151643, 151643, 151643, 151643, 151643, 151643, 151643, 151643, 151643, 151643, 151643, 151643, 151643, 151643, 151643, 151643, 151643, 151643, 151643, 151643, 151643, 151643, 151643, 151643, 151643, 151643, 151643, 151643, 151643, 151643, 151643, 151643, 151643, 151643, 151643, 151643, 151643, 151643, 151643, 151643, 151643, 151643, 151643, 151643, 151643, 151643, 151643, 151643, 151643, 151643, 151643, 151643, 151643, 151643, 151643, 151643, 151643, 151643, 151643, 151643, 151643, 151643, 151643, 151643, 151643, 151643, 151643, 151643, 151643, 151643, 151643, 151643, 151643, 151643, 151643, 151643, 151643, 151643, 151643, 151643, 151643, 151643, 151643, 151643, 151643, 151643, 151643, 151643, 151643, 151643, 151643, 151643, 151643, 151643, 151643, 151643, 151643, 151643, 151643, 151643, 151643, 151643, 151643, 151643, 151643, 151643, 151643, 151643, 151643, 151643, 151643, 151643, 151643, 151643, 151643, 151643, 151643, 151643, 151643, 151643, 151643, 151643, 151643, 151643, 151643, 151643, 151643, 151643, 151643, 151643, 151643, 151643, 151643, 151643, 151643, 151643, 151643, 151643, 151643, 151643, 151643, 151643, 151643, 151643, 151643, 151643, 151643, 151643, 151643, 151643, 151643, 151643, 151643, 151643, 151643, 151643, 151643, 151643, 151643, 151643, 151643, 151643, 151643, 151643, 151643, 151643, 151643, 151643, 151643, 151643, 151643, 151643, 151643, 151643, 151643, 151643, 151643, 151643, 151643, 151643, 151643, 151643, 151643, 151643, 151643, 151643, 151643, 151643, 151643, 151643, 151643, 151643, 151643, 151643, 151643, 151643, 151643, 151643, 151643, 151643, 151643, 151643, 151643, 151643, 151643, 151643, 151643, 151643, 151643, 151643, 151643, 151643, 151643, 151643, 151643, 151643, 151643, 151643, 151643, 151643, 151643, 151643, 151643, 151643, 151643, 151643, 151643, 151643, 151643, 151643, 151643, 151643, 151643, 151643, 151643, 151643, 151643, 151643, 151643, 151643, 151643, 151643, 151643, 151643, 151643, 151643, 151643, 151643, 151643, 151643, 151643, 151643, 151643, 151643, 151643, 151643, 151643, 151643, 151643, 151643, 151643, 151643, 151643, 151643, 151643, 151643, 151643, 151643, 151643, 151643, 151643, 151643, 151643, 151643, 151643, 151643, 151643, 151643, 151643, 151643, 151643, 151643, 151643, 151643, 151643, 151643, 151643, 151643, 151643, 151643, 151643, 151643, 151643, 151643, 151643, 151643, 151643, 151643, 151643, 151643, 151643, 151643, 151643, 151643, 151643, 151643, 151643, 151643, 151643, 151643, 151643, 151643, 151643, 151643, 151643, 151643, 151643, 151643, 151643, 151643, 151643, 151643, 151643, 151643, 151643, 151643, 151643, 151643, 151643, 151643, 151643, 151643, 151643, 151643, 151643, 151643, 151643, 151643, 151643, 151643, 151643, 151643, 151643, 151643, 151643, 151643, 151643, 151643, 151643, 151643, 151643, 151643, 151643, 151643, 151643, 151643, 151643, 151643, 151643, 151643, 151643, 151643, 151643, 151643, 151643, 151643, 151643, 151643, 151643, 151643, 151643, 151643, 151643, 151643, 151643, 151643, 151643, 151643, 151643, 151643, 151643, 151643, 151643, 151643, 151643, 151643, 151643, 151643, 151643, 151643, 151643, 151643, 151643, 151643, 151643, 151643, 151643, 151643, 151643, 151643, 151643, 151643, 151643, 151643, 151643, 151643, 151643, 151643, 151643, 151643, 151643, 151643, 151643, 151643, 151643, 151643, 151643, 151643, 151643, 151643, 151643, 151643, 151643, 151643, 151643, 151643, 151643, 151643, 151643, 151643, 151643, 151643, 151643, 151643, 151643, 151643, 151643, 151643, 151643, 151643, 151643, 151643, 151643, 151643, 151643, 151643, 151643, 151643, 151643, 151643, 151643, 151643, 151643, 151643, 151643, 151643, 151643, 151643, 151643, 151643, 151643, 151643, 151643, 151643, 151643, 151643, 151643, 151643, 151643, 151643, 151643, 151643, 151643, 151643, 151643, 151643, 151643, 151643, 151643, 151643, 151643, 151643, 151643, 151643, 151643, 151643, 151643, 151643, 151643, 151643, 151643, 151643, 151643, 151643, 151643, 151643, 151643, 151643, 151643, 151643, 151643, 151643, 151643, 151643, 151643, 151643, 151643, 151643, 151643, 151643, 151643, 151643, 151643, 151643, 151643, 151643, 151643, 151643, 151643, 151643, 151643, 151643, 151643, 151643, 151643, 151643, 151643, 151643, 151643, 151643, 151643, 151643, 151643, 151643, 151643, 151643, 151643, 151643, 151643, 151643, 151643, 151643, 151643, 151643, 151643, 151643, 151643, 151643, 151643, 151643, 151643, 151643, 151643, 151643, 151643, 151643, 151643, 151643, 151644, 8948, 198, 2610, 525, 1207, 16948, 11, 3465, 553, 54364, 14817, 13, 1446, 525, 264, 10950, 17847, 13, 151645, 198, 151644, 872, 198, 16141, 279, 2701, 5248, 5754, 3405, 13, 576, 1537, 1555, 315, 697, 2033, 1265, 387, 315, 279, 2701, 3561, 25, 364, 16141, 25, 400, 20756, 4198, 6, 320, 28996, 17194, 8, 1380, 44428, 374, 825, 315, 19360, 35, 13, 21149, 3019, 553, 3019, 1573, 35764, 382, 3838, 374, 279, 3598, 15274, 315, 279, 12720, 1948, 220, 19, 11, 19, 1737, 318, 41872, 66, 3337, 22288, 306, 12, 16, 20767, 337, 323, 93471, 482, 1939, 32, 8, 320, 16, 49, 11, 17, 50, 7287, 16, 11, 17, 1737, 579, 98539, 12, 19, 11, 19, 1737, 318, 41872, 66, 3337, 22288, 306, 38610, 198, 33, 8, 220, 17, 1455, 98539, 12, 19, 11, 19, 1737, 318, 41872, 66, 3337, 22288, 306, 276, 603, 198, 34, 8, 320, 16, 49, 11, 17, 49, 7287, 16, 11, 17, 1737, 579, 98539, 12, 19, 11, 19, 1737, 318, 41872, 66, 3337, 22288, 306, 38610, 198, 35, 8, 220, 19, 1455, 98539, 12, 19, 11, 19, 1737, 318, 41872, 66, 3337, 22288, 306, 276, 603, 151645, 198, 151644, 77091, 198]",,198,514,712,0.0,0.0
bbe19d06-2ebd-42eb-adfb-6ce446c4cced,7,40,"[151643, 151643, 151643, 151643, 151643, 151643, 151643, 151643, 151643, 151643, 151643, 151643, 151643, 151643, 151643, 151643, 151643, 151643, 151643, 151643, 151643, 151643, 151643, 151643, 151643, 151643, 151643, 151643, 151643, 151643, 151643, 151643, 151643, 151643, 151643, 151643, 151643, 151643, 151643, 151643, 151643, 151643, 151643, 151643, 151643, 151643, 151643, 151643, 151643, 151643, 151643, 151643, 151643, 151643, 151643, 151643, 151643, 151643, 151643, 151643, 151643, 151643, 151643, 151643, 151643, 151643, 151643, 151643, 151643, 151643, 151643, 151643, 151643, 151643, 151643, 151643, 151643, 151643, 151643, 151643, 151643, 151643, 151643, 151643, 151643, 151643, 151643, 151643, 151643, 151643, 151643, 151643, 151643, 151643, 151643, 151643, 151643, 151643, 151643, 151643, 151643, 151643, 151643, 151643, 151643, 151643, 151643, 151643, 151643, 151643, 151643, 151643, 151643, 151643, 151643, 151643, 151643, 151643, 151643, 151643, 151643, 151643, 151643, 151643, 151643, 151643, 151643, 151643, 151643, 151643, 151643, 151643, 151643, 151643, 151643, 151643, 151643, 151643, 151643, 151643, 151643, 151643, 151643, 151643, 151643, 151643, 151643, 151643, 151643, 151643, 151643, 151643, 151643, 151643, 151643, 151643, 151643, 151643, 151643, 151643, 151643, 151643, 151643, 151643, 151643, 151643, 151643, 151643, 151643, 151643, 151643, 151643, 151643, 151643, 151643, 151643, 151643, 151643, 151643, 151643, 151643, 151643, 151643, 151643, 151643, 151643, 151643, 151643, 151643, 151643, 151643, 151643, 151643, 151643, 151643, 151643, 151643, 151643, 151643, 151643, 151643, 151643, 151643, 151643, 151643, 151643, 151643, 151643, 151643, 151643, 151643, 151643, 151643, 151643, 151643, 151643, 151643, 151643, 151643, 151643, 151643, 151643, 151643, 151643, 151643, 151643, 151643, 151643, 151643, 151643, 151643, 151643, 151643, 151643, 151643, 151643, 151643, 151643, 151643, 151643, 151643, 151643, 151643, 151643, 151643, 151643, 151643, 151643, 151643, 151643, 151643, 151643, 151643, 151643, 151643, 151643, 151643, 151643, 151643, 151643, 151643, 151643, 151643, 151643, 151643, 151643, 151643, 151643, 151643, 151643, 151643, 151643, 151643, 151643, 151643, 151643, 151643, 151643, 151643, 151643, 151643, 151643, 151643, 151643, 151643, 151643, 151643, 151643, 151643, 151643, 151643, 151643, 151643, 151643, 151643, 151643, 151643, 151643, 151643, 151643, 151643, 151643, 151643, 151643, 151643, 151643, 151643, 151643, 151643, 151643, 151643, 151643, 151643, 151643, 151643, 151643, 151643, 151643, 151643, 151643, 151643, 151643, 151643, 151643, 151643, 151643, 151643, 151643, 151643, 151643, 151643, 151643, 151643, 151643, 151643, 151643, 151643, 151643, 151643, 151643, 151643, 151643, 151643, 151643, 151643, 151643, 151643, 151643, 151643, 151643, 151643, 151643, 151643, 151643, 151643, 151643, 151643, 151643, 151643, 151643, 151643, 151643, 151643, 151643, 151643, 151643, 151643, 151643, 151643, 151643, 151643, 151643, 151643, 151643, 151643, 151643, 151643, 151643, 151643, 151643, 151643, 151643, 151643, 151643, 151643, 151643, 151643, 151643, 151643, 151643, 151643, 151643, 151643, 151643, 151643, 151643, 151643, 151643, 151643, 151643, 151643, 151643, 151643, 151643, 151643, 151643, 151643, 151643, 151643, 151643, 151643, 151643, 151643, 151643, 151643, 151643, 151643, 151643, 151643, 151643, 151643, 151643, 151643, 151643, 151643, 151643, 151643, 151643, 151643, 151643, 151643, 151643, 151643, 151643, 151643, 151643, 151643, 151643, 151643, 151643, 151643, 151643, 151643, 151643, 151643, 151643, 151643, 151643, 151643, 151643, 151643, 151643, 151643, 151643, 151643, 151643, 151643, 151643, 151643, 151643, 151643, 151643, 151643, 151643, 151643, 151643, 151643, 151643, 151643, 151643, 151643, 151643, 151643, 151643, 151643, 151643, 151643, 151643, 151643, 151643, 151643, 151643, 151643, 151643, 151643, 151643, 151643, 151643, 151643, 151643, 151643, 151643, 151643, 151643, 151643, 151643, 151643, 151643, 151643, 151643, 151643, 151643, 151643, 151643, 151643, 151643, 151643, 151643, 151643, 151643, 151643, 151643, 151643, 151643, 151643, 151643, 151643, 151643, 151643, 151643, 151643, 151643, 151643, 151643, 151643, 151643, 151643, 151643, 151643, 151643, 151643, 151643, 151643, 151643, 151643, 151643, 151643, 151643, 151643, 151643, 151643, 151643, 151643, 151643, 151643, 151643, 151643, 151643, 151643, 151643, 151643, 151643, 151643, 151643, 151643, 151643, 151643, 151643, 151643, 151643, 151643, 151643, 151643, 151643, 151643, 151643, 151643, 151643, 151643, 151643, 151643, 151643, 151643, 151643, 151643, 151643, 151643, 151643, 151643, 151643, 151643, 151643, 151643, 151643, 151643, 151643, 151643, 151643, 151643, 151643, 151643, 151643, 151643, 151643, 151643, 151643, 151643, 151643, 151643, 151643, 151643, 151643, 151643, 151643, 151643, 151643, 151643, 151643, 151643, 151643, 151643, 151643, 151643, 151643, 151643, 151643, 151643, 151643, 151643, 151643, 151643, 151643, 151643, 151643, 151643, 151643, 151643, 151643, 151643, 151643, 151643, 151643, 151643, 151643, 151643, 151643, 151643, 151643, 151643, 151643, 151643, 151643, 151643, 151643, 151643, 151643, 151643, 151643, 151643, 151643, 151643, 151643, 151643, 151643, 151643, 151643, 151643, 151643, 151643, 151643, 151643, 151643, 151643, 151643, 151643, 151643, 151643, 151643, 151643, 151643, 151643, 151643, 151643, 151643, 151643, 151643, 151643, 151643, 151643, 151643, 151643, 151643, 151643, 151643, 151643, 151643, 151643, 151643, 151643, 151643, 151643, 151643, 151643, 151643, 151643, 151643, 151643, 151643, 151643, 151643, 151643, 151643, 151643, 151643, 151643, 151643, 151643, 151643, 151643, 151643, 151643, 151643, 151643, 151643, 151643, 151643, 151643, 151643, 151643, 151643, 151643, 151643, 151643, 151643, 151643, 151643, 151643, 151643, 151643, 151643, 151643, 151643, 151643, 151643, 151643, 151643, 151643, 151643, 151643, 151643, 151643, 151643, 151643, 151643, 151643, 151643, 151643, 151643, 151643, 151643, 151643, 151643, 151643, 151643, 151643, 151643, 151643, 151643, 151643, 151643, 151643, 151643, 151643, 151643, 151643, 151643, 151643, 151643, 151643, 151643, 151643, 151643, 151643, 151643, 151643, 151643, 151643, 151643, 151643, 151643, 151643, 151643, 151643, 151643, 151643, 151643, 151643, 151643, 151643, 151643, 151643, 151643, 151643, 151643, 151643, 151643, 151643, 151643, 151643, 151643, 151643, 151643, 151643, 151643, 151643, 151643, 151643, 151643, 151643, 151643, 151643, 151643, 151643, 151643, 151643, 151643, 151643, 151643, 151643, 151643, 151643, 151643, 151643, 151643, 151643, 151643, 151643, 151643, 151643, 151643, 151643, 151643, 151643, 151643, 151643, 151643, 151643, 151643, 151643, 151643, 151644, 8948, 198, 2610, 525, 1207, 16948, 11, 3465, 553, 54364, 14817, 13, 1446, 525, 264, 10950, 17847, 13, 151645, 198, 151644, 872, 198, 16141, 279, 2701, 5248, 5754, 3405, 13, 576, 1537, 1555, 315, 697, 2033, 1265, 387, 315, 279, 2701, 3561, 25, 364, 16141, 25, 400, 20756, 4198, 6, 320, 28996, 17194, 8, 1380, 44428, 374, 825, 315, 19360, 35, 13, 21149, 3019, 553, 3019, 1573, 35764, 382, 3838, 374, 279, 19950, 315, 34619, 64025, 304, 264, 6291, 8482, 220, 15, 13, 15, 17, 386, 357, 4953, 72, 23375, 14413, 12, 1479, 15204, 6351, 320, 896, 9658, 429, 279, 36043, 374, 10507, 11, 350, 284, 220, 17, 20, 36286, 34, 568, 21084, 64, 12, 1479, 15204, 284, 220, 20, 87, 16, 15, 61, 16, 15, 382, 32, 8, 220, 16, 13, 15, 87, 16, 15, 49309, 17, 386, 198, 33, 8, 220, 17, 13, 15, 87, 16, 15, 49309, 17, 386, 198, 34, 8, 220, 21, 13, 18, 87, 16, 15, 49309, 22, 386, 198, 35, 8, 220, 20, 13, 15, 87, 16, 15, 49309, 18, 386, 151645, 198, 151644, 77091, 198]",,184,746,930,1.0,1.0
cf609a13-0916-4ab0-ade0-23cb920a7701,7,41,"[151643, 151643, 151643, 151643, 151643, 151643, 151643, 151643, 151643, 151643, 151643, 151643, 151643, 151643, 151643, 151643, 151643, 151643, 151643, 151643, 151643, 151643, 151643, 151643, 151643, 151643, 151643, 151643, 151643, 151643, 151643, 151643, 151643, 151643, 151643, 151643, 151643, 151643, 151643, 151643, 151643, 151643, 151643, 151643, 151643, 151643, 151643, 151643, 151643, 151643, 151643, 151643, 151643, 151643, 151643, 151643, 151643, 151643, 151643, 151643, 151643, 151643, 151643, 151643, 151643, 151643, 151643, 151643, 151643, 151643, 151643, 151643, 151643, 151643, 151643, 151643, 151643, 151643, 151643, 151643, 151643, 151643, 151643, 151643, 151643, 151643, 151643, 151643, 151643, 151643, 151643, 151643, 151643, 151643, 151643, 151643, 151643, 151643, 151643, 151643, 151643, 151643, 151643, 151643, 151643, 151643, 151643, 151643, 151643, 151643, 151643, 151643, 151643, 151643, 151643, 151643, 151643, 151643, 151643, 151643, 151643, 151643, 151643, 151643, 151643, 151643, 151643, 151643, 151643, 151643, 151643, 151643, 151643, 151643, 151643, 151643, 151643, 151643, 151643, 151643, 151643, 151643, 151643, 151643, 151643, 151643, 151643, 151643, 151643, 151643, 151643, 151643, 151643, 151643, 151643, 151643, 151643, 151643, 151643, 151643, 151643, 151643, 151643, 151643, 151643, 151643, 151643, 151643, 151643, 151643, 151643, 151643, 151643, 151643, 151643, 151643, 151643, 151643, 151643, 151643, 151643, 151643, 151643, 151643, 151643, 151643, 151643, 151643, 151643, 151643, 151643, 151643, 151643, 151643, 151643, 151643, 151643, 151643, 151643, 151643, 151643, 151643, 151643, 151643, 151643, 151643, 151643, 151643, 151643, 151643, 151643, 151643, 151643, 151643, 151643, 151643, 151643, 151643, 151643, 151643, 151643, 151643, 151643, 151643, 151643, 151643, 151643, 151643, 151643, 151643, 151643, 151643, 151643, 151643, 151643, 151643, 151643, 151643, 151643, 151643, 151643, 151643, 151643, 151643, 151643, 151643, 151643, 151643, 151643, 151643, 151643, 151643, 151643, 151643, 151643, 151643, 151643, 151643, 151643, 151643, 151643, 151643, 151643, 151643, 151643, 151643, 151643, 151643, 151643, 151643, 151643, 151643, 151643, 151643, 151643, 151643, 151643, 151643, 151643, 151643, 151643, 151643, 151643, 151643, 151643, 151643, 151643, 151643, 151643, 151643, 151643, 151643, 151643, 151643, 151643, 151643, 151643, 151643, 151643, 151643, 151643, 151643, 151643, 151643, 151643, 151643, 151643, 151643, 151643, 151643, 151643, 151643, 151643, 151643, 151643, 151643, 151643, 151643, 151643, 151643, 151643, 151643, 151643, 151643, 151643, 151643, 151643, 151643, 151643, 151643, 151643, 151643, 151643, 151643, 151643, 151643, 151643, 151643, 151643, 151643, 151643, 151643, 151643, 151643, 151643, 151643, 151643, 151643, 151643, 151643, 151643, 151643, 151643, 151643, 151643, 151643, 151643, 151643, 151643, 151643, 151643, 151643, 151643, 151643, 151643, 151643, 151643, 151643, 151643, 151643, 151643, 151643, 151643, 151643, 151643, 151643, 151643, 151643, 151643, 151643, 151643, 151643, 151643, 151643, 151643, 151643, 151643, 151643, 151643, 151643, 151643, 151643, 151643, 151643, 151643, 151643, 151643, 151643, 151643, 151643, 151643, 151643, 151643, 151643, 151643, 151643, 151643, 151643, 151643, 151643, 151643, 151643, 151643, 151643, 151643, 151643, 151643, 151643, 151643, 151643, 151643, 151643, 151643, 151643, 151643, 151643, 151643, 151643, 151643, 151643, 151643, 151643, 151643, 151643, 151643, 151643, 151643, 151643, 151643, 151643, 151643, 151643, 151643, 151643, 151643, 151643, 151643, 151643, 151643, 151643, 151643, 151643, 151643, 151643, 151643, 151643, 151643, 151643, 151643, 151643, 151643, 151643, 151643, 151643, 151643, 151643, 151643, 151643, 151643, 151643, 151643, 151643, 151643, 151643, 151643, 151643, 151643, 151643, 151643, 151643, 151643, 151643, 151643, 151643, 151643, 151643, 151643, 151643, 151643, 151643, 151643, 151643, 151643, 151643, 151643, 151643, 151643, 151643, 151643, 151643, 151643, 151643, 151643, 151643, 151643, 151643, 151643, 151643, 151643, 151643, 151643, 151643, 151643, 151643, 151643, 151643, 151643, 151643, 151643, 151643, 151643, 151643, 151643, 151643, 151643, 151643, 151643, 151643, 151643, 151643, 151643, 151643, 151643, 151643, 151643, 151643, 151643, 151643, 151643, 151643, 151643, 151643, 151643, 151643, 151643, 151643, 151643, 151643, 151643, 151643, 151643, 151643, 151643, 151643, 151643, 151643, 151643, 151643, 151643, 151643, 151643, 151643, 151643, 151643, 151643, 151643, 151643, 151643, 151643, 151643, 151643, 151643, 151643, 151643, 151643, 151643, 151643, 151643, 151643, 151643, 151643, 151643, 151643, 151643, 151643, 151643, 151643, 151643, 151643, 151643, 151643, 151643, 151643, 151643, 151643, 151643, 151643, 151643, 151643, 151643, 151643, 151643, 151643, 151643, 151643, 151643, 151643, 151643, 151643, 151643, 151643, 151643, 151643, 151643, 151643, 151643, 151643, 151643, 151643, 151643, 151643, 151643, 151643, 151643, 151643, 151643, 151643, 151643, 151643, 151643, 151643, 151643, 151643, 151643, 151643, 151643, 151643, 151643, 151643, 151643, 151643, 151643, 151643, 151643, 151643, 151643, 151643, 151643, 151643, 151643, 151643, 151643, 151643, 151643, 151643, 151643, 151643, 151643, 151643, 151643, 151643, 151643, 151643, 151643, 151643, 151643, 151643, 151643, 151643, 151643, 151643, 151643, 151643, 151643, 151643, 151643, 151643, 151643, 151643, 151643, 151643, 151643, 151643, 151643, 151643, 151643, 151643, 151643, 151643, 151643, 151643, 151643, 151643, 151643, 151643, 151643, 151643, 151643, 151643, 151643, 151643, 151643, 151643, 151643, 151643, 151643, 151643, 151643, 151643, 151643, 151643, 151643, 151643, 151643, 151643, 151643, 151643, 151643, 151643, 151643, 151643, 151643, 151643, 151643, 151643, 151643, 151643, 151643, 151643, 151643, 151643, 151643, 151643, 151643, 151643, 151643, 151643, 151643, 151643, 151643, 151643, 151643, 151643, 151643, 151643, 151643, 151643, 151643, 151643, 151643, 151643, 151643, 151643, 151643, 151643, 151643, 151643, 151643, 151643, 151643, 151643, 151643, 151643, 151643, 151643, 151643, 151643, 151643, 151643, 151643, 151643, 151643, 151643, 151643, 151643, 151643, 151643, 151643, 151643, 151643, 151643, 151643, 151643, 151643, 151643, 151643, 151643, 151643, 151643, 151643, 151643, 151643, 151643, 151643, 151643, 151643, 151643, 151643, 151643, 151644, 8948, 198, 2610, 525, 1207, 16948, 11, 3465, 553, 54364, 14817, 13, 1446, 525, 264, 10950, 17847, 13, 151645, 198, 151644, 872, 198, 16141, 279, 2701, 5248, 5754, 3405, 13, 576, 1537, 1555, 315, 697, 2033, 1265, 387, 315, 279, 2701, 3561, 25, 364, 16141, 25, 400, 20756, 4198, 6, 320, 28996, 17194, 8, 1380, 44428, 374, 825, 315, 19360, 35, 13, 21149, 3019, 553, 3019, 1573, 35764, 382, 28301, 1437, 279, 5916, 3684, 1141, 8, 2567, 311, 6782, 26887, 78474, 220, 17, 76571, 3923, 12, 16, 11, 17, 11, 19, 64, 11, 20, 11, 21, 11, 22, 11, 23, 11, 23, 64, 16022, 302, 1466, 40121, 2248, 1342, 30292, 1952, 12, 16, 23992, 2011, 3923, 349, 382, 32, 8, 80981, 385, 17308, 1952, 323, 78474, 220, 17, 11, 18, 1737, 318, 87540, 17308, 5652, 349, 198, 33, 8, 78474, 320, 17, 36, 11, 19, 36, 11, 16, 15, 57, 7287, 72442, 13281, 22794, 12, 17, 11, 19, 11, 16, 15, 10188, 3591, 78, 349, 198, 34, 8, 220, 16, 8273, 258, 3923, 66, 3337, 385, 17308, 12, 16, 12, 1952, 323, 78474, 12371, 12, 17, 12, 1872, 78, 349, 198, 35, 8, 78474, 320, 17, 36, 11, 23, 36, 11, 16, 15, 36, 7287, 72442, 13281, 22794, 12, 17, 11, 23, 11, 16, 15, 10188, 3591, 78, 349, 151645, 198, 151644, 77091, 198]",,225,489,714,0.0,0.0
e6e67937-bb65-4283-a4b6-d51b8463e42b,7,42,"[151643, 151643, 151643, 151643, 151643, 151643, 151643, 151643, 151643, 151643, 151643, 151643, 151643, 151643, 151643, 151643, 151643, 151643, 151643, 151643, 151643, 151643, 151643, 151643, 151643, 151643, 151643, 151643, 151643, 151643, 151643, 151643, 151643, 151643, 151643, 151643, 151643, 151643, 151643, 151643, 151643, 151643, 151643, 151643, 151643, 151643, 151643, 151643, 151643, 151643, 151643, 151643, 151643, 151643, 151643, 151643, 151643, 151643, 151643, 151643, 151643, 151643, 151643, 151643, 151643, 151643, 151643, 151643, 151643, 151643, 151643, 151643, 151643, 151643, 151643, 151643, 151643, 151643, 151643, 151643, 151643, 151643, 151643, 151643, 151643, 151643, 151643, 151643, 151643, 151643, 151643, 151643, 151643, 151643, 151643, 151643, 151643, 151643, 151643, 151643, 151643, 151643, 151643, 151643, 151643, 151643, 151643, 151643, 151643, 151643, 151643, 151643, 151643, 151643, 151643, 151643, 151643, 151643, 151643, 151643, 151643, 151643, 151643, 151643, 151643, 151643, 151643, 151643, 151643, 151643, 151643, 151643, 151643, 151643, 151643, 151643, 151643, 151643, 151643, 151643, 151643, 151643, 151643, 151643, 151643, 151643, 151643, 151643, 151643, 151643, 151643, 151643, 151643, 151643, 151643, 151643, 151643, 151643, 151643, 151643, 151643, 151643, 151643, 151643, 151643, 151643, 151643, 151643, 151643, 151643, 151643, 151643, 151643, 151643, 151643, 151643, 151643, 151643, 151643, 151643, 151643, 151643, 151643, 151643, 151643, 151643, 151643, 151643, 151643, 151643, 151643, 151643, 151643, 151643, 151643, 151643, 151643, 151643, 151643, 151643, 151643, 151643, 151643, 151643, 151643, 151643, 151643, 151643, 151643, 151643, 151643, 151643, 151643, 151643, 151643, 151643, 151643, 151643, 151643, 151643, 151643, 151643, 151643, 151643, 151643, 151643, 151643, 151643, 151643, 151643, 151643, 151643, 151643, 151643, 151643, 151643, 151643, 151643, 151643, 151643, 151643, 151643, 151643, 151643, 151643, 151643, 151643, 151643, 151643, 151643, 151643, 151643, 151643, 151643, 151643, 151643, 151643, 151643, 151643, 151643, 151643, 151643, 151643, 151643, 151643, 151643, 151643, 151643, 151643, 151643, 151643, 151643, 151643, 151643, 151643, 151643, 151643, 151643, 151643, 151643, 151643, 151643, 151643, 151643, 151643, 151643, 151643, 151643, 151643, 151643, 151643, 151643, 151643, 151643, 151643, 151643, 151643, 151643, 151643, 151643, 151643, 151643, 151643, 151643, 151643, 151643, 151643, 151643, 151643, 151643, 151643, 151643, 151643, 151643, 151643, 151643, 151643, 151643, 151643, 151643, 151643, 151643, 151643, 151643, 151643, 151643, 151643, 151643, 151643, 151643, 151643, 151643, 151643, 151643, 151643, 151643, 151643, 151643, 151643, 151643, 151643, 151643, 151643, 151643, 151643, 151643, 151643, 151643, 151643, 151643, 151643, 151643, 151643, 151643, 151643, 151643, 151643, 151643, 151643, 151643, 151643, 151643, 151643, 151643, 151643, 151643, 151643, 151643, 151643, 151643, 151643, 151643, 151643, 151643, 151643, 151643, 151643, 151643, 151643, 151643, 151643, 151643, 151643, 151643, 151643, 151643, 151643, 151643, 151643, 151643, 151643, 151643, 151643, 151643, 151643, 151643, 151643, 151643, 151643, 151643, 151643, 151643, 151643, 151643, 151643, 151643, 151643, 151643, 151643, 151643, 151643, 151643, 151643, 151643, 151643, 151643, 151643, 151643, 151643, 151643, 151643, 151643, 151643, 151643, 151643, 151643, 151643, 151643, 151643, 151643, 151643, 151643, 151643, 151643, 151643, 151643, 151643, 151643, 151643, 151643, 151643, 151643, 151643, 151643, 151643, 151643, 151643, 151643, 151643, 151643, 151643, 151643, 151643, 151643, 151643, 151643, 151643, 151643, 151643, 151643, 151643, 151643, 151643, 151643, 151643, 151643, 151643, 151643, 151643, 151643, 151643, 151643, 151643, 151643, 151643, 151643, 151643, 151643, 151643, 151643, 151643, 151643, 151643, 151643, 151643, 151643, 151643, 151643, 151643, 151643, 151643, 151643, 151643, 151643, 151643, 151643, 151643, 151643, 151643, 151643, 151643, 151643, 151643, 151643, 151643, 151643, 151643, 151643, 151643, 151643, 151643, 151643, 151643, 151643, 151643, 151643, 151643, 151643, 151643, 151643, 151643, 151643, 151643, 151643, 151643, 151643, 151643, 151643, 151643, 151643, 151643, 151643, 151643, 151643, 151643, 151643, 151643, 151643, 151643, 151643, 151643, 151643, 151643, 151643, 151643, 151643, 151643, 151643, 151643, 151643, 151643, 151643, 151643, 151643, 151643, 151643, 151643, 151643, 151643, 151643, 151643, 151643, 151643, 151643, 151643, 151643, 151643, 151643, 151643, 151643, 151643, 151643, 151643, 151643, 151643, 151643, 151643, 151643, 151643, 151643, 151643, 151643, 151643, 151643, 151643, 151643, 151643, 151643, 151643, 151643, 151643, 151643, 151643, 151643, 151643, 151643, 151643, 151643, 151643, 151643, 151643, 151643, 151643, 151643, 151643, 151643, 151643, 151643, 151643, 151643, 151643, 151643, 151643, 151643, 151643, 151643, 151643, 151643, 151643, 151643, 151643, 151643, 151643, 151643, 151643, 151643, 151643, 151643, 151643, 151643, 151643, 151643, 151643, 151643, 151643, 151643, 151643, 151643, 151643, 151643, 151643, 151643, 151643, 151643, 151643, 151643, 151643, 151643, 151643, 151643, 151643, 151643, 151643, 151643, 151643, 151643, 151643, 151643, 151643, 151643, 151643, 151643, 151643, 151643, 151643, 151643, 151643, 151643, 151643, 151643, 151643, 151643, 151643, 151643, 151643, 151643, 151643, 151643, 151643, 151643, 151643, 151643, 151643, 151643, 151643, 151643, 151643, 151643, 151643, 151643, 151643, 151643, 151643, 151643, 151643, 151643, 151643, 151643, 151643, 151643, 151643, 151643, 151643, 151643, 151643, 151643, 151643, 151643, 151643, 151643, 151643, 151643, 151643, 151643, 151643, 151643, 151643, 151643, 151643, 151643, 151643, 151643, 151643, 151643, 151643, 151643, 151643, 151643, 151643, 151643, 151643, 151643, 151643, 151643, 151643, 151643, 151643, 151643, 151643, 151643, 151643, 151643, 151643, 151643, 151643, 151643, 151643, 151643, 151643, 151643, 151643, 151643, 151644, 8948, 198, 2610, 525, 1207, 16948, 11, 3465, 553, 54364, 14817, 13, 1446, 525, 264, 10950, 17847, 13, 151645, 198, 151644, 872, 198, 16141, 279, 2701, 5248, 5754, 3405, 13, 576, 1537, 1555, 315, 697, 2033, 1265, 387, 315, 279, 2701, 3561, 25, 364, 16141, 25, 400, 20756, 4198, 6, 320, 28996, 17194, 8, 1380, 44428, 374, 825, 315, 19360, 35, 13, 21149, 3019, 553, 3019, 1573, 35764, 382, 37175, 264, 30128, 22148, 1849, 8482, 264, 18790, 315, 3072, 400, 76, 3, 7218, 304, 458, 5999, 43936, 2326, 55887, 4650, 315, 279, 1352, 400, 53, 2601, 8, 284, 220, 16, 14, 17, 296, 1124, 32696, 61, 17, 435, 61, 17, 3, 12159, 311, 279, 30432, 5344, 40601, 287, 472, 85458, 748, 2329, 13, 5692, 11, 57960, 32696, 3, 374, 279, 20314, 11639, 315, 42424, 367, 323, 400, 81, 3, 374, 279, 56836, 6010, 315, 279, 18790, 504, 279, 6238, 304, 64151, 24660, 16184, 13, 3555, 374, 279, 897, 315, 4802, 315, 279, 4843, 12035, 1584, 11, 323, 1246, 1657, 13482, 398, 9489, 28724, 21409, 525, 3204, 369, 279, 1852, 4802, 28724, 957, 1939, 32, 8, 320, 24, 14, 17, 8, 1124, 71, 2257, 1124, 32696, 1154, 220, 16, 15, 198, 33, 8, 220, 16, 16, 1124, 2493, 61, 17, 1124, 71, 2257, 61, 17, 608, 320, 17, 76, 435, 61, 17, 701, 220, 18, 198, 34, 8, 220, 16, 16, 1124, 2493, 61, 17, 1124, 71, 2257, 61, 17, 608, 320, 17, 76, 435, 61, 17, 701, 220, 16, 15, 198, 35, 8, 320, 24, 14, 17, 8, 1124, 71, 2257, 1124, 32696, 11, 220, 18, 151645, 198, 151644, 77091, 198]",,272,584,856,0.0,0.0
3d26daf6-bdca-4595-b839-6a333bb6e8cb,7,43,"[151643, 151643, 151643, 151643, 151643, 151643, 151643, 151643, 151643, 151643, 151643, 151643, 151643, 151643, 151643, 151643, 151643, 151643, 151643, 151643, 151643, 151643, 151643, 151643, 151643, 151643, 151643, 151643, 151643, 151643, 151643, 151643, 151643, 151643, 151643, 151643, 151643, 151643, 151643, 151643, 151643, 151643, 151643, 151643, 151643, 151643, 151643, 151643, 151643, 151643, 151643, 151643, 151643, 151643, 151643, 151643, 151643, 151643, 151643, 151643, 151643, 151643, 151643, 151643, 151643, 151643, 151643, 151643, 151643, 151643, 151643, 151643, 151643, 151643, 151643, 151643, 151643, 151643, 151643, 151643, 151643, 151643, 151643, 151643, 151643, 151643, 151643, 151643, 151643, 151643, 151643, 151643, 151643, 151643, 151643, 151643, 151643, 151643, 151643, 151643, 151643, 151643, 151643, 151643, 151643, 151643, 151643, 151643, 151643, 151643, 151643, 151643, 151643, 151643, 151643, 151643, 151643, 151643, 151643, 151643, 151643, 151643, 151643, 151643, 151643, 151643, 151643, 151643, 151643, 151643, 151643, 151643, 151643, 151643, 151643, 151643, 151643, 151643, 151643, 151643, 151643, 151643, 151643, 151643, 151643, 151643, 151643, 151643, 151643, 151643, 151643, 151643, 151643, 151643, 151643, 151643, 151643, 151643, 151643, 151643, 151643, 151643, 151643, 151643, 151643, 151643, 151643, 151643, 151643, 151643, 151643, 151643, 151643, 151643, 151643, 151643, 151643, 151643, 151643, 151643, 151643, 151643, 151643, 151643, 151643, 151643, 151643, 151643, 151643, 151643, 151643, 151643, 151643, 151643, 151643, 151643, 151643, 151643, 151643, 151643, 151643, 151643, 151643, 151643, 151643, 151643, 151643, 151643, 151643, 151643, 151643, 151643, 151643, 151643, 151643, 151643, 151643, 151643, 151643, 151643, 151643, 151643, 151643, 151643, 151643, 151643, 151643, 151643, 151643, 151643, 151643, 151643, 151643, 151643, 151643, 151643, 151643, 151643, 151643, 151643, 151643, 151643, 151643, 151643, 151643, 151643, 151643, 151643, 151643, 151643, 151643, 151643, 151643, 151643, 151643, 151643, 151643, 151643, 151643, 151643, 151643, 151643, 151643, 151643, 151643, 151643, 151643, 151643, 151643, 151643, 151643, 151643, 151643, 151643, 151643, 151643, 151643, 151643, 151643, 151643, 151643, 151643, 151643, 151643, 151643, 151643, 151643, 151643, 151643, 151643, 151643, 151643, 151643, 151643, 151643, 151643, 151643, 151643, 151643, 151643, 151643, 151643, 151643, 151643, 151643, 151643, 151643, 151643, 151643, 151643, 151643, 151643, 151643, 151643, 151643, 151643, 151643, 151643, 151643, 151643, 151643, 151643, 151643, 151643, 151643, 151643, 151643, 151643, 151643, 151643, 151643, 151643, 151643, 151643, 151643, 151643, 151643, 151643, 151643, 151643, 151643, 151643, 151643, 151643, 151643, 151643, 151643, 151643, 151643, 151643, 151643, 151643, 151643, 151643, 151643, 151643, 151643, 151643, 151643, 151643, 151643, 151643, 151643, 151643, 151643, 151643, 151643, 151643, 151643, 151643, 151643, 151643, 151643, 151643, 151643, 151643, 151643, 151643, 151643, 151643, 151643, 151643, 151643, 151643, 151643, 151643, 151643, 151643, 151643, 151643, 151643, 151643, 151643, 151643, 151643, 151643, 151643, 151643, 151643, 151643, 151643, 151643, 151643, 151643, 151643, 151643, 151643, 151643, 151643, 151643, 151643, 151643, 151643, 151643, 151643, 151643, 151643, 151643, 151643, 151643, 151643, 151643, 151643, 151643, 151643, 151643, 151643, 151643, 151643, 151643, 151643, 151643, 151643, 151643, 151643, 151643, 151643, 151643, 151643, 151643, 151643, 151643, 151643, 151643, 151643, 151643, 151643, 151643, 151643, 151643, 151643, 151643, 151643, 151643, 151643, 151643, 151643, 151643, 151643, 151643, 151643, 151643, 151643, 151643, 151643, 151643, 151643, 151643, 151643, 151643, 151643, 151643, 151643, 151643, 151643, 151643, 151643, 151643, 151643, 151643, 151643, 151643, 151643, 151643, 151643, 151643, 151643, 151643, 151643, 151643, 151643, 151643, 151643, 151643, 151643, 151643, 151643, 151643, 151643, 151643, 151643, 151643, 151643, 151643, 151643, 151643, 151643, 151643, 151643, 151643, 151643, 151643, 151643, 151643, 151643, 151643, 151643, 151643, 151643, 151643, 151643, 151643, 151643, 151643, 151643, 151643, 151643, 151643, 151643, 151643, 151643, 151643, 151643, 151643, 151643, 151643, 151643, 151643, 151643, 151643, 151643, 151643, 151643, 151643, 151643, 151643, 151643, 151643, 151643, 151643, 151643, 151643, 151643, 151643, 151643, 151643, 151643, 151643, 151643, 151643, 151643, 151643, 151643, 151643, 151643, 151643, 151643, 151643, 151643, 151643, 151643, 151643, 151643, 151643, 151643, 151643, 151643, 151643, 151643, 151643, 151643, 151643, 151643, 151643, 151643, 151643, 151643, 151643, 151643, 151643, 151643, 151643, 151643, 151643, 151643, 151643, 151643, 151643, 151643, 151643, 151643, 151643, 151643, 151643, 151643, 151643, 151643, 151643, 151643, 151643, 151643, 151643, 151643, 151643, 151643, 151643, 151643, 151643, 151643, 151643, 151643, 151643, 151643, 151643, 151643, 151643, 151643, 151643, 151643, 151643, 151643, 151643, 151643, 151643, 151643, 151643, 151643, 151643, 151643, 151643, 151643, 151643, 151643, 151643, 151643, 151643, 151643, 151643, 151643, 151643, 151643, 151643, 151643, 151643, 151643, 151643, 151643, 151643, 151643, 151643, 151643, 151643, 151643, 151643, 151643, 151643, 151643, 151643, 151643, 151643, 151643, 151643, 151643, 151643, 151643, 151643, 151643, 151643, 151643, 151643, 151643, 151643, 151643, 151643, 151643, 151643, 151643, 151643, 151643, 151643, 151643, 151643, 151643, 151643, 151643, 151643, 151643, 151643, 151643, 151643, 151643, 151643, 151643, 151643, 151643, 151643, 151643, 151643, 151643, 151643, 151643, 151643, 151643, 151643, 151643, 151643, 151643, 151643, 151643, 151643, 151643, 151643, 151643, 151643, 151643, 151643, 151644, 8948, 198, 2610, 525, 1207, 16948, 11, 3465, 553, 54364, 14817, 13, 1446, 525, 264, 10950, 17847, 13, 151645, 198, 151644, 872, 198, 16141, 279, 2701, 5248, 5754, 3405, 13, 576, 1537, 1555, 315, 697, 2033, 1265, 387, 315, 279, 2701, 3561, 25, 364, 16141, 25, 400, 20756, 4198, 6, 320, 28996, 17194, 8, 1380, 44428, 374, 825, 315, 19360, 35, 13, 21149, 3019, 553, 3019, 1573, 35764, 382, 641, 9015, 295, 51279, 11, 279, 17239, 1014, 482, 36671, 288, 1378, 24484, 315, 752, 90160, 311, 2968, 10000, 311, 45800, 51096, 9015, 95181, 13, 576, 5795, 315, 752, 90160, 11, 19836, 5451, 10704, 11, 374, 311, 8651, 537, 1172, 279, 71380, 12923, 97184, 3365, 714, 1083, 279, 4998, 1609, 782, 50715, 13530, 311, 1352, 45800, 51096, 7761, 13, 434, 85695, 1506, 9015, 95181, 3725, 43381, 51279, 323, 13653, 2225, 1119, 458, 46020, 13, 2157, 90160, 374, 537, 2677, 13942, 15695, 11, 323, 1429, 1741, 5048, 1102, 304, 43381, 14011, 97422, 2719, 13, 647, 2156, 4357, 646, 2669, 387, 16507, 304, 279, 595, 658, 4156, 315, 43381, 14011, 7761, 504, 279, 1079, 7751, 14212, 15590, 13, 3776, 1741, 1538, 3059, 304, 730, 1056, 69, 17872, 594, 27339, 304, 13007, 13, 15920, 30106, 16953, 374, 8480, 369, 2686, 20469, 14018, 36841, 292, 15917, 315, 730, 1056, 69, 17872, 594, 27339, 7707, 311, 2664, 3881, 6285, 594, 27339, 1939, 32, 8, 21372, 14768, 21068, 78833, 553, 12744, 603, 78474, 24188, 2264, 304, 279, 1736, 12, 4246, 70, 1272, 198, 33, 8, 19984, 315, 98191, 311, 23938, 11023, 958, 416, 304, 279, 30668, 519, 358, 198, 34, 8, 32724, 315, 279, 46293, 519, 8287, 304, 279, 4313, 5607, 14, 63317, 509, 597, 198, 35, 8, 521, 32890, 459, 10935, 553, 4836, 519, 304, 1853, 585, 82789, 151645, 198, 151644, 77091, 198]",,298,476,774,1.0,1.0
7fea4788-8f67-468a-a0c3-f76c42f10d93,7,44,"[151643, 151643, 151643, 151643, 151643, 151643, 151643, 151643, 151643, 151643, 151643, 151643, 151643, 151643, 151643, 151643, 151643, 151643, 151643, 151643, 151643, 151643, 151643, 151643, 151643, 151643, 151643, 151643, 151643, 151643, 151643, 151643, 151643, 151643, 151643, 151643, 151643, 151643, 151643, 151643, 151643, 151643, 151643, 151643, 151643, 151643, 151643, 151643, 151643, 151643, 151643, 151643, 151643, 151643, 151643, 151643, 151643, 151643, 151643, 151643, 151643, 151643, 151643, 151643, 151643, 151643, 151643, 151643, 151643, 151643, 151643, 151643, 151643, 151643, 151643, 151643, 151643, 151643, 151643, 151643, 151643, 151643, 151643, 151643, 151643, 151643, 151643, 151643, 151643, 151643, 151643, 151643, 151643, 151643, 151643, 151643, 151643, 151643, 151643, 151643, 151643, 151643, 151643, 151643, 151643, 151643, 151643, 151643, 151643, 151643, 151643, 151643, 151643, 151643, 151643, 151643, 151643, 151643, 151643, 151643, 151643, 151643, 151643, 151643, 151643, 151643, 151643, 151643, 151643, 151643, 151643, 151643, 151643, 151643, 151643, 151643, 151643, 151643, 151643, 151643, 151643, 151643, 151643, 151643, 151643, 151643, 151643, 151643, 151643, 151643, 151643, 151643, 151643, 151643, 151643, 151643, 151643, 151643, 151643, 151643, 151643, 151643, 151643, 151643, 151643, 151643, 151643, 151643, 151643, 151643, 151643, 151643, 151643, 151643, 151643, 151643, 151643, 151643, 151643, 151643, 151643, 151643, 151643, 151643, 151643, 151643, 151643, 151643, 151643, 151643, 151643, 151643, 151643, 151643, 151643, 151643, 151643, 151643, 151643, 151643, 151643, 151643, 151643, 151643, 151643, 151643, 151643, 151643, 151643, 151643, 151643, 151643, 151643, 151643, 151643, 151643, 151643, 151643, 151643, 151643, 151643, 151643, 151643, 151643, 151643, 151643, 151643, 151643, 151643, 151643, 151643, 151643, 151643, 151643, 151643, 151643, 151643, 151643, 151643, 151643, 151643, 151643, 151643, 151643, 151643, 151643, 151643, 151643, 151643, 151643, 151643, 151643, 151643, 151643, 151643, 151643, 151643, 151643, 151643, 151643, 151643, 151643, 151643, 151643, 151643, 151643, 151643, 151643, 151643, 151643, 151643, 151643, 151643, 151643, 151643, 151643, 151643, 151643, 151643, 151643, 151643, 151643, 151643, 151643, 151643, 151643, 151643, 151643, 151643, 151643, 151643, 151643, 151643, 151643, 151643, 151643, 151643, 151643, 151643, 151643, 151643, 151643, 151643, 151643, 151643, 151643, 151643, 151643, 151643, 151643, 151643, 151643, 151643, 151643, 151643, 151643, 151643, 151643, 151643, 151643, 151643, 151643, 151643, 151643, 151643, 151643, 151643, 151643, 151643, 151643, 151643, 151643, 151643, 151643, 151643, 151643, 151643, 151643, 151643, 151643, 151643, 151643, 151643, 151643, 151643, 151643, 151643, 151643, 151643, 151643, 151643, 151643, 151643, 151643, 151643, 151643, 151643, 151643, 151643, 151643, 151643, 151643, 151643, 151643, 151643, 151643, 151643, 151643, 151643, 151643, 151643, 151643, 151643, 151643, 151643, 151643, 151643, 151643, 151643, 151643, 151643, 151643, 151643, 151643, 151643, 151643, 151643, 151643, 151643, 151643, 151643, 151643, 151643, 151643, 151643, 151643, 151643, 151643, 151643, 151643, 151643, 151643, 151643, 151643, 151643, 151643, 151643, 151643, 151643, 151643, 151643, 151643, 151643, 151643, 151643, 151643, 151643, 151643, 151643, 151643, 151643, 151643, 151643, 151643, 151643, 151643, 151643, 151643, 151643, 151643, 151643, 151643, 151643, 151643, 151643, 151643, 151643, 151643, 151643, 151643, 151643, 151643, 151643, 151643, 151643, 151643, 151643, 151643, 151643, 151643, 151643, 151643, 151643, 151643, 151643, 151643, 151643, 151643, 151643, 151643, 151643, 151643, 151643, 151643, 151643, 151643, 151643, 151643, 151643, 151643, 151643, 151643, 151643, 151643, 151643, 151643, 151643, 151643, 151643, 151643, 151643, 151643, 151643, 151643, 151643, 151643, 151643, 151643, 151643, 151643, 151643, 151643, 151643, 151643, 151643, 151643, 151643, 151643, 151643, 151643, 151643, 151643, 151643, 151643, 151643, 151643, 151643, 151643, 151643, 151643, 151643, 151643, 151643, 151643, 151643, 151643, 151643, 151643, 151643, 151643, 151643, 151643, 151643, 151643, 151643, 151643, 151643, 151643, 151643, 151643, 151643, 151643, 151643, 151643, 151643, 151643, 151643, 151643, 151643, 151643, 151643, 151643, 151643, 151643, 151643, 151643, 151643, 151643, 151643, 151643, 151643, 151643, 151643, 151643, 151643, 151643, 151643, 151643, 151643, 151643, 151643, 151643, 151643, 151643, 151643, 151643, 151643, 151643, 151643, 151643, 151643, 151643, 151643, 151643, 151643, 151643, 151643, 151643, 151643, 151643, 151643, 151643, 151643, 151643, 151643, 151643, 151643, 151643, 151643, 151643, 151643, 151643, 151643, 151643, 151643, 151643, 151643, 151643, 151643, 151643, 151643, 151643, 151643, 151643, 151643, 151643, 151643, 151643, 151643, 151643, 151643, 151643, 151643, 151643, 151643, 151643, 151643, 151643, 151643, 151643, 151643, 151643, 151643, 151643, 151643, 151643, 151643, 151643, 151643, 151643, 151643, 151643, 151643, 151643, 151643, 151643, 151643, 151643, 151643, 151643, 151643, 151643, 151643, 151643, 151643, 151643, 151643, 151643, 151643, 151643, 151643, 151643, 151643, 151643, 151643, 151643, 151643, 151643, 151643, 151643, 151643, 151643, 151643, 151643, 151643, 151643, 151643, 151643, 151643, 151643, 151643, 151643, 151643, 151643, 151643, 151643, 151643, 151643, 151643, 151643, 151643, 151643, 151643, 151643, 151643, 151643, 151643, 151643, 151643, 151643, 151643, 151643, 151643, 151643, 151643, 151643, 151643, 151643, 151643, 151643, 151643, 151643, 151643, 151643, 151643, 151643, 151643, 151643, 151643, 151643, 151643, 151643, 151643, 151643, 151643, 151643, 151643, 151643, 151643, 151643, 151643, 151643, 151643, 151643, 151643, 151643, 151643, 151643, 151643, 151643, 151643, 151643, 151643, 151643, 151643, 151643, 151643, 151643, 151643, 151643, 151643, 151643, 151643, 151643, 151643, 151644, 8948, 198, 2610, 525, 1207, 16948, 11, 3465, 553, 54364, 14817, 13, 1446, 525, 264, 10950, 17847, 13, 151645, 198, 151644, 872, 198, 16141, 279, 2701, 5248, 5754, 3405, 13, 576, 1537, 1555, 315, 697, 2033, 1265, 387, 315, 279, 2701, 3561, 25, 364, 16141, 25, 400, 20756, 4198, 6, 320, 28996, 17194, 8, 1380, 44428, 374, 825, 315, 19360, 35, 13, 21149, 3019, 553, 3019, 1573, 35764, 382, 32, 495, 14274, 388, 525, 20956, 264, 6774, 448, 264, 220, 16, 13, 20, 12941, 10578, 323, 220, 16, 13, 16, 12941, 31638, 13, 3197, 279, 6774, 594, 7329, 374, 537, 9761, 553, 6319, 18773, 11, 1181, 2655, 542, 374, 220, 21, 15, 15, 15, 42, 13, 4354, 11, 979, 220, 19, 15, 4, 315, 1181, 7329, 374, 9761, 553, 18773, 11, 279, 8084, 7249, 32249, 7373, 9315, 42054, 311, 220, 20, 20, 15, 15, 730, 13, 758, 279, 47217, 7249, 8023, 11, 979, 37836, 279, 11341, 315, 279, 1372, 315, 20628, 32199, 315, 22325, 304, 1378, 44855, 5866, 320, 3294, 220, 16, 323, 2188, 220, 17, 701, 86787, 614, 13166, 429, 419, 11341, 42054, 979, 279, 6774, 702, 18773, 13, 3555, 374, 279, 8168, 553, 892, 419, 11341, 4344, 979, 279, 6774, 1558, 537, 614, 18773, 7707, 311, 979, 432, 702, 18773, 30, 7036, 429, 279, 9142, 1948, 279, 4802, 5866, 1212, 17879, 33210, 311, 264, 45306, 315, 13187, 220, 16, 19, 19, 23, 79252, 13, 62197, 429, 279, 47217, 7249, 8023, 374, 304, 51398, 382, 32, 8, 3968, 16, 13, 16, 198, 33, 8, 3968, 17, 13, 24, 198, 34, 8, 3968, 22, 13, 23, 198, 35, 8, 3968, 19, 13, 20, 151645, 198, 151644, 77091, 198]",,279,1096,1375,0.0,0.0
8450c5da-6292-4111-ac11-d91d640a8b33,7,45,"[151643, 151643, 151643, 151643, 151643, 151643, 151643, 151643, 151643, 151643, 151643, 151643, 151643, 151643, 151643, 151643, 151643, 151643, 151643, 151643, 151643, 151643, 151643, 151643, 151643, 151643, 151643, 151643, 151643, 151643, 151643, 151643, 151643, 151643, 151643, 151643, 151643, 151643, 151643, 151643, 151643, 151643, 151643, 151643, 151643, 151643, 151643, 151643, 151643, 151643, 151643, 151643, 151643, 151643, 151643, 151643, 151643, 151643, 151643, 151643, 151643, 151643, 151643, 151643, 151643, 151643, 151643, 151643, 151643, 151643, 151643, 151643, 151643, 151643, 151643, 151643, 151643, 151643, 151643, 151643, 151643, 151643, 151643, 151643, 151643, 151643, 151643, 151643, 151643, 151643, 151643, 151643, 151643, 151643, 151643, 151643, 151643, 151643, 151643, 151643, 151643, 151643, 151643, 151643, 151643, 151643, 151643, 151643, 151643, 151643, 151643, 151643, 151643, 151643, 151643, 151643, 151643, 151643, 151643, 151643, 151643, 151643, 151643, 151643, 151643, 151643, 151643, 151643, 151643, 151643, 151643, 151643, 151643, 151643, 151643, 151643, 151643, 151643, 151643, 151643, 151643, 151643, 151643, 151643, 151643, 151643, 151643, 151643, 151643, 151643, 151643, 151643, 151643, 151643, 151643, 151643, 151643, 151643, 151643, 151643, 151643, 151643, 151643, 151643, 151643, 151643, 151643, 151643, 151643, 151643, 151643, 151643, 151643, 151643, 151643, 151643, 151643, 151643, 151643, 151643, 151643, 151643, 151643, 151643, 151643, 151643, 151643, 151643, 151643, 151643, 151643, 151643, 151643, 151643, 151643, 151643, 151643, 151643, 151643, 151643, 151643, 151643, 151643, 151643, 151643, 151643, 151643, 151643, 151643, 151643, 151643, 151643, 151643, 151643, 151643, 151643, 151643, 151643, 151643, 151643, 151643, 151643, 151643, 151643, 151643, 151643, 151643, 151643, 151643, 151643, 151643, 151643, 151643, 151643, 151643, 151643, 151643, 151643, 151643, 151643, 151643, 151643, 151643, 151643, 151643, 151643, 151643, 151643, 151643, 151643, 151643, 151643, 151643, 151643, 151643, 151643, 151643, 151643, 151643, 151643, 151643, 151643, 151643, 151643, 151643, 151643, 151643, 151643, 151643, 151643, 151643, 151643, 151643, 151643, 151643, 151643, 151643, 151643, 151643, 151643, 151643, 151643, 151643, 151643, 151643, 151643, 151643, 151643, 151643, 151643, 151643, 151643, 151643, 151643, 151643, 151643, 151643, 151643, 151643, 151643, 151643, 151643, 151643, 151643, 151643, 151643, 151643, 151643, 151643, 151643, 151643, 151643, 151643, 151643, 151643, 151643, 151643, 151643, 151643, 151643, 151643, 151643, 151643, 151643, 151643, 151643, 151643, 151643, 151643, 151643, 151643, 151643, 151643, 151643, 151643, 151643, 151643, 151643, 151643, 151643, 151643, 151643, 151643, 151643, 151643, 151643, 151643, 151643, 151643, 151643, 151643, 151643, 151643, 151643, 151643, 151643, 151643, 151643, 151643, 151643, 151643, 151643, 151643, 151643, 151643, 151643, 151643, 151643, 151643, 151643, 151643, 151643, 151643, 151643, 151643, 151643, 151643, 151643, 151643, 151643, 151643, 151643, 151643, 151643, 151643, 151643, 151643, 151643, 151643, 151643, 151643, 151643, 151643, 151643, 151643, 151643, 151643, 151643, 151643, 151643, 151643, 151643, 151643, 151643, 151643, 151643, 151643, 151643, 151643, 151643, 151643, 151643, 151643, 151643, 151643, 151643, 151643, 151643, 151643, 151643, 151643, 151643, 151643, 151643, 151643, 151643, 151643, 151643, 151643, 151643, 151643, 151643, 151643, 151643, 151643, 151643, 151643, 151643, 151643, 151643, 151643, 151643, 151643, 151643, 151643, 151643, 151643, 151643, 151643, 151643, 151643, 151643, 151643, 151643, 151643, 151643, 151643, 151643, 151643, 151643, 151643, 151643, 151643, 151643, 151643, 151643, 151643, 151643, 151643, 151643, 151643, 151643, 151643, 151643, 151643, 151643, 151643, 151643, 151643, 151643, 151643, 151643, 151643, 151643, 151643, 151643, 151643, 151643, 151643, 151643, 151643, 151643, 151643, 151643, 151643, 151643, 151643, 151643, 151643, 151643, 151643, 151643, 151643, 151643, 151643, 151643, 151643, 151643, 151643, 151643, 151643, 151643, 151643, 151643, 151643, 151643, 151643, 151643, 151643, 151643, 151643, 151643, 151643, 151643, 151643, 151643, 151643, 151643, 151643, 151643, 151643, 151643, 151643, 151643, 151643, 151643, 151643, 151643, 151643, 151643, 151643, 151643, 151643, 151643, 151643, 151643, 151643, 151643, 151643, 151643, 151643, 151643, 151643, 151643, 151643, 151643, 151643, 151643, 151643, 151643, 151643, 151643, 151643, 151643, 151643, 151643, 151643, 151643, 151643, 151643, 151643, 151643, 151643, 151643, 151643, 151643, 151643, 151643, 151643, 151643, 151643, 151643, 151643, 151643, 151643, 151643, 151643, 151643, 151643, 151643, 151643, 151643, 151643, 151643, 151643, 151643, 151643, 151643, 151643, 151643, 151643, 151643, 151643, 151643, 151643, 151643, 151643, 151643, 151643, 151643, 151643, 151643, 151643, 151643, 151643, 151643, 151643, 151643, 151643, 151643, 151643, 151643, 151643, 151643, 151643, 151643, 151643, 151643, 151643, 151643, 151643, 151643, 151643, 151643, 151643, 151643, 151643, 151643, 151643, 151643, 151643, 151643, 151643, 151643, 151643, 151643, 151643, 151643, 151643, 151643, 151643, 151643, 151643, 151643, 151643, 151643, 151643, 151643, 151643, 151643, 151643, 151643, 151643, 151643, 151643, 151643, 151643, 151643, 151643, 151643, 151643, 151643, 151643, 151643, 151643, 151643, 151643, 151643, 151643, 151643, 151643, 151643, 151643, 151643, 151643, 151643, 151643, 151643, 151643, 151643, 151643, 151643, 151643, 151643, 151643, 151643, 151643, 151643, 151643, 151643, 151643, 151643, 151643, 151643, 151643, 151643, 151643, 151643, 151643, 151643, 151643, 151643, 151643, 151643, 151643, 151643, 151643, 151643, 151643, 151643, 151643, 151643, 151643, 151643, 151643, 151643, 151643, 151643, 151643, 151643, 151643, 151643, 151643, 151643, 151643, 151643, 151643, 151643, 151643, 151643, 151643, 151643, 151643, 151643, 151643, 151643, 151643, 151643, 151643, 151643, 151644, 8948, 198, 2610, 525, 1207, 16948, 11, 3465, 553, 54364, 14817, 13, 1446, 525, 264, 10950, 17847, 13, 151645, 198, 151644, 872, 198, 16141, 279, 2701, 5248, 5754, 3405, 13, 576, 1537, 1555, 315, 697, 2033, 1265, 387, 315, 279, 2701, 3561, 25, 364, 16141, 25, 400, 20756, 4198, 6, 320, 28996, 17194, 8, 1380, 44428, 374, 825, 315, 19360, 35, 13, 21149, 3019, 553, 3019, 1573, 35764, 382, 10061, 760, 7141, 29, 387, 279, 1584, 22692, 458, 16715, 11, 1741, 429, 432, 374, 54172, 311, 320, 16, 21212, 8, 760, 454, 29, 488, 320, 17, 17600, 8, 760, 2923, 8066, 1380, 760, 454, 29, 323, 760, 2923, 29, 525, 279, 28724, 32069, 315, 279, 1147, 9838, 7606, 315, 279, 12616, 5675, 13, 20517, 279, 18927, 315, 28990, 279, 18790, 304, 1817, 315, 279, 28724, 32069, 315, 279, 5675, 6693, 6172, 13042, 374, 2661, 553, 279, 5424, 362, 3172, 11, 1741, 429, 362, 3172, 284, 305, 2257, 14, 17, 421, 600, 374, 2155, 504, 502, 11, 323, 220, 15, 5937, 13, 7281, 11, 1477, 279, 5461, 897, 315, 429, 5675, 382, 32, 8, 220, 15, 13, 21, 19, 11, 220, 15, 13, 18, 21, 323, 305, 2257, 608, 220, 22, 198, 33, 8, 220, 15, 13, 21, 16, 11, 220, 15, 13, 17, 24, 323, 220, 17, 54286, 2257, 608, 17946, 7, 22, 340, 34, 8, 220, 15, 13, 20, 19, 11, 220, 15, 13, 19, 21, 323, 220, 18, 54286, 2257, 608, 17946, 7, 22, 340, 35, 8, 220, 15, 13, 17, 23, 11, 220, 15, 13, 22, 17, 323, 305, 2257, 608, 17946, 7, 22, 8, 151645, 198, 151644, 77091, 198]",,274,629,903,1.0,1.0
91e24db3-f5be-4df1-96ce-16dfb4f65808,7,46,"[151643, 151643, 151643, 151643, 151643, 151643, 151643, 151643, 151643, 151643, 151643, 151643, 151643, 151643, 151643, 151643, 151643, 151643, 151643, 151643, 151643, 151643, 151643, 151643, 151643, 151643, 151643, 151643, 151643, 151643, 151643, 151643, 151643, 151643, 151643, 151643, 151643, 151643, 151643, 151643, 151643, 151643, 151643, 151643, 151643, 151643, 151643, 151643, 151643, 151643, 151643, 151643, 151643, 151643, 151643, 151643, 151643, 151643, 151643, 151643, 151643, 151643, 151643, 151643, 151643, 151643, 151643, 151643, 151643, 151643, 151643, 151643, 151643, 151643, 151643, 151643, 151643, 151643, 151643, 151643, 151643, 151643, 151643, 151643, 151643, 151643, 151643, 151643, 151643, 151643, 151643, 151643, 151643, 151643, 151643, 151643, 151643, 151643, 151643, 151643, 151643, 151643, 151643, 151643, 151643, 151643, 151643, 151643, 151643, 151643, 151643, 151643, 151643, 151643, 151643, 151643, 151643, 151643, 151643, 151643, 151643, 151643, 151643, 151643, 151643, 151643, 151643, 151643, 151643, 151643, 151643, 151643, 151643, 151643, 151643, 151643, 151643, 151643, 151643, 151643, 151643, 151643, 151643, 151643, 151643, 151643, 151643, 151643, 151643, 151643, 151643, 151643, 151643, 151643, 151643, 151643, 151643, 151643, 151643, 151643, 151643, 151643, 151643, 151643, 151643, 151643, 151643, 151643, 151643, 151643, 151643, 151643, 151643, 151643, 151643, 151643, 151643, 151643, 151643, 151643, 151643, 151643, 151643, 151643, 151643, 151643, 151643, 151643, 151643, 151643, 151643, 151643, 151643, 151643, 151643, 151643, 151643, 151643, 151643, 151643, 151643, 151643, 151643, 151643, 151643, 151643, 151643, 151643, 151643, 151643, 151643, 151643, 151643, 151643, 151643, 151643, 151643, 151643, 151643, 151643, 151643, 151643, 151643, 151643, 151643, 151643, 151643, 151643, 151643, 151643, 151643, 151643, 151643, 151643, 151643, 151643, 151643, 151643, 151643, 151643, 151643, 151643, 151643, 151643, 151643, 151643, 151643, 151643, 151643, 151643, 151643, 151643, 151643, 151643, 151643, 151643, 151643, 151643, 151643, 151643, 151643, 151643, 151643, 151643, 151643, 151643, 151643, 151643, 151643, 151643, 151643, 151643, 151643, 151643, 151643, 151643, 151643, 151643, 151643, 151643, 151643, 151643, 151643, 151643, 151643, 151643, 151643, 151643, 151643, 151643, 151643, 151643, 151643, 151643, 151643, 151643, 151643, 151643, 151643, 151643, 151643, 151643, 151643, 151643, 151643, 151643, 151643, 151643, 151643, 151643, 151643, 151643, 151643, 151643, 151643, 151643, 151643, 151643, 151643, 151643, 151643, 151643, 151643, 151643, 151643, 151643, 151643, 151643, 151643, 151643, 151643, 151643, 151643, 151643, 151643, 151643, 151643, 151643, 151643, 151643, 151643, 151643, 151643, 151643, 151643, 151643, 151643, 151643, 151643, 151643, 151643, 151643, 151643, 151643, 151643, 151643, 151643, 151643, 151643, 151643, 151643, 151643, 151643, 151643, 151643, 151643, 151643, 151643, 151643, 151643, 151643, 151643, 151643, 151643, 151643, 151643, 151643, 151643, 151643, 151643, 151643, 151643, 151643, 151643, 151643, 151643, 151643, 151643, 151643, 151643, 151643, 151643, 151643, 151643, 151643, 151643, 151643, 151643, 151643, 151643, 151643, 151643, 151643, 151643, 151643, 151643, 151643, 151643, 151643, 151643, 151643, 151643, 151643, 151643, 151643, 151643, 151643, 151643, 151643, 151643, 151643, 151643, 151643, 151643, 151643, 151643, 151643, 151643, 151643, 151643, 151643, 151643, 151643, 151643, 151643, 151643, 151643, 151643, 151643, 151643, 151643, 151643, 151643, 151643, 151643, 151643, 151643, 151643, 151643, 151643, 151643, 151643, 151643, 151643, 151643, 151643, 151643, 151643, 151643, 151643, 151643, 151643, 151643, 151643, 151643, 151643, 151643, 151643, 151643, 151643, 151643, 151643, 151643, 151643, 151643, 151643, 151643, 151643, 151643, 151643, 151643, 151643, 151643, 151643, 151643, 151643, 151643, 151643, 151643, 151643, 151643, 151643, 151643, 151643, 151643, 151643, 151643, 151643, 151643, 151643, 151643, 151643, 151643, 151643, 151643, 151643, 151643, 151643, 151643, 151643, 151643, 151643, 151643, 151643, 151643, 151643, 151643, 151643, 151643, 151643, 151643, 151643, 151643, 151643, 151643, 151643, 151643, 151643, 151643, 151643, 151643, 151643, 151643, 151643, 151643, 151643, 151643, 151643, 151643, 151643, 151643, 151643, 151643, 151643, 151643, 151643, 151643, 151643, 151643, 151643, 151643, 151643, 151643, 151643, 151643, 151643, 151643, 151643, 151643, 151643, 151643, 151643, 151643, 151643, 151643, 151643, 151643, 151643, 151643, 151643, 151643, 151643, 151643, 151643, 151643, 151643, 151643, 151643, 151643, 151643, 151643, 151643, 151643, 151643, 151643, 151643, 151643, 151643, 151643, 151643, 151643, 151643, 151643, 151643, 151643, 151643, 151643, 151643, 151643, 151643, 151643, 151643, 151643, 151643, 151643, 151643, 151643, 151643, 151643, 151643, 151643, 151643, 151643, 151643, 151643, 151643, 151643, 151643, 151643, 151643, 151643, 151643, 151643, 151643, 151643, 151643, 151643, 151643, 151643, 151643, 151643, 151643, 151643, 151643, 151643, 151643, 151643, 151643, 151643, 151643, 151643, 151643, 151643, 151643, 151643, 151643, 151643, 151643, 151643, 151643, 151643, 151643, 151643, 151643, 151643, 151643, 151643, 151643, 151643, 151643, 151643, 151643, 151643, 151643, 151643, 151643, 151643, 151643, 151643, 151643, 151643, 151643, 151643, 151643, 151643, 151643, 151643, 151643, 151643, 151643, 151643, 151643, 151643, 151643, 151643, 151643, 151643, 151643, 151643, 151643, 151643, 151643, 151643, 151643, 151643, 151643, 151643, 151643, 151643, 151643, 151643, 151643, 151643, 151643, 151643, 151643, 151643, 151643, 151643, 151643, 151643, 151643, 151643, 151643, 151643, 151643, 151643, 151643, 151643, 151643, 151643, 151643, 151643, 151643, 151643, 151643, 151643, 151643, 151643, 151643, 151643, 151643, 151643, 151643, 151643, 151643, 151643, 151643, 151643, 151643, 151643, 151643, 151643, 151643, 151643, 151643, 151643, 151643, 151643, 151643, 151643, 151643, 151643, 151643, 151643, 151643, 151643, 151643, 151643, 151643, 151643, 151643, 151643, 151643, 151643, 151643, 151643, 151643, 151643, 151643, 151643, 151644, 8948, 198, 2610, 525, 1207, 16948, 11, 3465, 553, 54364, 14817, 13, 1446, 525, 264, 10950, 17847, 13, 151645, 198, 151644, 872, 198, 16141, 279, 2701, 5248, 5754, 3405, 13, 576, 1537, 1555, 315, 697, 2033, 1265, 387, 315, 279, 2701, 3561, 25, 364, 16141, 25, 400, 20756, 4198, 6, 320, 28996, 17194, 8, 1380, 44428, 374, 825, 315, 19360, 35, 13, 21149, 3019, 553, 3019, 1573, 35764, 382, 32, 495, 14274, 388, 525, 8014, 304, 279, 44958, 436, 1361, 315, 1378, 9759, 13, 7679, 62, 16, 702, 264, 10578, 220, 16, 13, 20, 3039, 8131, 1091, 429, 315, 7679, 62, 17, 13, 576, 3072, 315, 7679, 62, 16, 374, 1083, 8131, 553, 279, 1852, 8168, 320, 16, 13, 20, 3039, 568, 16904, 65325, 50756, 11, 279, 86787, 8975, 311, 8253, 279, 92859, 518, 892, 279, 9759, 9723, 70921, 11, 323, 1730, 429, 807, 525, 279, 1852, 13, 38516, 14274, 388, 1083, 16588, 279, 56836, 74057, 315, 279, 1378, 9759, 311, 387, 220, 15, 323, 220, 22, 15, 15, 13136, 2687, 369, 7679, 62, 16, 323, 7679, 62, 17, 15576, 13, 63964, 429, 279, 9759, 11900, 349, 438, 3691, 12866, 11, 807, 24182, 279, 44958, 22053, 315, 7679, 62, 16, 311, 387, 7046, 1091, 279, 44958, 22053, 315, 7679, 62, 17, 553, 264, 8168, 315, 1447, 32, 8, 3968, 17, 13, 18, 20, 198, 33, 8, 3968, 17, 13, 18, 17, 198, 34, 8, 3968, 17, 13, 17, 18, 198, 35, 8, 3968, 17, 13, 17, 20, 151645, 198, 151644, 77091, 198]",,253,305,558,0.0,0.0
b677fc3b-00d7-47aa-abc1-68b3c4d10fb7,7,47,"[151643, 151643, 151643, 151643, 151643, 151643, 151643, 151643, 151643, 151643, 151643, 151643, 151643, 151643, 151643, 151643, 151643, 151643, 151643, 151643, 151643, 151643, 151643, 151643, 151643, 151643, 151643, 151643, 151643, 151643, 151643, 151643, 151643, 151643, 151643, 151643, 151643, 151643, 151643, 151643, 151643, 151643, 151643, 151643, 151643, 151643, 151643, 151643, 151643, 151643, 151643, 151643, 151643, 151643, 151643, 151643, 151643, 151643, 151643, 151643, 151643, 151643, 151643, 151643, 151643, 151643, 151643, 151643, 151643, 151643, 151643, 151643, 151643, 151643, 151643, 151643, 151643, 151643, 151643, 151643, 151643, 151643, 151643, 151643, 151643, 151643, 151643, 151643, 151643, 151643, 151643, 151643, 151643, 151643, 151643, 151643, 151643, 151643, 151643, 151643, 151643, 151643, 151643, 151643, 151643, 151643, 151643, 151643, 151643, 151643, 151643, 151643, 151643, 151643, 151643, 151643, 151643, 151643, 151643, 151643, 151643, 151643, 151643, 151643, 151643, 151643, 151643, 151643, 151643, 151643, 151643, 151643, 151643, 151643, 151643, 151643, 151643, 151643, 151643, 151643, 151643, 151643, 151643, 151643, 151643, 151643, 151643, 151643, 151643, 151643, 151643, 151643, 151643, 151643, 151643, 151643, 151643, 151643, 151643, 151643, 151643, 151643, 151643, 151643, 151643, 151643, 151643, 151643, 151643, 151643, 151643, 151643, 151643, 151643, 151643, 151643, 151643, 151643, 151643, 151643, 151643, 151643, 151643, 151643, 151643, 151643, 151643, 151643, 151643, 151643, 151643, 151643, 151643, 151643, 151643, 151643, 151643, 151643, 151643, 151643, 151643, 151643, 151643, 151643, 151643, 151643, 151643, 151643, 151643, 151643, 151643, 151643, 151643, 151643, 151643, 151643, 151643, 151643, 151643, 151643, 151643, 151643, 151643, 151643, 151643, 151643, 151643, 151643, 151643, 151643, 151643, 151643, 151643, 151643, 151643, 151643, 151643, 151643, 151643, 151643, 151643, 151643, 151643, 151643, 151643, 151643, 151643, 151643, 151643, 151643, 151643, 151643, 151643, 151643, 151643, 151643, 151643, 151643, 151643, 151643, 151643, 151643, 151643, 151643, 151643, 151643, 151643, 151643, 151643, 151643, 151643, 151643, 151643, 151643, 151643, 151643, 151643, 151643, 151643, 151643, 151643, 151643, 151643, 151643, 151643, 151643, 151643, 151643, 151643, 151643, 151643, 151643, 151643, 151643, 151643, 151643, 151643, 151643, 151643, 151643, 151643, 151643, 151643, 151643, 151643, 151643, 151643, 151643, 151643, 151643, 151643, 151643, 151643, 151643, 151643, 151643, 151643, 151643, 151643, 151643, 151643, 151643, 151643, 151643, 151643, 151643, 151643, 151643, 151643, 151643, 151643, 151643, 151643, 151643, 151643, 151643, 151643, 151643, 151643, 151643, 151643, 151643, 151643, 151643, 151643, 151643, 151643, 151643, 151643, 151643, 151643, 151643, 151643, 151643, 151643, 151643, 151643, 151643, 151643, 151643, 151643, 151643, 151643, 151643, 151643, 151643, 151643, 151643, 151643, 151643, 151643, 151643, 151643, 151643, 151643, 151643, 151643, 151643, 151643, 151643, 151643, 151643, 151643, 151643, 151643, 151643, 151643, 151643, 151643, 151643, 151643, 151643, 151643, 151643, 151643, 151643, 151643, 151643, 151643, 151643, 151643, 151643, 151643, 151643, 151643, 151643, 151643, 151643, 151643, 151643, 151643, 151643, 151643, 151643, 151643, 151643, 151643, 151643, 151643, 151643, 151643, 151643, 151643, 151643, 151643, 151643, 151643, 151643, 151643, 151643, 151643, 151643, 151643, 151643, 151643, 151643, 151643, 151643, 151643, 151643, 151643, 151643, 151643, 151643, 151643, 151643, 151643, 151643, 151643, 151643, 151643, 151643, 151643, 151643, 151643, 151643, 151643, 151643, 151643, 151643, 151643, 151643, 151643, 151643, 151643, 151643, 151643, 151643, 151643, 151643, 151643, 151643, 151643, 151643, 151643, 151643, 151643, 151643, 151643, 151643, 151643, 151643, 151643, 151643, 151643, 151643, 151643, 151643, 151643, 151643, 151643, 151643, 151643, 151643, 151643, 151643, 151643, 151643, 151643, 151643, 151643, 151643, 151643, 151643, 151643, 151643, 151643, 151643, 151643, 151643, 151643, 151643, 151643, 151643, 151643, 151643, 151643, 151643, 151643, 151643, 151643, 151643, 151643, 151643, 151643, 151643, 151643, 151643, 151643, 151643, 151643, 151643, 151643, 151643, 151643, 151643, 151643, 151643, 151643, 151643, 151643, 151643, 151643, 151643, 151643, 151643, 151643, 151643, 151643, 151643, 151643, 151643, 151643, 151643, 151643, 151643, 151643, 151643, 151643, 151643, 151643, 151643, 151643, 151643, 151643, 151643, 151643, 151643, 151643, 151643, 151643, 151643, 151643, 151643, 151643, 151643, 151643, 151643, 151643, 151643, 151643, 151643, 151643, 151643, 151643, 151643, 151643, 151643, 151643, 151643, 151643, 151643, 151643, 151643, 151643, 151643, 151643, 151643, 151643, 151643, 151643, 151643, 151643, 151643, 151643, 151643, 151643, 151643, 151643, 151643, 151643, 151643, 151643, 151643, 151643, 151643, 151643, 151643, 151643, 151643, 151643, 151643, 151643, 151643, 151643, 151643, 151644, 8948, 198, 2610, 525, 1207, 16948, 11, 3465, 553, 54364, 14817, 13, 1446, 525, 264, 10950, 17847, 13, 151645, 198, 151644, 872, 198, 16141, 279, 2701, 5248, 5754, 3405, 13, 576, 1537, 1555, 315, 697, 2033, 1265, 387, 315, 279, 2701, 3561, 25, 364, 16141, 25, 400, 20756, 4198, 6, 320, 28996, 17194, 8, 1380, 44428, 374, 825, 315, 19360, 35, 13, 21149, 3019, 553, 3019, 1573, 35764, 382, 35, 56862, 525, 17356, 31146, 448, 1378, 23942, 1990, 26363, 304, 862, 5944, 11, 323, 807, 30224, 4911, 312, 7175, 4152, 311, 862, 63280, 657, 8938, 35981, 2248, 1849, 13, 2379, 1486, 264, 5089, 3476, 304, 17356, 29803, 323, 525, 6398, 304, 5257, 11483, 24473, 323, 5810, 11364, 624, 33610, 279, 2661, 2606, 892, 825, 374, 279, 3204, 13767, 517, 320, 32, 8, 369, 279, 2661, 12720, 1083, 6286, 279, 4396, 8500, 315, 279, 1853, 21649, 4092, 311, 862, 312, 7175, 320, 1429, 55463, 311, 3245, 55463, 8, 425, 624, 34, 3337, 385, 17308, 1952, 488, 362, 69726, 220, 23, 11, 23, 50289, 3127, 674, 2842, 32578, 58, 19, 13, 17, 13, 15, 60, 41692, 276, 12, 22, 18589, 198, 5349, 8, 220, 16, 13, 220, 17, 11, 18, 1737, 318, 41872, 8088, 64, 12, 16, 11, 18, 1737, 42568, 11, 220, 17, 13, 320, 17, 36, 11, 19, 36, 7287, 17308, 64, 12, 17, 11, 19, 1737, 42568, 11, 220, 18, 13, 43348, 22288, 16576, 12, 16, 11, 18, 1737, 42568, 11, 220, 19, 13, 320, 17, 57, 11, 19, 57, 7287, 17308, 64, 12, 17, 11, 19, 1737, 42568, 271, 32, 8, 362, 284, 220, 17, 11, 17, 50289, 3127, 78, 769, 268, 12, 16, 18589, 11, 425, 284, 220, 18, 11, 220, 16, 11, 220, 17, 11, 220, 19, 198, 33, 8, 362, 284, 220, 19, 11, 19, 50289, 3127, 509, 3337, 1684, 332, 12, 17, 20767, 12, 16, 18589, 11, 425, 284, 220, 19, 11, 220, 17, 11, 220, 16, 11, 220, 18, 198, 34, 8, 362, 284, 220, 19, 11, 19, 50289, 3127, 509, 3337, 1684, 332, 12, 17, 20767, 12, 16, 18589, 11, 425, 284, 220, 18, 11, 220, 16, 11, 220, 17, 11, 220, 19, 198, 35, 8, 362, 284, 220, 17, 11, 17, 50289, 3127, 78, 769, 268, 12, 16, 18589, 11, 425, 284, 220, 19, 11, 220, 17, 11, 220, 16, 11, 220, 18, 151645, 198, 151644, 77091, 198]",,398,581,979,0.0,0.0
7210c8ef-aed4-4d77-b308-42e36e6ce492,7,48,"[151643, 151643, 151643, 151643, 151643, 151643, 151643, 151643, 151643, 151643, 151643, 151643, 151643, 151643, 151643, 151643, 151643, 151643, 151643, 151643, 151643, 151643, 151643, 151643, 151643, 151643, 151643, 151643, 151643, 151643, 151643, 151643, 151643, 151643, 151643, 151643, 151643, 151643, 151643, 151643, 151643, 151643, 151643, 151643, 151643, 151643, 151643, 151643, 151643, 151643, 151643, 151643, 151643, 151643, 151643, 151643, 151643, 151643, 151643, 151643, 151643, 151643, 151643, 151643, 151643, 151643, 151643, 151643, 151643, 151643, 151643, 151643, 151643, 151643, 151643, 151643, 151643, 151643, 151643, 151643, 151643, 151643, 151643, 151643, 151643, 151643, 151643, 151643, 151643, 151643, 151643, 151643, 151643, 151643, 151643, 151643, 151643, 151643, 151643, 151643, 151643, 151643, 151643, 151643, 151643, 151643, 151643, 151643, 151643, 151643, 151643, 151643, 151643, 151643, 151643, 151643, 151643, 151643, 151643, 151643, 151643, 151643, 151643, 151643, 151643, 151643, 151643, 151643, 151643, 151643, 151643, 151643, 151643, 151643, 151643, 151643, 151643, 151643, 151643, 151643, 151643, 151643, 151643, 151643, 151643, 151643, 151643, 151643, 151643, 151643, 151643, 151643, 151643, 151643, 151643, 151643, 151643, 151643, 151643, 151643, 151643, 151643, 151643, 151643, 151643, 151643, 151643, 151643, 151643, 151643, 151643, 151643, 151643, 151643, 151643, 151643, 151643, 151643, 151643, 151643, 151643, 151643, 151643, 151643, 151643, 151643, 151643, 151643, 151643, 151643, 151643, 151643, 151643, 151643, 151643, 151643, 151643, 151643, 151643, 151643, 151643, 151643, 151643, 151643, 151643, 151643, 151643, 151643, 151643, 151643, 151643, 151643, 151643, 151643, 151643, 151643, 151643, 151643, 151643, 151643, 151643, 151643, 151643, 151643, 151643, 151643, 151643, 151643, 151643, 151643, 151643, 151643, 151643, 151643, 151643, 151643, 151643, 151643, 151643, 151643, 151643, 151643, 151643, 151643, 151643, 151643, 151643, 151643, 151643, 151643, 151643, 151643, 151643, 151643, 151643, 151643, 151643, 151643, 151643, 151643, 151643, 151643, 151643, 151643, 151643, 151643, 151643, 151643, 151643, 151643, 151643, 151643, 151643, 151643, 151643, 151643, 151643, 151643, 151643, 151643, 151643, 151643, 151643, 151643, 151643, 151643, 151643, 151643, 151643, 151643, 151643, 151643, 151643, 151643, 151643, 151643, 151643, 151643, 151643, 151643, 151643, 151643, 151643, 151643, 151643, 151643, 151643, 151643, 151643, 151643, 151643, 151643, 151643, 151643, 151643, 151643, 151643, 151643, 151643, 151643, 151643, 151643, 151643, 151643, 151643, 151643, 151643, 151643, 151643, 151643, 151643, 151643, 151643, 151643, 151643, 151643, 151643, 151643, 151643, 151643, 151643, 151643, 151643, 151643, 151643, 151643, 151643, 151643, 151643, 151643, 151643, 151643, 151643, 151643, 151643, 151643, 151643, 151643, 151643, 151643, 151643, 151643, 151643, 151643, 151643, 151643, 151643, 151643, 151643, 151643, 151643, 151643, 151643, 151643, 151643, 151643, 151643, 151643, 151643, 151643, 151643, 151643, 151643, 151643, 151643, 151643, 151643, 151643, 151643, 151643, 151643, 151643, 151643, 151643, 151643, 151643, 151643, 151643, 151643, 151643, 151643, 151643, 151643, 151643, 151643, 151643, 151643, 151643, 151643, 151643, 151643, 151643, 151643, 151643, 151643, 151643, 151643, 151643, 151643, 151643, 151643, 151643, 151643, 151643, 151643, 151643, 151643, 151643, 151643, 151643, 151643, 151643, 151643, 151643, 151643, 151643, 151643, 151643, 151643, 151643, 151643, 151643, 151643, 151643, 151643, 151643, 151643, 151643, 151643, 151643, 151643, 151643, 151643, 151643, 151643, 151643, 151643, 151643, 151643, 151643, 151643, 151643, 151643, 151643, 151643, 151643, 151643, 151643, 151643, 151643, 151643, 151643, 151643, 151643, 151643, 151643, 151643, 151643, 151643, 151643, 151643, 151643, 151643, 151643, 151643, 151643, 151643, 151643, 151643, 151643, 151643, 151643, 151643, 151643, 151643, 151643, 151643, 151643, 151643, 151643, 151643, 151643, 151643, 151643, 151643, 151643, 151643, 151643, 151643, 151643, 151643, 151643, 151643, 151643, 151643, 151643, 151643, 151643, 151643, 151643, 151643, 151643, 151643, 151643, 151643, 151643, 151643, 151643, 151643, 151643, 151643, 151643, 151643, 151643, 151643, 151643, 151643, 151643, 151643, 151643, 151643, 151643, 151643, 151643, 151643, 151643, 151643, 151643, 151643, 151643, 151643, 151643, 151643, 151643, 151643, 151643, 151643, 151643, 151643, 151643, 151643, 151643, 151643, 151643, 151643, 151643, 151643, 151643, 151643, 151643, 151643, 151643, 151643, 151643, 151643, 151643, 151643, 151643, 151643, 151643, 151643, 151643, 151643, 151643, 151643, 151643, 151643, 151643, 151643, 151643, 151643, 151643, 151643, 151643, 151643, 151643, 151643, 151643, 151643, 151643, 151643, 151643, 151643, 151643, 151643, 151643, 151643, 151643, 151643, 151643, 151643, 151644, 8948, 198, 2610, 525, 1207, 16948, 11, 3465, 553, 54364, 14817, 13, 1446, 525, 264, 10950, 17847, 13, 151645, 198, 151644, 872, 198, 16141, 279, 2701, 5248, 5754, 3405, 13, 576, 1537, 1555, 315, 697, 2033, 1265, 387, 315, 279, 2701, 3561, 25, 364, 16141, 25, 400, 20756, 4198, 6, 320, 28996, 17194, 8, 1380, 44428, 374, 825, 315, 19360, 35, 13, 21149, 3019, 553, 3019, 1573, 35764, 382, 641, 458, 9342, 11, 23628, 1599, 320, 34, 16, 16, 39, 16, 17, 46, 8, 572, 37026, 311, 264, 12720, 448, 220, 16, 11, 19, 1737, 26975, 370, 2842, 32578, 58, 17, 13, 17, 13, 17, 60, 41692, 2145, 304, 2477, 79, 7417, 68896, 518, 264, 9315, 315, 220, 19, 15, 18, 730, 369, 264, 8090, 315, 220, 16, 1899, 13, 576, 31787, 220, 16, 39, 11250, 18446, 323, 220, 16, 18, 34, 11250, 18446, 62597, 315, 279, 12942, 1985, 16400, 279, 2701, 8286, 12624, 624, 16, 39, 451, 18446, 25, 69334, 220, 17, 13, 17, 23, 320, 18, 39, 11, 274, 701, 220, 17, 13, 18, 16, 320, 18, 39, 11, 274, 701, 220, 21, 13, 22, 20, 320, 16, 39, 11, 294, 701, 220, 22, 13, 15, 23, 320, 17, 39, 11, 294, 701, 220, 22, 13, 21, 23, 320, 16, 39, 11, 294, 701, 220, 22, 13, 22, 16, 320, 17, 39, 11, 294, 4292, 16, 18, 34, 451, 18446, 25, 69334, 220, 17, 16, 13, 18, 320, 16, 34, 11, 274, 701, 220, 17, 23, 13, 19, 320, 16, 34, 11, 274, 701, 220, 16, 17, 21, 13, 24, 320, 17, 34, 11, 274, 701, 220, 16, 17, 22, 13, 16, 320, 16, 34, 11, 274, 701, 220, 16, 17, 24, 13, 16, 320, 17, 34, 11, 274, 701, 220, 16, 18, 15, 13, 18, 320, 16, 34, 11, 274, 701, 220, 16, 19, 16, 13, 20, 320, 16, 34, 11, 274, 701, 220, 16, 19, 19, 13, 16, 320, 16, 34, 11, 274, 701, 220, 16, 24, 22, 13, 22, 320, 16, 34, 11, 274, 4292, 28301, 1437, 61572, 1599, 382, 32, 8, 220, 17, 1448, 41872, 12, 18, 5477, 88, 884, 55728, 404, 2145, 198, 33, 8, 220, 17, 5477, 88, 884, 62967, 54089, 198, 34, 8, 220, 17, 8013, 19, 1448, 41872, 78755, 884, 75, 8, 5131, 404, 2145, 198, 35, 8, 220, 17, 8013, 16, 12, 14769, 3923, 2674, 12, 16, 20767, 12, 17, 12, 3923, 8, 5131, 404, 2145, 151645, 198, 151644, 77091, 198]",,413,583,996,1.0,1.0
c3df3c9e-a5ab-4e2b-9556-ca52e4c0c00e,7,49,"[151643, 151643, 151643, 151643, 151643, 151643, 151643, 151643, 151643, 151643, 151643, 151643, 151643, 151643, 151643, 151643, 151643, 151643, 151643, 151643, 151643, 151643, 151643, 151643, 151643, 151643, 151643, 151643, 151643, 151643, 151643, 151643, 151643, 151643, 151643, 151643, 151643, 151643, 151643, 151643, 151643, 151643, 151643, 151643, 151643, 151643, 151643, 151643, 151643, 151643, 151643, 151643, 151643, 151643, 151643, 151643, 151643, 151643, 151643, 151643, 151643, 151643, 151643, 151643, 151643, 151643, 151643, 151643, 151643, 151643, 151643, 151643, 151643, 151643, 151643, 151643, 151643, 151643, 151643, 151643, 151643, 151643, 151643, 151643, 151643, 151643, 151643, 151643, 151643, 151643, 151643, 151643, 151643, 151643, 151643, 151643, 151643, 151643, 151643, 151643, 151643, 151643, 151643, 151643, 151643, 151643, 151643, 151643, 151643, 151643, 151643, 151643, 151643, 151643, 151643, 151643, 151643, 151643, 151643, 151643, 151643, 151643, 151643, 151643, 151643, 151643, 151643, 151643, 151643, 151643, 151643, 151643, 151643, 151643, 151643, 151643, 151643, 151643, 151643, 151643, 151643, 151643, 151643, 151643, 151643, 151643, 151643, 151643, 151643, 151643, 151643, 151643, 151643, 151643, 151643, 151643, 151643, 151643, 151643, 151643, 151643, 151643, 151643, 151643, 151643, 151643, 151643, 151643, 151643, 151643, 151643, 151643, 151643, 151643, 151643, 151643, 151643, 151643, 151643, 151643, 151643, 151643, 151643, 151643, 151643, 151643, 151643, 151643, 151643, 151643, 151643, 151643, 151643, 151643, 151643, 151643, 151643, 151643, 151643, 151643, 151643, 151643, 151643, 151643, 151643, 151643, 151643, 151643, 151643, 151643, 151643, 151643, 151643, 151643, 151643, 151643, 151643, 151643, 151643, 151643, 151643, 151643, 151643, 151643, 151643, 151643, 151643, 151643, 151643, 151643, 151643, 151643, 151643, 151643, 151643, 151643, 151643, 151643, 151643, 151643, 151643, 151643, 151643, 151643, 151643, 151643, 151643, 151643, 151643, 151643, 151643, 151643, 151643, 151643, 151643, 151643, 151643, 151643, 151643, 151643, 151643, 151643, 151643, 151643, 151643, 151643, 151643, 151643, 151643, 151643, 151643, 151643, 151643, 151643, 151643, 151643, 151643, 151643, 151643, 151643, 151643, 151643, 151643, 151643, 151643, 151643, 151643, 151643, 151643, 151643, 151643, 151643, 151643, 151643, 151643, 151643, 151643, 151643, 151643, 151643, 151643, 151643, 151643, 151643, 151643, 151643, 151643, 151643, 151643, 151643, 151643, 151643, 151643, 151643, 151643, 151643, 151643, 151643, 151643, 151643, 151643, 151643, 151643, 151643, 151643, 151643, 151643, 151643, 151643, 151643, 151643, 151643, 151643, 151643, 151643, 151643, 151643, 151643, 151643, 151643, 151643, 151643, 151643, 151643, 151643, 151643, 151643, 151643, 151643, 151643, 151643, 151643, 151643, 151643, 151643, 151643, 151643, 151643, 151643, 151643, 151643, 151643, 151643, 151643, 151643, 151643, 151643, 151643, 151643, 151643, 151643, 151643, 151643, 151643, 151643, 151643, 151643, 151643, 151643, 151643, 151643, 151643, 151643, 151643, 151643, 151643, 151643, 151643, 151643, 151643, 151643, 151643, 151643, 151643, 151643, 151643, 151643, 151643, 151643, 151643, 151643, 151643, 151643, 151643, 151643, 151643, 151643, 151643, 151643, 151643, 151643, 151643, 151643, 151643, 151643, 151643, 151643, 151643, 151643, 151643, 151643, 151643, 151643, 151643, 151643, 151643, 151643, 151643, 151643, 151643, 151643, 151643, 151643, 151643, 151643, 151643, 151643, 151643, 151643, 151643, 151643, 151643, 151643, 151643, 151643, 151643, 151643, 151643, 151643, 151643, 151643, 151643, 151643, 151643, 151643, 151643, 151643, 151643, 151643, 151643, 151643, 151643, 151643, 151643, 151643, 151643, 151643, 151643, 151643, 151643, 151643, 151643, 151643, 151643, 151643, 151643, 151643, 151643, 151643, 151643, 151643, 151643, 151643, 151643, 151643, 151643, 151643, 151643, 151643, 151643, 151643, 151643, 151643, 151643, 151643, 151643, 151643, 151643, 151643, 151643, 151643, 151643, 151643, 151643, 151643, 151643, 151643, 151643, 151643, 151643, 151643, 151643, 151643, 151643, 151643, 151643, 151643, 151643, 151643, 151643, 151643, 151643, 151643, 151643, 151643, 151643, 151643, 151643, 151643, 151643, 151643, 151643, 151643, 151643, 151643, 151643, 151643, 151643, 151643, 151643, 151643, 151643, 151643, 151643, 151643, 151643, 151643, 151643, 151643, 151643, 151643, 151643, 151643, 151643, 151643, 151643, 151643, 151643, 151643, 151643, 151643, 151643, 151643, 151643, 151643, 151643, 151643, 151643, 151643, 151643, 151643, 151643, 151643, 151643, 151643, 151643, 151643, 151643, 151643, 151643, 151643, 151643, 151643, 151643, 151643, 151643, 151643, 151643, 151643, 151643, 151643, 151643, 151643, 151643, 151643, 151643, 151643, 151643, 151643, 151643, 151643, 151643, 151643, 151643, 151643, 151643, 151643, 151643, 151643, 151643, 151643, 151643, 151643, 151643, 151643, 151643, 151643, 151643, 151643, 151643, 151643, 151643, 151643, 151643, 151643, 151643, 151643, 151643, 151643, 151643, 151643, 151643, 151643, 151643, 151643, 151643, 151643, 151643, 151643, 151643, 151643, 151643, 151643, 151643, 151643, 151643, 151643, 151643, 151643, 151643, 151643, 151643, 151643, 151643, 151643, 151643, 151643, 151643, 151643, 151643, 151643, 151643, 151643, 151643, 151643, 151643, 151643, 151643, 151643, 151643, 151643, 151643, 151643, 151643, 151643, 151643, 151643, 151643, 151643, 151643, 151643, 151643, 151643, 151643, 151643, 151643, 151643, 151643, 151643, 151643, 151643, 151643, 151643, 151643, 151643, 151643, 151643, 151643, 151643, 151643, 151643, 151643, 151643, 151643, 151643, 151643, 151643, 151643, 151643, 151643, 151643, 151643, 151643, 151643, 151643, 151643, 151643, 151643, 151643, 151643, 151643, 151643, 151643, 151643, 151643, 151643, 151643, 151643, 151643, 151643, 151643, 151643, 151643, 151643, 151643, 151643, 151643, 151643, 151643, 151643, 151643, 151643, 151643, 151643, 151643, 151643, 151643, 151643, 151643, 151643, 151643, 151643, 151643, 151643, 151643, 151643, 151643, 151643, 151643, 151643, 151643, 151643, 151643, 151643, 151643, 151643, 151643, 151643, 151643, 151643, 151643, 151643, 151643, 151643, 151643, 151643, 151643, 151643, 151643, 151643, 151643, 151643, 151643, 151643, 151643, 151643, 151643, 151643, 151643, 151643, 151643, 151643, 151643, 151643, 151643, 151643, 151643, 151643, 151643, 151643, 151643, 151643, 151643, 151643, 151643, 151643, 151643, 151643, 151643, 151643, 151643, 151643, 151643, 151643, 151643, 151643, 151643, 151643, 151643, 151643, 151643, 151643, 151643, 151643, 151643, 151643, 151643, 151643, 151643, 151643, 151643, 151643, 151643, 151643, 151643, 151643, 151643, 151643, 151643, 151643, 151643, 151643, 151643, 151643, 151643, 151643, 151643, 151643, 151643, 151643, 151643, 151643, 151643, 151643, 151643, 151643, 151643, 151643, 151643, 151643, 151643, 151643, 151643, 151644, 8948, 198, 2610, 525, 1207, 16948, 11, 3465, 553, 54364, 14817, 13, 1446, 525, 264, 10950, 17847, 13, 151645, 198, 151644, 872, 198, 16141, 279, 2701, 5248, 5754, 3405, 13, 576, 1537, 1555, 315, 697, 2033, 1265, 387, 315, 279, 2701, 3561, 25, 364, 16141, 25, 400, 20756, 4198, 6, 320, 28996, 17194, 8, 1380, 44428, 374, 825, 315, 19360, 35, 13, 21149, 3019, 553, 3019, 1573, 35764, 382, 20576, 84, 1952, 374, 11758, 448, 24691, 2216, 13621, 323, 71491, 292, 13621, 11, 29064, 1985, 220, 16, 382, 16, 374, 11758, 448, 56731, 46, 17, 323, 472, 17, 13880, 19, 11, 29064, 1985, 220, 17, 382, 17, 374, 11758, 448, 64702, 603, 323, 65200, 782, 38595, 16643, 87, 577, 11, 29064, 1985, 220, 18, 382, 12555, 374, 279, 30106, 45120, 1874, 315, 220, 18, 1939, 32, 8, 294, 17, 71, 198, 33, 8, 10532, 198, 34, 8, 272, 18, 198, 35, 8, 272, 17, 71, 151645, 198, 151644, 77091, 198]",,161,491,652,1.0,1.0
bf0fb9bd-5410-4bea-8f6b-e35980fa8edc,7,50,"[151643, 151643, 151643, 151643, 151643, 151643, 151643, 151643, 151643, 151643, 151643, 151643, 151643, 151643, 151643, 151643, 151643, 151643, 151643, 151643, 151643, 151643, 151643, 151643, 151643, 151643, 151643, 151643, 151643, 151643, 151643, 151643, 151643, 151643, 151643, 151643, 151643, 151643, 151643, 151643, 151643, 151643, 151643, 151643, 151643, 151643, 151643, 151643, 151643, 151643, 151643, 151643, 151643, 151643, 151643, 151643, 151643, 151643, 151643, 151643, 151643, 151643, 151643, 151643, 151643, 151643, 151643, 151643, 151643, 151643, 151643, 151643, 151643, 151643, 151643, 151643, 151643, 151643, 151643, 151643, 151643, 151643, 151643, 151643, 151643, 151643, 151643, 151643, 151643, 151643, 151643, 151643, 151643, 151643, 151643, 151643, 151643, 151643, 151643, 151643, 151643, 151643, 151643, 151643, 151643, 151643, 151643, 151643, 151643, 151643, 151643, 151643, 151643, 151643, 151643, 151643, 151643, 151643, 151643, 151643, 151643, 151643, 151643, 151643, 151643, 151643, 151643, 151643, 151643, 151643, 151643, 151643, 151643, 151643, 151643, 151643, 151643, 151643, 151643, 151643, 151643, 151643, 151643, 151643, 151643, 151643, 151643, 151643, 151643, 151643, 151643, 151643, 151643, 151643, 151643, 151643, 151643, 151643, 151643, 151643, 151643, 151643, 151643, 151643, 151643, 151643, 151643, 151643, 151643, 151643, 151643, 151643, 151643, 151643, 151643, 151643, 151643, 151643, 151643, 151643, 151643, 151643, 151643, 151643, 151643, 151643, 151643, 151643, 151643, 151643, 151643, 151643, 151643, 151643, 151643, 151643, 151643, 151643, 151643, 151643, 151643, 151643, 151643, 151643, 151643, 151643, 151643, 151643, 151643, 151643, 151643, 151643, 151643, 151643, 151643, 151643, 151643, 151643, 151643, 151643, 151643, 151643, 151643, 151643, 151643, 151643, 151643, 151643, 151643, 151643, 151643, 151643, 151643, 151643, 151643, 151643, 151643, 151643, 151643, 151643, 151643, 151643, 151643, 151643, 151643, 151643, 151643, 151643, 151643, 151643, 151643, 151643, 151643, 151643, 151643, 151643, 151643, 151643, 151643, 151643, 151643, 151643, 151643, 151643, 151643, 151643, 151643, 151643, 151643, 151643, 151643, 151643, 151643, 151643, 151643, 151643, 151643, 151643, 151643, 151643, 151643, 151643, 151643, 151643, 151643, 151643, 151643, 151643, 151643, 151643, 151643, 151643, 151643, 151643, 151643, 151643, 151643, 151643, 151643, 151643, 151643, 151643, 151643, 151643, 151643, 151643, 151643, 151643, 151643, 151643, 151643, 151643, 151643, 151643, 151643, 151643, 151643, 151643, 151643, 151643, 151643, 151643, 151643, 151643, 151643, 151643, 151643, 151643, 151643, 151643, 151643, 151643, 151643, 151643, 151643, 151643, 151643, 151643, 151643, 151643, 151643, 151643, 151643, 151643, 151643, 151643, 151643, 151643, 151643, 151643, 151643, 151643, 151643, 151643, 151643, 151643, 151643, 151643, 151643, 151643, 151643, 151643, 151643, 151643, 151643, 151643, 151643, 151643, 151643, 151643, 151643, 151643, 151643, 151643, 151643, 151643, 151643, 151643, 151643, 151643, 151643, 151643, 151643, 151643, 151643, 151643, 151643, 151643, 151643, 151643, 151643, 151643, 151643, 151643, 151643, 151643, 151643, 151643, 151643, 151643, 151643, 151643, 151643, 151643, 151643, 151643, 151643, 151643, 151643, 151643, 151643, 151643, 151643, 151643, 151643, 151643, 151643, 151643, 151643, 151643, 151643, 151643, 151643, 151643, 151643, 151643, 151643, 151643, 151643, 151643, 151643, 151643, 151643, 151643, 151643, 151643, 151643, 151643, 151643, 151643, 151643, 151643, 151643, 151643, 151643, 151643, 151643, 151643, 151643, 151643, 151643, 151643, 151643, 151643, 151643, 151643, 151643, 151643, 151643, 151643, 151643, 151643, 151643, 151643, 151643, 151643, 151643, 151643, 151643, 151643, 151643, 151643, 151643, 151643, 151643, 151643, 151643, 151643, 151643, 151643, 151643, 151643, 151643, 151643, 151643, 151643, 151643, 151643, 151643, 151643, 151643, 151643, 151643, 151643, 151643, 151643, 151643, 151643, 151643, 151643, 151643, 151643, 151643, 151643, 151643, 151643, 151643, 151643, 151643, 151643, 151643, 151643, 151643, 151643, 151643, 151643, 151643, 151643, 151643, 151643, 151643, 151643, 151643, 151643, 151643, 151643, 151643, 151643, 151643, 151643, 151643, 151643, 151643, 151643, 151643, 151643, 151643, 151643, 151643, 151643, 151643, 151643, 151643, 151643, 151643, 151643, 151643, 151643, 151643, 151643, 151643, 151643, 151643, 151643, 151643, 151643, 151643, 151643, 151643, 151643, 151643, 151643, 151643, 151643, 151643, 151643, 151643, 151643, 151643, 151643, 151643, 151643, 151643, 151643, 151643, 151643, 151643, 151643, 151643, 151643, 151643, 151643, 151643, 151643, 151643, 151643, 151643, 151643, 151643, 151643, 151643, 151643, 151643, 151643, 151643, 151643, 151643, 151643, 151643, 151643, 151643, 151643, 151643, 151643, 151643, 151643, 151643, 151643, 151643, 151643, 151643, 151643, 151643, 151643, 151643, 151643, 151643, 151643, 151643, 151643, 151643, 151643, 151643, 151643, 151643, 151643, 151643, 151643, 151643, 151643, 151643, 151643, 151643, 151643, 151643, 151643, 151643, 151643, 151643, 151643, 151643, 151643, 151643, 151643, 151643, 151643, 151643, 151643, 151643, 151643, 151643, 151643, 151643, 151643, 151643, 151643, 151643, 151643, 151643, 151643, 151643, 151643, 151643, 151643, 151643, 151643, 151643, 151643, 151643, 151643, 151643, 151643, 151643, 151643, 151643, 151643, 151643, 151643, 151643, 151643, 151643, 151643, 151643, 151643, 151643, 151644, 8948, 198, 2610, 525, 1207, 16948, 11, 3465, 553, 54364, 14817, 13, 1446, 525, 264, 10950, 17847, 13, 151645, 198, 151644, 872, 198, 16141, 279, 2701, 5248, 5754, 3405, 13, 576, 1537, 1555, 315, 697, 2033, 1265, 387, 315, 279, 2701, 3561, 25, 364, 16141, 25, 400, 20756, 4198, 6, 320, 28996, 17194, 8, 1380, 44428, 374, 825, 315, 19360, 35, 13, 21149, 3019, 553, 3019, 1573, 35764, 382, 32, 384, 3101, 658, 14212, 2779, 27895, 264, 16953, 311, 2484, 8978, 441, 42843, 4752, 10010, 1119, 4802, 13, 576, 1882, 13666, 304, 53942, 4204, 11, 892, 525, 34593, 4802, 34059, 13, 758, 279, 4013, 315, 2518, 5131, 24473, 11, 279, 4802, 504, 3607, 374, 9768, 1948, 279, 78006, 5203, 323, 1483, 438, 264, 20178, 34593, 11413, 13, 576, 4802, 2852, 21140, 34615, 525, 9311, 83, 832, 700, 315, 279, 53942, 81, 290, 311, 8683, 304, 678, 34593, 11364, 13, 1446, 11105, 264, 501, 7147, 50289, 16231, 5506, 323, 1366, 311, 19314, 3425, 432, 702, 458, 2456, 389, 279, 53942, 4204, 13, 1446, 738, 705, 264, 2088, 315, 21204, 448, 697, 11685, 42, 17, 24, 18, 2779, 1555, 13, 15920, 315, 279, 21204, 10007, 3685, 686, 537, 1492, 498, 6997, 279, 70961, 3476, 315, 697, 5506, 1447, 32, 8, 98736, 73082, 768, 367, 32189, 315, 53942, 4204, 8110, 553, 279, 8280, 93597, 547, 417, 726, 3478, 318, 16340, 2688, 352, 20951, 198, 33, 8, 53652, 315, 7761, 448, 37201, 6863, 517, 25927, 11437, 519, 323, 44958, 20408, 5290, 1283, 220, 20, 32883, 44, 315, 25927, 11437, 258, 5256, 311, 279, 38787, 266, 517, 198, 34, 8, 14974, 3683, 96232, 91814, 1283, 386, 6357, 10911, 4239, 87796, 315, 279, 7761, 198, 35, 8, 22452, 78809, 6988, 1283, 54302, 448, 220, 17, 13, 20, 32883, 44, 220, 20, 11, 20, 516, 21, 11, 21, 24293, 51, 17366, 610, 9566, 78, 12, 16, 11, 16, 516, 18, 11, 220, 18, 24293, 72442, 956, 41872, 7964, 89, 98494, 1370, 337, 3923, 6918, 65, 509, 8339, 482, 78987, 577, 151645, 198, 151644, 77091, 198]",,339,413,752,0.0,0.0
7e48c4f1-9839-4224-8174-a8507dcc0393,7,51,"[151643, 151643, 151643, 151643, 151643, 151643, 151643, 151643, 151643, 151643, 151643, 151643, 151643, 151643, 151643, 151643, 151643, 151643, 151643, 151643, 151643, 151643, 151643, 151643, 151643, 151643, 151643, 151643, 151643, 151643, 151643, 151643, 151643, 151643, 151643, 151643, 151643, 151643, 151643, 151643, 151643, 151643, 151643, 151643, 151643, 151643, 151643, 151643, 151643, 151643, 151643, 151643, 151643, 151643, 151643, 151643, 151643, 151643, 151643, 151643, 151643, 151643, 151643, 151643, 151643, 151643, 151643, 151643, 151643, 151643, 151643, 151643, 151643, 151643, 151643, 151643, 151643, 151643, 151643, 151643, 151643, 151643, 151643, 151643, 151643, 151643, 151643, 151643, 151643, 151643, 151643, 151643, 151643, 151643, 151643, 151643, 151643, 151643, 151643, 151643, 151643, 151643, 151643, 151643, 151643, 151643, 151643, 151643, 151643, 151643, 151643, 151643, 151643, 151643, 151643, 151643, 151643, 151643, 151643, 151643, 151643, 151643, 151643, 151643, 151643, 151643, 151643, 151643, 151643, 151643, 151643, 151643, 151643, 151643, 151643, 151643, 151643, 151643, 151643, 151643, 151643, 151643, 151643, 151643, 151643, 151643, 151643, 151643, 151643, 151643, 151643, 151643, 151643, 151643, 151643, 151643, 151643, 151643, 151643, 151643, 151643, 151643, 151643, 151643, 151643, 151643, 151643, 151643, 151643, 151643, 151643, 151643, 151643, 151643, 151643, 151643, 151643, 151643, 151643, 151643, 151643, 151643, 151643, 151643, 151643, 151643, 151643, 151643, 151643, 151643, 151643, 151643, 151643, 151643, 151643, 151643, 151643, 151643, 151643, 151643, 151643, 151643, 151643, 151643, 151643, 151643, 151643, 151643, 151643, 151643, 151643, 151643, 151643, 151643, 151643, 151643, 151643, 151643, 151643, 151643, 151643, 151643, 151643, 151643, 151643, 151643, 151643, 151643, 151643, 151643, 151643, 151643, 151643, 151643, 151643, 151643, 151643, 151643, 151643, 151643, 151643, 151643, 151643, 151643, 151643, 151643, 151643, 151643, 151643, 151643, 151643, 151643, 151643, 151643, 151643, 151643, 151643, 151643, 151643, 151643, 151643, 151643, 151643, 151643, 151643, 151643, 151643, 151643, 151643, 151643, 151643, 151643, 151643, 151643, 151643, 151643, 151643, 151643, 151643, 151643, 151643, 151643, 151643, 151643, 151643, 151643, 151643, 151643, 151643, 151643, 151643, 151643, 151643, 151643, 151643, 151643, 151643, 151643, 151643, 151643, 151643, 151643, 151643, 151643, 151643, 151643, 151643, 151643, 151643, 151643, 151643, 151643, 151643, 151643, 151643, 151643, 151643, 151643, 151643, 151643, 151643, 151643, 151643, 151643, 151643, 151643, 151643, 151643, 151643, 151643, 151643, 151643, 151643, 151643, 151643, 151643, 151643, 151643, 151643, 151643, 151643, 151643, 151643, 151643, 151643, 151643, 151643, 151643, 151643, 151643, 151643, 151643, 151643, 151643, 151643, 151643, 151643, 151643, 151643, 151643, 151643, 151643, 151643, 151643, 151643, 151643, 151643, 151643, 151643, 151643, 151643, 151643, 151643, 151643, 151643, 151643, 151643, 151643, 151643, 151643, 151643, 151643, 151643, 151643, 151643, 151643, 151643, 151643, 151643, 151643, 151643, 151643, 151643, 151643, 151643, 151643, 151643, 151643, 151643, 151643, 151643, 151643, 151643, 151643, 151643, 151643, 151643, 151643, 151643, 151643, 151643, 151643, 151643, 151643, 151643, 151643, 151643, 151643, 151643, 151643, 151643, 151643, 151643, 151643, 151643, 151643, 151643, 151643, 151643, 151643, 151643, 151643, 151643, 151643, 151643, 151643, 151643, 151643, 151643, 151643, 151643, 151643, 151643, 151643, 151643, 151643, 151643, 151643, 151643, 151643, 151643, 151643, 151643, 151643, 151643, 151643, 151643, 151643, 151643, 151643, 151643, 151643, 151643, 151643, 151643, 151643, 151643, 151643, 151643, 151643, 151643, 151643, 151643, 151643, 151643, 151643, 151643, 151643, 151643, 151643, 151643, 151643, 151643, 151643, 151643, 151643, 151643, 151643, 151643, 151643, 151643, 151643, 151643, 151643, 151643, 151643, 151643, 151643, 151643, 151643, 151643, 151643, 151643, 151643, 151643, 151643, 151643, 151643, 151643, 151643, 151643, 151643, 151643, 151643, 151643, 151643, 151643, 151643, 151643, 151643, 151643, 151643, 151643, 151643, 151643, 151643, 151643, 151643, 151643, 151643, 151643, 151643, 151643, 151643, 151643, 151643, 151643, 151643, 151643, 151643, 151643, 151643, 151643, 151643, 151643, 151643, 151643, 151643, 151643, 151643, 151643, 151643, 151643, 151643, 151643, 151643, 151643, 151643, 151643, 151643, 151643, 151643, 151643, 151643, 151643, 151643, 151643, 151643, 151643, 151643, 151643, 151643, 151643, 151643, 151643, 151643, 151643, 151643, 151643, 151643, 151643, 151643, 151643, 151643, 151643, 151643, 151643, 151643, 151643, 151643, 151643, 151643, 151643, 151643, 151643, 151643, 151643, 151643, 151643, 151643, 151643, 151643, 151643, 151643, 151643, 151643, 151643, 151643, 151643, 151643, 151643, 151643, 151643, 151643, 151643, 151643, 151643, 151643, 151643, 151643, 151643, 151643, 151643, 151643, 151643, 151643, 151643, 151643, 151643, 151643, 151643, 151643, 151643, 151643, 151643, 151643, 151643, 151643, 151643, 151643, 151643, 151643, 151643, 151643, 151643, 151643, 151643, 151643, 151643, 151643, 151643, 151643, 151643, 151643, 151643, 151643, 151643, 151643, 151643, 151643, 151643, 151643, 151643, 151644, 8948, 198, 2610, 525, 1207, 16948, 11, 3465, 553, 54364, 14817, 13, 1446, 525, 264, 10950, 17847, 13, 151645, 198, 151644, 872, 198, 16141, 279, 2701, 5248, 5754, 3405, 13, 576, 1537, 1555, 315, 697, 2033, 1265, 387, 315, 279, 2701, 3561, 25, 364, 16141, 25, 400, 20756, 4198, 6, 320, 28996, 17194, 8, 1380, 44428, 374, 825, 315, 19360, 35, 13, 21149, 3019, 553, 3019, 1573, 35764, 382, 32, 8424, 380, 10660, 1378, 24473, 553, 4633, 1378, 9788, 31146, 323, 11758, 1105, 25156, 448, 1378, 2155, 17719, 13009, 13, 8427, 279, 6169, 5916, 3684, 369, 2176, 315, 279, 24473, 624, 32, 488, 14511, 97151, 19, 488, 472, 10, 69726, 320, 49, 7287, 19, 12, 41872, 72442, 956, 66129, 12, 17, 39, 2268, 88, 6576, 12, 17, 18589, 198, 33, 488, 67747, 18, 488, 472, 10, 69726, 320, 50, 7287, 19, 12, 41872, 72442, 956, 66129, 12, 17, 39, 2268, 88, 6576, 12, 17, 18589, 271, 32, 8, 362, 284, 320, 49, 7287, 18, 12, 41872, 12, 20, 30430, 674, 1535, 4130, 12, 20, 12, 5131, 453, 306, 5652, 292, 13621, 11, 425, 284, 320, 50, 7287, 18, 12, 41872, 12, 20, 30430, 674, 1535, 4130, 12, 20, 12, 5131, 453, 306, 5652, 292, 13621, 198, 33, 8, 362, 284, 320, 50, 7287, 18, 12, 41872, 12, 20, 30430, 674, 1535, 4130, 12, 20, 12, 5131, 453, 306, 5652, 292, 13621, 11, 425, 284, 320, 49, 7287, 18, 12, 41872, 12, 20, 30430, 674, 1535, 4130, 12, 20, 12, 5131, 453, 306, 5652, 292, 13621, 198, 34, 8, 362, 284, 320, 49, 7287, 18, 12, 41872, 12, 20, 30430, 674, 1535, 4130, 12, 20, 12, 5131, 453, 306, 5652, 292, 13621, 1154, 425, 284, 320, 49, 7287, 18, 12, 41872, 12, 20, 30430, 674, 1535, 4130, 12, 20, 12, 5131, 453, 306, 5652, 292, 13621, 198, 35, 8, 362, 284, 320, 50, 7287, 18, 12, 41872, 12, 20, 30430, 674, 1535, 4130, 12, 20, 12, 5131, 453, 306, 5652, 292, 13621, 1154, 425, 284, 320, 50, 7287, 18, 12, 41872, 12, 20, 30430, 674, 1535, 4130, 12, 20, 12, 5131, 453, 306, 5652, 292, 13621, 151645, 198, 151644, 77091, 198]",,361,606,967,0.0,0.0
54bb4dbf-dc14-48a2-b7c2-cca5dba2a00e,7,52,"[151643, 151643, 151643, 151643, 151643, 151643, 151643, 151643, 151643, 151643, 151643, 151643, 151643, 151643, 151643, 151643, 151643, 151643, 151643, 151643, 151643, 151643, 151643, 151643, 151643, 151643, 151643, 151643, 151643, 151643, 151643, 151643, 151643, 151643, 151643, 151643, 151643, 151643, 151643, 151643, 151643, 151643, 151643, 151643, 151643, 151643, 151643, 151643, 151643, 151643, 151643, 151643, 151643, 151643, 151643, 151643, 151643, 151643, 151643, 151643, 151643, 151643, 151643, 151643, 151643, 151643, 151643, 151643, 151643, 151643, 151643, 151643, 151643, 151643, 151643, 151643, 151643, 151643, 151643, 151643, 151643, 151643, 151643, 151643, 151643, 151643, 151643, 151643, 151643, 151643, 151643, 151643, 151643, 151643, 151643, 151643, 151643, 151643, 151643, 151643, 151643, 151643, 151643, 151643, 151643, 151643, 151643, 151643, 151643, 151643, 151643, 151643, 151643, 151643, 151643, 151643, 151643, 151643, 151643, 151643, 151643, 151643, 151643, 151643, 151643, 151643, 151643, 151643, 151643, 151643, 151643, 151643, 151643, 151643, 151643, 151643, 151643, 151643, 151643, 151643, 151643, 151643, 151643, 151643, 151643, 151643, 151643, 151643, 151643, 151643, 151643, 151643, 151643, 151643, 151643, 151643, 151643, 151643, 151643, 151643, 151643, 151643, 151643, 151643, 151643, 151643, 151643, 151643, 151643, 151643, 151643, 151643, 151643, 151643, 151643, 151643, 151643, 151643, 151643, 151643, 151643, 151643, 151643, 151643, 151643, 151643, 151643, 151643, 151643, 151643, 151643, 151643, 151643, 151643, 151643, 151643, 151643, 151643, 151643, 151643, 151643, 151643, 151643, 151643, 151643, 151643, 151643, 151643, 151643, 151643, 151643, 151643, 151643, 151643, 151643, 151643, 151643, 151643, 151643, 151643, 151643, 151643, 151643, 151643, 151643, 151643, 151643, 151643, 151643, 151643, 151643, 151643, 151643, 151643, 151643, 151643, 151643, 151643, 151643, 151643, 151643, 151643, 151643, 151643, 151643, 151643, 151643, 151643, 151643, 151643, 151643, 151643, 151643, 151643, 151643, 151643, 151643, 151643, 151643, 151643, 151643, 151643, 151643, 151643, 151643, 151643, 151643, 151643, 151643, 151643, 151643, 151643, 151643, 151643, 151643, 151643, 151643, 151643, 151643, 151643, 151643, 151643, 151643, 151643, 151643, 151643, 151643, 151643, 151643, 151643, 151643, 151643, 151643, 151643, 151643, 151643, 151643, 151643, 151643, 151643, 151643, 151643, 151643, 151643, 151643, 151643, 151643, 151643, 151643, 151643, 151643, 151643, 151643, 151643, 151643, 151643, 151643, 151643, 151643, 151643, 151643, 151643, 151643, 151643, 151643, 151643, 151643, 151643, 151643, 151643, 151643, 151643, 151643, 151643, 151643, 151643, 151643, 151643, 151643, 151643, 151643, 151643, 151643, 151643, 151643, 151643, 151643, 151643, 151643, 151643, 151643, 151643, 151643, 151643, 151643, 151643, 151643, 151643, 151643, 151643, 151643, 151643, 151643, 151643, 151643, 151643, 151643, 151643, 151643, 151643, 151643, 151643, 151643, 151643, 151643, 151643, 151643, 151643, 151643, 151643, 151643, 151643, 151643, 151643, 151643, 151643, 151643, 151643, 151643, 151643, 151643, 151643, 151643, 151643, 151643, 151643, 151643, 151643, 151643, 151643, 151643, 151643, 151643, 151643, 151643, 151643, 151643, 151643, 151643, 151643, 151643, 151643, 151643, 151643, 151643, 151643, 151643, 151643, 151643, 151643, 151643, 151643, 151643, 151643, 151643, 151643, 151643, 151643, 151643, 151643, 151643, 151643, 151643, 151643, 151643, 151643, 151643, 151643, 151643, 151643, 151643, 151643, 151643, 151643, 151643, 151643, 151643, 151643, 151643, 151643, 151643, 151643, 151643, 151643, 151643, 151643, 151643, 151643, 151643, 151643, 151643, 151643, 151643, 151643, 151643, 151643, 151643, 151643, 151643, 151643, 151643, 151643, 151643, 151643, 151643, 151643, 151643, 151643, 151643, 151643, 151643, 151643, 151643, 151643, 151643, 151643, 151643, 151643, 151643, 151643, 151643, 151643, 151643, 151643, 151643, 151643, 151643, 151643, 151643, 151643, 151643, 151643, 151643, 151643, 151643, 151643, 151643, 151643, 151643, 151643, 151643, 151643, 151643, 151643, 151643, 151643, 151643, 151643, 151643, 151643, 151643, 151643, 151643, 151643, 151643, 151643, 151643, 151643, 151643, 151643, 151643, 151643, 151643, 151643, 151643, 151643, 151643, 151643, 151643, 151643, 151643, 151643, 151643, 151643, 151643, 151643, 151643, 151643, 151643, 151643, 151643, 151643, 151643, 151643, 151643, 151643, 151643, 151643, 151643, 151643, 151643, 151643, 151643, 151643, 151643, 151643, 151643, 151643, 151643, 151643, 151643, 151643, 151643, 151643, 151643, 151643, 151643, 151643, 151643, 151643, 151643, 151643, 151643, 151643, 151643, 151643, 151643, 151643, 151643, 151643, 151643, 151643, 151643, 151643, 151643, 151643, 151643, 151643, 151643, 151643, 151643, 151643, 151643, 151643, 151643, 151643, 151643, 151643, 151643, 151643, 151643, 151643, 151643, 151643, 151643, 151643, 151643, 151643, 151643, 151643, 151643, 151643, 151643, 151643, 151643, 151643, 151643, 151643, 151643, 151643, 151643, 151643, 151643, 151643, 151643, 151643, 151643, 151643, 151643, 151643, 151643, 151643, 151643, 151643, 151643, 151643, 151643, 151643, 151643, 151643, 151643, 151643, 151643, 151643, 151643, 151643, 151643, 151643, 151643, 151643, 151643, 151643, 151643, 151643, 151643, 151643, 151643, 151643, 151643, 151643, 151643, 151643, 151643, 151643, 151643, 151643, 151643, 151643, 151643, 151643, 151643, 151643, 151643, 151643, 151643, 151643, 151643, 151643, 151643, 151643, 151643, 151643, 151643, 151643, 151643, 151643, 151643, 151643, 151643, 151643, 151643, 151643, 151643, 151643, 151643, 151643, 151643, 151643, 151643, 151643, 151643, 151643, 151643, 151643, 151643, 151643, 151643, 151643, 151643, 151643, 151643, 151643, 151643, 151643, 151643, 151643, 151643, 151643, 151643, 151643, 151643, 151643, 151643, 151643, 151643, 151643, 151643, 151643, 151643, 151643, 151643, 151643, 151643, 151643, 151643, 151643, 151643, 151643, 151643, 151643, 151643, 151643, 151643, 151643, 151644, 8948, 198, 2610, 525, 1207, 16948, 11, 3465, 553, 54364, 14817, 13, 1446, 525, 264, 10950, 17847, 13, 151645, 198, 151644, 872, 198, 16141, 279, 2701, 5248, 5754, 3405, 13, 576, 1537, 1555, 315, 697, 2033, 1265, 387, 315, 279, 2701, 3561, 25, 364, 16141, 25, 400, 20756, 4198, 6, 320, 28996, 17194, 8, 1380, 44428, 374, 825, 315, 19360, 35, 13, 21149, 3019, 553, 3019, 1573, 35764, 382, 2610, 614, 10030, 458, 9788, 23628, 13, 2014, 10542, 279, 1985, 11, 498, 614, 1483, 279, 2701, 3668, 7923, 12538, 25, 23301, 2801, 11, 220, 16, 39, 451, 18446, 11, 323, 9167, 26628, 441, 15149, 13, 576, 23301, 2801, 19745, 4933, 264, 1602, 7205, 43125, 16162, 518, 220, 18, 15, 15, 15, 289, 5276, 372, 1902, 13, 9043, 1008, 3746, 43125, 38935, 525, 13166, 518, 220, 16, 22, 15, 15, 323, 220, 16, 21, 20, 15, 289, 5276, 372, 1902, 13, 25694, 38935, 1033, 13166, 304, 279, 220, 16, 39, 451, 18446, 19745, 2670, 38935, 12159, 311, 33449, 2832, 67007, 58305, 13, 576, 3072, 19745, 4933, 264, 12289, 16162, 518, 296, 31082, 284, 220, 19, 20, 13, 64547, 279, 11483, 14806, 315, 419, 9788, 23628, 438, 2987, 356, 21, 39, 16, 17, 46, 11, 356, 21, 39, 16, 15, 46, 11, 356, 21, 39, 16, 15, 46, 17, 11, 476, 356, 21, 39, 16, 17, 46, 17, 382, 32, 8, 356, 21, 39, 16, 15, 46, 198, 33, 8, 356, 21, 39, 16, 17, 46, 17, 198, 34, 8, 356, 21, 39, 16, 15, 46, 17, 198, 35, 8, 356, 21, 39, 16, 17, 46, 151645, 198, 151644, 77091, 198]",,270,404,674,0.0,0.0
762bc09e-f8c5-4aca-add3-fd1f7a92cc11,7,53,"[151643, 151643, 151643, 151643, 151643, 151643, 151643, 151643, 151643, 151643, 151643, 151643, 151643, 151643, 151643, 151643, 151643, 151643, 151643, 151643, 151643, 151643, 151643, 151643, 151643, 151643, 151643, 151643, 151643, 151643, 151643, 151643, 151643, 151643, 151643, 151643, 151643, 151643, 151643, 151643, 151643, 151643, 151643, 151643, 151643, 151643, 151643, 151643, 151643, 151643, 151643, 151643, 151643, 151643, 151643, 151643, 151643, 151643, 151643, 151643, 151643, 151643, 151643, 151643, 151643, 151643, 151643, 151643, 151643, 151643, 151643, 151643, 151643, 151643, 151643, 151643, 151643, 151643, 151643, 151643, 151643, 151643, 151643, 151643, 151643, 151643, 151643, 151643, 151643, 151643, 151643, 151643, 151643, 151643, 151643, 151643, 151643, 151643, 151643, 151643, 151643, 151643, 151643, 151643, 151643, 151643, 151643, 151643, 151643, 151643, 151643, 151643, 151643, 151643, 151643, 151643, 151643, 151643, 151643, 151643, 151643, 151643, 151643, 151643, 151643, 151643, 151643, 151643, 151643, 151643, 151643, 151643, 151643, 151643, 151643, 151643, 151643, 151643, 151643, 151643, 151643, 151643, 151643, 151643, 151643, 151643, 151643, 151643, 151643, 151643, 151643, 151643, 151643, 151643, 151643, 151643, 151643, 151643, 151643, 151643, 151643, 151643, 151643, 151643, 151643, 151643, 151643, 151643, 151643, 151643, 151643, 151643, 151643, 151643, 151643, 151643, 151643, 151643, 151643, 151643, 151643, 151643, 151643, 151643, 151643, 151643, 151643, 151643, 151643, 151643, 151643, 151643, 151643, 151643, 151643, 151643, 151643, 151643, 151643, 151643, 151643, 151643, 151643, 151643, 151643, 151643, 151643, 151643, 151643, 151643, 151643, 151643, 151643, 151643, 151643, 151643, 151643, 151643, 151643, 151643, 151643, 151643, 151643, 151643, 151643, 151643, 151643, 151643, 151643, 151643, 151643, 151643, 151643, 151643, 151643, 151643, 151643, 151643, 151643, 151643, 151643, 151643, 151643, 151643, 151643, 151643, 151643, 151643, 151643, 151643, 151643, 151643, 151643, 151643, 151643, 151643, 151643, 151643, 151643, 151643, 151643, 151643, 151643, 151643, 151643, 151643, 151643, 151643, 151643, 151643, 151643, 151643, 151643, 151643, 151643, 151643, 151643, 151643, 151643, 151643, 151643, 151643, 151643, 151643, 151643, 151643, 151643, 151643, 151643, 151643, 151643, 151643, 151643, 151643, 151643, 151643, 151643, 151643, 151643, 151643, 151643, 151643, 151643, 151643, 151643, 151643, 151643, 151643, 151643, 151643, 151643, 151643, 151643, 151643, 151643, 151643, 151643, 151643, 151643, 151643, 151643, 151643, 151643, 151643, 151643, 151643, 151643, 151643, 151643, 151643, 151643, 151643, 151643, 151643, 151643, 151643, 151643, 151643, 151643, 151643, 151643, 151643, 151643, 151643, 151643, 151643, 151643, 151643, 151643, 151643, 151643, 151643, 151643, 151643, 151643, 151643, 151643, 151643, 151643, 151643, 151643, 151643, 151643, 151643, 151643, 151643, 151643, 151643, 151643, 151643, 151643, 151643, 151643, 151643, 151643, 151643, 151643, 151643, 151643, 151643, 151643, 151643, 151643, 151643, 151643, 151643, 151643, 151643, 151643, 151643, 151643, 151643, 151643, 151643, 151643, 151643, 151643, 151643, 151643, 151643, 151643, 151643, 151643, 151643, 151643, 151643, 151643, 151643, 151643, 151643, 151643, 151643, 151643, 151643, 151643, 151643, 151643, 151643, 151643, 151643, 151643, 151643, 151643, 151643, 151643, 151643, 151643, 151643, 151643, 151643, 151643, 151643, 151643, 151643, 151643, 151643, 151643, 151643, 151643, 151643, 151643, 151643, 151643, 151643, 151643, 151643, 151643, 151643, 151643, 151643, 151643, 151643, 151643, 151643, 151643, 151643, 151643, 151643, 151643, 151643, 151643, 151643, 151643, 151643, 151643, 151643, 151643, 151643, 151643, 151643, 151643, 151643, 151643, 151643, 151643, 151643, 151643, 151643, 151643, 151643, 151643, 151643, 151643, 151643, 151643, 151643, 151643, 151643, 151643, 151643, 151643, 151643, 151643, 151643, 151643, 151643, 151643, 151643, 151643, 151643, 151643, 151643, 151643, 151643, 151643, 151643, 151643, 151643, 151643, 151643, 151643, 151643, 151643, 151643, 151643, 151643, 151643, 151643, 151643, 151643, 151643, 151643, 151643, 151643, 151643, 151643, 151643, 151643, 151643, 151643, 151643, 151643, 151643, 151643, 151643, 151643, 151643, 151643, 151643, 151643, 151643, 151643, 151643, 151643, 151643, 151643, 151643, 151643, 151643, 151643, 151643, 151643, 151643, 151643, 151643, 151643, 151643, 151643, 151643, 151643, 151643, 151643, 151643, 151643, 151643, 151643, 151643, 151643, 151643, 151643, 151643, 151643, 151643, 151643, 151643, 151643, 151643, 151643, 151643, 151643, 151643, 151643, 151643, 151643, 151643, 151643, 151643, 151643, 151643, 151643, 151643, 151643, 151643, 151643, 151643, 151643, 151643, 151643, 151643, 151643, 151643, 151643, 151643, 151643, 151643, 151643, 151643, 151643, 151643, 151643, 151643, 151643, 151643, 151643, 151643, 151643, 151643, 151643, 151643, 151643, 151643, 151643, 151643, 151643, 151643, 151643, 151643, 151643, 151643, 151643, 151643, 151643, 151643, 151643, 151643, 151643, 151643, 151643, 151643, 151643, 151643, 151643, 151643, 151643, 151643, 151643, 151643, 151643, 151643, 151643, 151643, 151643, 151643, 151643, 151643, 151643, 151643, 151643, 151643, 151643, 151643, 151643, 151643, 151643, 151643, 151643, 151643, 151643, 151643, 151643, 151643, 151643, 151643, 151643, 151643, 151643, 151643, 151643, 151643, 151643, 151643, 151643, 151643, 151643, 151643, 151643, 151643, 151643, 151643, 151643, 151643, 151643, 151643, 151643, 151643, 151643, 151643, 151643, 151643, 151643, 151643, 151643, 151643, 151643, 151643, 151643, 151643, 151643, 151643, 151643, 151643, 151643, 151643, 151643, 151643, 151643, 151643, 151643, 151643, 151643, 151643, 151643, 151643, 151643, 151643, 151643, 151643, 151643, 151643, 151643, 151643, 151643, 151643, 151643, 151643, 151643, 151643, 151643, 151643, 151643, 151643, 151643, 151643, 151643, 151643, 151643, 151643, 151643, 151643, 151643, 151643, 151643, 151643, 151643, 151643, 151643, 151643, 151644, 8948, 198, 2610, 525, 1207, 16948, 11, 3465, 553, 54364, 14817, 13, 1446, 525, 264, 10950, 17847, 13, 151645, 198, 151644, 872, 198, 16141, 279, 2701, 5248, 5754, 3405, 13, 576, 1537, 1555, 315, 697, 2033, 1265, 387, 315, 279, 2701, 3561, 25, 364, 16141, 25, 400, 20756, 4198, 6, 320, 28996, 17194, 8, 1380, 44428, 374, 825, 315, 19360, 35, 13, 21149, 3019, 553, 3019, 1573, 35764, 382, 2082, 3232, 318, 7417, 20980, 315, 77135, 362, 323, 425, 46726, 220, 22, 13, 17, 15, 342, 572, 31713, 311, 220, 17, 15, 15, 30937, 2041, 3720, 13, 758, 419, 1142, 11, 1172, 264, 20980, 315, 44512, 572, 14122, 11, 892, 11, 2041, 26917, 11, 572, 5823, 2393, 3132, 1526, 32983, 10199, 448, 458, 8503, 67, 26522, 72593, 43644, 46, 19, 8, 17, 320, 144287, 16, 701, 14413, 19238, 39, 8, 17, 320, 144287, 17, 8, 6291, 11, 323, 2518, 59447, 23285, 320, 144287, 18, 568, 18099, 25, 279, 14324, 315, 32983, 96890, 16, 323, 96890, 18, 7172, 553, 220, 18, 13, 21, 15, 342, 323, 220, 15, 13, 23, 15, 342, 11, 15576, 320, 44819, 46, 14122, 304, 13705, 96890, 18, 568, 576, 4680, 315, 279, 2086, 13705, 702, 537, 5497, 13, 1634, 264, 1102, 11, 1172, 220, 17, 13, 17, 19, 92866, 315, 6819, 356, 320, 20270, 9315, 323, 7262, 8, 14616, 624, 1425, 8463, 279, 2790, 1372, 315, 678, 32199, 304, 77135, 362, 323, 425, 382, 32, 8, 220, 16, 24, 198, 33, 8, 220, 16, 18, 198, 34, 8, 220, 16, 22, 198, 35, 8, 220, 16, 20, 151645, 198, 151644, 77091, 198]",,267,801,1068,0.0,0.0
9240a22b-38a9-421f-923c-417803bf4d57,7,54,"[151643, 151643, 151643, 151643, 151643, 151643, 151643, 151643, 151643, 151643, 151643, 151643, 151643, 151643, 151643, 151643, 151643, 151643, 151643, 151643, 151643, 151643, 151643, 151643, 151643, 151643, 151643, 151643, 151643, 151643, 151643, 151643, 151643, 151643, 151643, 151643, 151643, 151643, 151643, 151643, 151643, 151643, 151643, 151643, 151643, 151643, 151643, 151643, 151643, 151643, 151643, 151643, 151643, 151643, 151643, 151643, 151643, 151643, 151643, 151643, 151643, 151643, 151643, 151643, 151643, 151643, 151643, 151643, 151643, 151643, 151643, 151643, 151643, 151643, 151643, 151643, 151643, 151643, 151643, 151643, 151643, 151643, 151643, 151643, 151643, 151643, 151643, 151643, 151643, 151643, 151643, 151643, 151643, 151643, 151643, 151643, 151643, 151643, 151643, 151643, 151643, 151643, 151643, 151643, 151643, 151643, 151643, 151643, 151643, 151643, 151643, 151643, 151643, 151643, 151643, 151643, 151643, 151643, 151643, 151643, 151643, 151643, 151643, 151643, 151643, 151643, 151643, 151643, 151643, 151643, 151643, 151643, 151643, 151643, 151643, 151643, 151643, 151643, 151643, 151643, 151643, 151643, 151643, 151643, 151643, 151643, 151643, 151643, 151643, 151643, 151643, 151643, 151643, 151643, 151643, 151643, 151643, 151643, 151643, 151643, 151643, 151643, 151643, 151643, 151643, 151643, 151643, 151643, 151643, 151643, 151643, 151643, 151643, 151643, 151643, 151643, 151643, 151643, 151643, 151643, 151643, 151643, 151643, 151643, 151643, 151643, 151643, 151643, 151643, 151643, 151643, 151643, 151643, 151643, 151643, 151643, 151643, 151643, 151643, 151643, 151643, 151643, 151643, 151643, 151643, 151643, 151643, 151643, 151643, 151643, 151643, 151643, 151643, 151643, 151643, 151643, 151643, 151643, 151643, 151643, 151643, 151643, 151643, 151643, 151643, 151643, 151643, 151643, 151643, 151643, 151643, 151643, 151643, 151643, 151643, 151643, 151643, 151643, 151643, 151643, 151643, 151643, 151643, 151643, 151643, 151643, 151643, 151643, 151643, 151643, 151643, 151643, 151643, 151643, 151643, 151643, 151643, 151643, 151643, 151643, 151643, 151643, 151643, 151643, 151643, 151643, 151643, 151643, 151643, 151643, 151643, 151643, 151643, 151643, 151643, 151643, 151643, 151643, 151643, 151643, 151643, 151643, 151643, 151643, 151643, 151643, 151643, 151643, 151643, 151643, 151643, 151643, 151643, 151643, 151643, 151643, 151643, 151643, 151643, 151643, 151643, 151643, 151643, 151643, 151643, 151643, 151643, 151643, 151643, 151643, 151643, 151643, 151643, 151643, 151643, 151643, 151643, 151643, 151643, 151643, 151643, 151643, 151643, 151643, 151643, 151643, 151643, 151643, 151643, 151643, 151643, 151643, 151643, 151643, 151643, 151643, 151643, 151643, 151643, 151643, 151643, 151643, 151643, 151643, 151643, 151643, 151643, 151643, 151643, 151643, 151643, 151643, 151643, 151643, 151643, 151643, 151643, 151643, 151643, 151643, 151643, 151643, 151643, 151643, 151643, 151643, 151643, 151643, 151643, 151643, 151643, 151643, 151643, 151643, 151643, 151643, 151643, 151643, 151643, 151643, 151643, 151643, 151643, 151643, 151643, 151643, 151643, 151643, 151643, 151643, 151643, 151643, 151643, 151643, 151643, 151643, 151643, 151643, 151643, 151643, 151643, 151643, 151643, 151643, 151643, 151643, 151643, 151643, 151643, 151643, 151643, 151643, 151643, 151643, 151643, 151643, 151643, 151643, 151643, 151643, 151643, 151643, 151643, 151643, 151643, 151643, 151643, 151643, 151643, 151643, 151643, 151643, 151643, 151643, 151643, 151643, 151643, 151643, 151643, 151643, 151643, 151643, 151643, 151643, 151643, 151643, 151643, 151643, 151643, 151643, 151643, 151643, 151643, 151643, 151643, 151643, 151643, 151643, 151643, 151643, 151643, 151643, 151643, 151643, 151643, 151643, 151643, 151643, 151643, 151643, 151643, 151643, 151643, 151643, 151643, 151643, 151643, 151643, 151643, 151643, 151643, 151643, 151643, 151643, 151643, 151643, 151643, 151643, 151643, 151643, 151643, 151643, 151643, 151643, 151643, 151643, 151643, 151643, 151643, 151643, 151643, 151643, 151643, 151643, 151643, 151643, 151643, 151643, 151643, 151643, 151643, 151643, 151643, 151643, 151643, 151643, 151643, 151643, 151643, 151643, 151643, 151643, 151643, 151643, 151643, 151643, 151643, 151643, 151643, 151643, 151643, 151643, 151643, 151643, 151643, 151643, 151643, 151643, 151643, 151643, 151643, 151643, 151643, 151643, 151643, 151643, 151643, 151643, 151643, 151643, 151643, 151643, 151643, 151643, 151643, 151643, 151643, 151643, 151643, 151643, 151643, 151643, 151643, 151643, 151643, 151643, 151643, 151643, 151643, 151643, 151643, 151643, 151643, 151643, 151643, 151643, 151643, 151643, 151643, 151643, 151643, 151643, 151643, 151643, 151643, 151643, 151643, 151643, 151643, 151643, 151643, 151643, 151643, 151643, 151643, 151643, 151643, 151643, 151643, 151643, 151643, 151643, 151643, 151643, 151643, 151643, 151643, 151643, 151643, 151643, 151643, 151643, 151643, 151643, 151643, 151643, 151643, 151643, 151643, 151643, 151643, 151643, 151643, 151643, 151643, 151643, 151643, 151643, 151643, 151643, 151643, 151643, 151643, 151643, 151643, 151643, 151643, 151643, 151643, 151643, 151643, 151643, 151643, 151643, 151643, 151643, 151643, 151643, 151643, 151643, 151643, 151643, 151643, 151643, 151643, 151643, 151643, 151643, 151643, 151643, 151643, 151643, 151643, 151643, 151643, 151643, 151643, 151643, 151643, 151643, 151643, 151643, 151643, 151643, 151643, 151643, 151643, 151643, 151643, 151643, 151643, 151643, 151643, 151643, 151643, 151643, 151643, 151643, 151643, 151643, 151643, 151643, 151643, 151643, 151643, 151643, 151643, 151643, 151643, 151643, 151643, 151643, 151643, 151643, 151643, 151643, 151643, 151643, 151643, 151643, 151643, 151643, 151643, 151643, 151643, 151643, 151643, 151643, 151643, 151643, 151643, 151643, 151643, 151643, 151643, 151643, 151643, 151643, 151643, 151643, 151643, 151643, 151643, 151643, 151643, 151643, 151643, 151643, 151643, 151643, 151643, 151643, 151643, 151643, 151643, 151643, 151643, 151643, 151643, 151643, 151643, 151643, 151643, 151643, 151643, 151643, 151643, 151643, 151643, 151643, 151643, 151643, 151643, 151643, 151643, 151643, 151643, 151643, 151643, 151643, 151643, 151643, 151643, 151643, 151643, 151643, 151643, 151643, 151643, 151643, 151643, 151643, 151643, 151643, 151643, 151643, 151643, 151643, 151643, 151643, 151643, 151643, 151643, 151643, 151643, 151643, 151643, 151643, 151643, 151643, 151643, 151643, 151643, 151643, 151643, 151643, 151643, 151643, 151643, 151643, 151643, 151643, 151643, 151643, 151643, 151643, 151643, 151643, 151643, 151643, 151644, 8948, 198, 2610, 525, 1207, 16948, 11, 3465, 553, 54364, 14817, 13, 1446, 525, 264, 10950, 17847, 13, 151645, 198, 151644, 872, 198, 16141, 279, 2701, 5248, 5754, 3405, 13, 576, 1537, 1555, 315, 697, 2033, 1265, 387, 315, 279, 2701, 3561, 25, 364, 16141, 25, 400, 20756, 4198, 6, 320, 28996, 17194, 8, 1380, 44428, 374, 825, 315, 19360, 35, 13, 21149, 3019, 553, 3019, 1573, 35764, 382, 28301, 1437, 279, 5916, 3684, 11, 362, 11, 304, 279, 2701, 12720, 624, 32, 488, 264, 78474, 798, 940, 268, 2356, 23628, 488, 220, 16, 76571, 1952, 69726, 220, 16, 8013, 2674, 12, 16, 20767, 12, 16, 12, 3923, 7287, 17, 8273, 258, 3923, 66, 3337, 22288, 306, 2145, 271, 32, 8, 220, 16, 11, 17, 1737, 318, 769, 88, 2892, 757, 3337, 22288, 306, 2145, 198, 33, 8, 220, 17, 1448, 41872, 12, 18, 1448, 87540, 65, 2842, 32578, 58, 17, 13, 16, 13, 15, 60, 45125, 2145, 198, 34, 8, 51417, 32578, 58, 18, 13, 17, 13, 15, 60, 383, 417, 12, 21, 12, 1952, 198, 35, 8, 220, 17, 1448, 41872, 65, 2842, 32578, 58, 18, 13, 16, 13, 15, 60, 17308, 12, 17, 12, 1952, 151645, 198, 151644, 77091, 198]",,204,408,612,0.0,0.0
e96fc963-e74e-4dbb-80c9-1d28efb29cc3,7,55,"[151643, 151643, 151643, 151643, 151643, 151643, 151643, 151643, 151643, 151643, 151643, 151643, 151643, 151643, 151643, 151643, 151643, 151643, 151643, 151643, 151643, 151643, 151643, 151643, 151643, 151643, 151643, 151643, 151643, 151643, 151643, 151643, 151643, 151643, 151643, 151643, 151643, 151643, 151643, 151643, 151643, 151643, 151643, 151643, 151643, 151643, 151643, 151643, 151643, 151643, 151643, 151643, 151643, 151643, 151643, 151643, 151643, 151643, 151643, 151643, 151643, 151643, 151643, 151643, 151643, 151643, 151643, 151643, 151643, 151643, 151643, 151643, 151643, 151643, 151643, 151643, 151643, 151643, 151643, 151643, 151643, 151643, 151643, 151643, 151643, 151643, 151643, 151643, 151643, 151643, 151643, 151643, 151643, 151643, 151643, 151643, 151643, 151643, 151643, 151643, 151643, 151643, 151643, 151643, 151643, 151643, 151643, 151643, 151643, 151643, 151643, 151643, 151643, 151643, 151643, 151643, 151643, 151643, 151643, 151643, 151643, 151643, 151643, 151643, 151643, 151643, 151643, 151643, 151643, 151643, 151643, 151643, 151643, 151643, 151643, 151643, 151643, 151643, 151643, 151643, 151643, 151643, 151643, 151643, 151643, 151643, 151643, 151643, 151643, 151643, 151643, 151643, 151643, 151643, 151643, 151643, 151643, 151643, 151643, 151643, 151643, 151643, 151643, 151643, 151643, 151643, 151643, 151643, 151643, 151643, 151643, 151643, 151643, 151643, 151643, 151643, 151643, 151643, 151643, 151643, 151643, 151643, 151643, 151643, 151643, 151643, 151643, 151643, 151643, 151643, 151643, 151643, 151643, 151643, 151643, 151643, 151643, 151643, 151643, 151643, 151643, 151643, 151643, 151643, 151643, 151643, 151643, 151643, 151643, 151643, 151643, 151643, 151643, 151643, 151643, 151643, 151643, 151643, 151643, 151643, 151643, 151643, 151643, 151643, 151643, 151643, 151643, 151643, 151643, 151643, 151643, 151643, 151643, 151643, 151643, 151643, 151643, 151643, 151643, 151643, 151643, 151643, 151643, 151643, 151643, 151643, 151643, 151643, 151643, 151643, 151643, 151643, 151643, 151643, 151643, 151643, 151643, 151643, 151643, 151643, 151643, 151643, 151643, 151643, 151643, 151643, 151643, 151643, 151643, 151643, 151643, 151643, 151643, 151643, 151643, 151643, 151643, 151643, 151643, 151643, 151643, 151643, 151643, 151643, 151643, 151643, 151643, 151643, 151643, 151643, 151643, 151643, 151643, 151643, 151643, 151643, 151643, 151643, 151643, 151643, 151643, 151643, 151643, 151643, 151643, 151643, 151643, 151643, 151643, 151643, 151643, 151643, 151643, 151643, 151643, 151643, 151643, 151643, 151643, 151643, 151643, 151643, 151643, 151643, 151643, 151643, 151643, 151643, 151643, 151643, 151643, 151643, 151643, 151643, 151643, 151643, 151643, 151643, 151643, 151643, 151643, 151643, 151643, 151643, 151643, 151643, 151643, 151643, 151643, 151643, 151643, 151643, 151643, 151643, 151643, 151643, 151643, 151643, 151643, 151643, 151643, 151643, 151643, 151643, 151643, 151643, 151643, 151643, 151643, 151643, 151643, 151643, 151643, 151643, 151643, 151643, 151643, 151643, 151643, 151643, 151643, 151643, 151643, 151643, 151643, 151643, 151643, 151643, 151643, 151643, 151643, 151643, 151643, 151643, 151643, 151643, 151643, 151643, 151643, 151643, 151643, 151643, 151643, 151643, 151643, 151643, 151643, 151643, 151643, 151643, 151643, 151643, 151643, 151643, 151643, 151643, 151643, 151643, 151643, 151643, 151643, 151643, 151643, 151643, 151643, 151643, 151643, 151643, 151643, 151643, 151643, 151643, 151643, 151643, 151643, 151643, 151643, 151643, 151643, 151643, 151643, 151643, 151643, 151643, 151643, 151643, 151643, 151643, 151643, 151643, 151643, 151643, 151643, 151643, 151643, 151643, 151643, 151643, 151643, 151643, 151643, 151643, 151643, 151643, 151643, 151643, 151643, 151643, 151643, 151643, 151643, 151643, 151643, 151643, 151643, 151643, 151643, 151643, 151643, 151643, 151643, 151643, 151643, 151643, 151643, 151643, 151643, 151643, 151643, 151643, 151643, 151643, 151643, 151643, 151643, 151643, 151643, 151643, 151643, 151643, 151643, 151643, 151643, 151643, 151643, 151643, 151643, 151643, 151643, 151643, 151643, 151643, 151643, 151643, 151643, 151643, 151643, 151643, 151643, 151643, 151643, 151643, 151643, 151643, 151643, 151643, 151643, 151643, 151643, 151643, 151643, 151643, 151643, 151643, 151643, 151643, 151643, 151643, 151643, 151643, 151643, 151643, 151643, 151643, 151643, 151643, 151643, 151643, 151643, 151643, 151643, 151643, 151643, 151643, 151643, 151643, 151643, 151643, 151643, 151643, 151643, 151643, 151643, 151643, 151643, 151643, 151643, 151643, 151643, 151643, 151643, 151643, 151643, 151643, 151643, 151643, 151643, 151643, 151643, 151643, 151643, 151643, 151643, 151643, 151643, 151643, 151643, 151643, 151643, 151643, 151643, 151643, 151643, 151643, 151643, 151643, 151643, 151643, 151643, 151643, 151643, 151643, 151643, 151643, 151643, 151643, 151643, 151643, 151643, 151643, 151643, 151643, 151643, 151643, 151643, 151643, 151643, 151643, 151643, 151643, 151643, 151643, 151643, 151643, 151643, 151643, 151643, 151643, 151643, 151643, 151643, 151643, 151643, 151643, 151643, 151643, 151643, 151643, 151643, 151643, 151643, 151643, 151643, 151643, 151643, 151643, 151643, 151643, 151643, 151643, 151643, 151643, 151643, 151643, 151643, 151643, 151643, 151643, 151643, 151643, 151643, 151643, 151643, 151643, 151643, 151643, 151643, 151643, 151643, 151643, 151643, 151643, 151643, 151643, 151643, 151643, 151643, 151643, 151643, 151643, 151643, 151643, 151643, 151643, 151643, 151643, 151643, 151643, 151643, 151643, 151643, 151643, 151643, 151643, 151643, 151643, 151643, 151643, 151643, 151643, 151643, 151643, 151643, 151643, 151643, 151643, 151643, 151643, 151643, 151643, 151643, 151643, 151643, 151643, 151643, 151643, 151643, 151643, 151643, 151643, 151643, 151643, 151643, 151643, 151643, 151643, 151643, 151643, 151643, 151643, 151643, 151643, 151643, 151643, 151643, 151643, 151643, 151643, 151643, 151643, 151643, 151643, 151643, 151643, 151643, 151643, 151643, 151643, 151643, 151643, 151643, 151643, 151643, 151643, 151643, 151643, 151643, 151643, 151643, 151643, 151643, 151643, 151643, 151643, 151643, 151643, 151643, 151643, 151643, 151643, 151643, 151643, 151643, 151643, 151643, 151643, 151643, 151643, 151643, 151643, 151643, 151643, 151643, 151643, 151643, 151643, 151643, 151643, 151643, 151643, 151643, 151643, 151643, 151643, 151643, 151643, 151643, 151643, 151643, 151643, 151643, 151643, 151643, 151643, 151643, 151643, 151643, 151643, 151643, 151643, 151643, 151643, 151643, 151643, 151643, 151643, 151643, 151643, 151643, 151643, 151643, 151643, 151643, 151643, 151643, 151643, 151643, 151643, 151643, 151643, 151643, 151643, 151643, 151643, 151643, 151643, 151643, 151643, 151643, 151643, 151643, 151643, 151643, 151643, 151643, 151643, 151643, 151643, 151643, 151643, 151643, 151643, 151643, 151643, 151643, 151643, 151643, 151643, 151643, 151643, 151643, 151643, 151643, 151643, 151643, 151643, 151643, 151643, 151643, 151643, 151644, 8948, 198, 2610, 525, 1207, 16948, 11, 3465, 553, 54364, 14817, 13, 1446, 525, 264, 10950, 17847, 13, 151645, 198, 151644, 872, 198, 16141, 279, 2701, 5248, 5754, 3405, 13, 576, 1537, 1555, 315, 697, 2033, 1265, 387, 315, 279, 2701, 3561, 25, 364, 16141, 25, 400, 20756, 4198, 6, 320, 28996, 17194, 8, 1380, 44428, 374, 825, 315, 19360, 35, 13, 21149, 3019, 553, 3019, 1573, 35764, 382, 641, 264, 3151, 5537, 315, 279, 12884, 11, 86787, 614, 13166, 429, 279, 1372, 315, 9759, 34227, 448, 1346, 44168, 438, 220, 16, 11255, 87, 61, 20, 13, 2585, 1558, 279, 1372, 315, 9759, 304, 429, 5537, 315, 279, 12884, 2297, 448, 6010, 320, 712, 4982, 2088, 315, 6010, 11, 435, 73530, 32, 8, 3968, 435, 61, 19, 198, 33, 8, 3968, 435, 61, 18, 198, 34, 8, 3968, 435, 61, 20, 198, 35, 8, 3968, 435, 61, 17, 151645, 198, 151644, 77091, 198]",,154,531,685,0.0,0.0
dfef24f2-6a6f-43dd-be6f-a29d87adb043,7,56,"[151643, 151643, 151643, 151643, 151643, 151643, 151643, 151643, 151643, 151643, 151643, 151643, 151643, 151643, 151643, 151643, 151643, 151643, 151643, 151643, 151643, 151643, 151643, 151643, 151643, 151643, 151643, 151643, 151643, 151643, 151643, 151643, 151643, 151643, 151643, 151643, 151643, 151643, 151643, 151643, 151643, 151643, 151643, 151643, 151643, 151643, 151643, 151643, 151643, 151643, 151643, 151643, 151643, 151643, 151643, 151643, 151643, 151643, 151643, 151643, 151643, 151643, 151643, 151643, 151643, 151643, 151643, 151643, 151643, 151643, 151643, 151643, 151643, 151643, 151643, 151643, 151643, 151643, 151643, 151643, 151643, 151643, 151643, 151643, 151643, 151643, 151643, 151643, 151643, 151643, 151643, 151643, 151643, 151643, 151643, 151643, 151643, 151643, 151643, 151643, 151643, 151643, 151643, 151643, 151643, 151643, 151643, 151643, 151643, 151643, 151643, 151643, 151643, 151643, 151643, 151643, 151643, 151643, 151643, 151643, 151643, 151643, 151643, 151643, 151643, 151643, 151643, 151643, 151643, 151643, 151643, 151643, 151643, 151643, 151643, 151643, 151643, 151643, 151643, 151643, 151643, 151643, 151643, 151643, 151643, 151643, 151643, 151643, 151643, 151643, 151643, 151643, 151643, 151643, 151643, 151643, 151643, 151643, 151643, 151643, 151643, 151643, 151643, 151643, 151643, 151643, 151643, 151643, 151643, 151643, 151643, 151643, 151643, 151643, 151643, 151643, 151643, 151643, 151643, 151643, 151643, 151643, 151643, 151643, 151643, 151643, 151643, 151643, 151643, 151643, 151643, 151643, 151643, 151643, 151643, 151643, 151643, 151643, 151643, 151643, 151643, 151643, 151643, 151643, 151643, 151643, 151643, 151643, 151643, 151643, 151643, 151643, 151643, 151643, 151643, 151643, 151643, 151643, 151643, 151643, 151643, 151643, 151643, 151643, 151643, 151643, 151643, 151643, 151643, 151643, 151643, 151643, 151643, 151643, 151643, 151643, 151643, 151643, 151643, 151643, 151643, 151643, 151643, 151643, 151643, 151643, 151643, 151643, 151643, 151643, 151643, 151643, 151643, 151643, 151643, 151643, 151643, 151643, 151643, 151643, 151643, 151643, 151643, 151643, 151643, 151643, 151643, 151643, 151643, 151643, 151643, 151643, 151643, 151643, 151643, 151643, 151643, 151643, 151643, 151643, 151643, 151643, 151643, 151643, 151643, 151643, 151643, 151643, 151643, 151643, 151643, 151643, 151643, 151643, 151643, 151643, 151643, 151643, 151643, 151643, 151643, 151643, 151643, 151643, 151643, 151643, 151643, 151643, 151643, 151643, 151643, 151643, 151643, 151643, 151643, 151643, 151643, 151643, 151643, 151643, 151643, 151643, 151643, 151643, 151643, 151643, 151643, 151643, 151643, 151643, 151643, 151643, 151643, 151643, 151643, 151643, 151643, 151643, 151643, 151643, 151643, 151643, 151643, 151643, 151643, 151643, 151643, 151643, 151643, 151643, 151643, 151643, 151643, 151643, 151643, 151643, 151643, 151643, 151643, 151643, 151643, 151643, 151643, 151643, 151643, 151643, 151643, 151643, 151643, 151643, 151643, 151643, 151643, 151643, 151643, 151643, 151643, 151643, 151643, 151643, 151643, 151643, 151643, 151643, 151643, 151643, 151643, 151643, 151643, 151643, 151643, 151643, 151643, 151643, 151643, 151643, 151643, 151643, 151643, 151643, 151643, 151643, 151643, 151643, 151643, 151643, 151643, 151643, 151643, 151643, 151643, 151643, 151643, 151643, 151643, 151643, 151643, 151643, 151643, 151643, 151643, 151643, 151643, 151643, 151643, 151643, 151643, 151643, 151643, 151643, 151643, 151643, 151643, 151643, 151643, 151643, 151643, 151643, 151643, 151643, 151643, 151643, 151643, 151643, 151643, 151643, 151643, 151643, 151643, 151643, 151643, 151643, 151643, 151643, 151643, 151643, 151643, 151643, 151643, 151643, 151643, 151643, 151643, 151643, 151643, 151643, 151643, 151643, 151643, 151643, 151643, 151643, 151643, 151643, 151643, 151643, 151643, 151643, 151643, 151643, 151643, 151643, 151643, 151643, 151643, 151643, 151643, 151643, 151643, 151643, 151643, 151643, 151643, 151643, 151643, 151643, 151643, 151643, 151643, 151643, 151643, 151643, 151643, 151643, 151643, 151643, 151643, 151643, 151643, 151643, 151643, 151643, 151643, 151643, 151643, 151643, 151643, 151643, 151643, 151643, 151643, 151643, 151643, 151643, 151643, 151643, 151643, 151643, 151643, 151643, 151643, 151643, 151643, 151643, 151643, 151643, 151643, 151643, 151643, 151643, 151643, 151643, 151643, 151643, 151643, 151643, 151643, 151643, 151643, 151643, 151643, 151643, 151643, 151643, 151643, 151643, 151643, 151643, 151643, 151643, 151643, 151643, 151643, 151643, 151643, 151643, 151643, 151643, 151643, 151643, 151643, 151643, 151643, 151643, 151643, 151643, 151643, 151643, 151643, 151643, 151643, 151643, 151643, 151643, 151643, 151643, 151643, 151643, 151643, 151643, 151643, 151643, 151643, 151643, 151643, 151643, 151643, 151643, 151643, 151643, 151644, 8948, 198, 2610, 525, 1207, 16948, 11, 3465, 553, 54364, 14817, 13, 1446, 525, 264, 10950, 17847, 13, 151645, 198, 151644, 872, 198, 16141, 279, 2701, 5248, 5754, 3405, 13, 576, 1537, 1555, 315, 697, 2033, 1265, 387, 315, 279, 2701, 3561, 25, 364, 16141, 25, 400, 20756, 4198, 6, 320, 28996, 17194, 8, 1380, 44428, 374, 825, 315, 19360, 35, 13, 21149, 3019, 553, 3019, 1573, 35764, 382, 2403, 279, 2701, 12239, 911, 279, 30106, 33358, 315, 1345, 19289, 6381, 1070, 76834, 5269, 56396, 69820, 220, 17, 320, 50, 17048, 55964, 7339, 53, 55964, 17, 8, 525, 4396, 3650, 271, 32, 8, 328, 17048, 86171, 53, 12, 17, 308, 2154, 16, 15, 9612, 2154, 16, 19, 12, 840, 78, 45, 26057, 438, 29448, 347, 67897, 304, 264, 35301, 12733, 16953, 13, 576, 451, 90623, 1374, 78, 45, 7947, 315, 308, 2154, 16, 19, 1410, 10719, 311, 308, 2154, 16, 15, 3259, 458, 4541, 98744, 1754, 1623, 6351, 429, 27934, 279, 29985, 315, 11472, 30720, 624, 33, 8, 576, 4379, 315, 14087, 71, 17680, 304, 53904, 374, 13482, 398, 48293, 448, 279, 1372, 315, 25879, 804, 429, 264, 50643, 562, 1921, 646, 10902, 13, 11733, 328, 17048, 86171, 53, 323, 328, 17048, 86171, 53, 12, 17, 6687, 2061, 481, 16, 64597, 47833, 82499, 1473, 1378, 25879, 804, 979, 1212, 23504, 11, 4428, 311, 1008, 50643, 562, 1921, 82, 429, 48753, 29039, 14087, 71, 17680, 7813, 624, 34, 8, 6687, 2061, 20131, 95008, 14087, 71, 17680, 11450, 1378, 9861, 776, 665, 1330, 3143, 311, 220, 20, 63, 835, 315, 279, 32769, 553, 7218, 1182, 553, 220, 16, 30384, 67944, 448, 279, 1492, 315, 70572, 30384, 354, 3341, 11, 323, 50643, 562, 1921, 13, 576, 328, 17048, 86171, 53, 12, 17, 55068, 20131, 95008, 14087, 71, 17680, 10008, 702, 279, 1852, 390, 1627, 438, 279, 328, 17048, 86171, 53, 55068, 20131, 95008, 14087, 71, 17680, 624, 35, 8, 328, 17048, 86171, 53, 12, 17, 2726, 37, 18, 64, 702, 279, 5726, 311, 8183, 4760, 79, 519, 12, 23, 15099, 2899, 273, 67156, 11, 2041, 27887, 279, 7493, 5866, 315, 425, 564, 12, 17, 13, 11054, 79, 519, 12, 23, 15099, 374, 14975, 438, 264, 28583, 4565, 315, 279, 11482, 27592, 82946, 14212, 37870, 4566, 4545, 43440, 11, 1393, 425, 564, 12, 17, 11088, 264, 16587, 3476, 304, 78416, 279, 70961, 37870, 13, 1096, 13230, 429, 279, 16953, 1526, 892, 328, 17048, 86171, 53, 12, 17, 2726, 37, 18, 64, 89874, 94774, 374, 4566, 279, 11482, 27592, 82946, 14212, 37870, 13, 151645, 198, 151644, 77091, 198]",,424,531,955,1.0,1.0
28e69aa1-ea42-4ece-a313-b208f3abba60,7,57,"[151643, 151643, 151643, 151643, 151643, 151643, 151643, 151643, 151643, 151643, 151643, 151643, 151643, 151643, 151643, 151643, 151643, 151643, 151643, 151643, 151643, 151643, 151643, 151643, 151643, 151643, 151643, 151643, 151643, 151643, 151643, 151643, 151643, 151643, 151643, 151643, 151643, 151643, 151643, 151643, 151643, 151643, 151643, 151643, 151643, 151643, 151643, 151643, 151643, 151643, 151643, 151643, 151643, 151643, 151643, 151643, 151643, 151643, 151643, 151643, 151643, 151643, 151643, 151643, 151643, 151643, 151643, 151643, 151643, 151643, 151643, 151643, 151643, 151643, 151643, 151643, 151643, 151643, 151643, 151643, 151643, 151643, 151643, 151643, 151643, 151643, 151643, 151643, 151643, 151643, 151643, 151643, 151643, 151643, 151643, 151643, 151643, 151643, 151643, 151643, 151643, 151643, 151643, 151643, 151643, 151643, 151643, 151643, 151643, 151643, 151643, 151643, 151643, 151643, 151643, 151643, 151643, 151643, 151643, 151643, 151643, 151643, 151643, 151643, 151643, 151643, 151643, 151643, 151643, 151643, 151643, 151643, 151643, 151643, 151643, 151643, 151643, 151643, 151643, 151643, 151643, 151643, 151643, 151643, 151643, 151643, 151643, 151643, 151643, 151643, 151643, 151643, 151643, 151643, 151643, 151643, 151643, 151643, 151643, 151643, 151643, 151643, 151643, 151643, 151643, 151643, 151643, 151643, 151643, 151643, 151643, 151643, 151643, 151643, 151643, 151643, 151643, 151643, 151643, 151643, 151643, 151643, 151643, 151643, 151643, 151643, 151643, 151643, 151643, 151643, 151643, 151643, 151643, 151643, 151643, 151643, 151643, 151643, 151643, 151643, 151643, 151643, 151643, 151643, 151643, 151643, 151643, 151643, 151643, 151643, 151643, 151643, 151643, 151643, 151643, 151643, 151643, 151643, 151643, 151643, 151643, 151643, 151643, 151643, 151643, 151643, 151643, 151643, 151643, 151643, 151643, 151643, 151643, 151643, 151643, 151643, 151643, 151643, 151643, 151643, 151643, 151643, 151643, 151643, 151643, 151643, 151643, 151643, 151643, 151643, 151643, 151643, 151643, 151643, 151643, 151643, 151643, 151643, 151643, 151643, 151643, 151643, 151643, 151643, 151643, 151643, 151643, 151643, 151643, 151643, 151643, 151643, 151643, 151643, 151643, 151643, 151643, 151643, 151643, 151643, 151643, 151643, 151643, 151643, 151643, 151643, 151643, 151643, 151643, 151643, 151643, 151643, 151643, 151643, 151643, 151643, 151643, 151643, 151643, 151643, 151643, 151643, 151643, 151643, 151643, 151643, 151643, 151643, 151643, 151643, 151643, 151643, 151643, 151643, 151643, 151643, 151643, 151643, 151643, 151643, 151643, 151643, 151643, 151643, 151643, 151643, 151643, 151643, 151643, 151643, 151643, 151643, 151643, 151643, 151643, 151643, 151643, 151643, 151643, 151643, 151643, 151643, 151643, 151643, 151643, 151643, 151643, 151643, 151643, 151643, 151643, 151643, 151643, 151643, 151643, 151643, 151643, 151643, 151643, 151643, 151643, 151643, 151643, 151643, 151643, 151643, 151643, 151643, 151643, 151643, 151643, 151643, 151643, 151643, 151643, 151643, 151643, 151643, 151643, 151643, 151643, 151643, 151643, 151643, 151643, 151643, 151643, 151643, 151643, 151643, 151643, 151643, 151643, 151643, 151643, 151643, 151643, 151643, 151643, 151643, 151643, 151643, 151643, 151643, 151643, 151643, 151643, 151643, 151643, 151643, 151643, 151643, 151643, 151643, 151643, 151643, 151643, 151643, 151643, 151643, 151643, 151643, 151643, 151643, 151643, 151643, 151643, 151643, 151643, 151643, 151643, 151643, 151643, 151643, 151643, 151643, 151643, 151643, 151643, 151643, 151643, 151643, 151643, 151643, 151643, 151643, 151643, 151643, 151643, 151643, 151643, 151643, 151643, 151643, 151643, 151643, 151643, 151643, 151643, 151643, 151643, 151643, 151643, 151643, 151643, 151643, 151643, 151643, 151643, 151643, 151643, 151643, 151643, 151643, 151643, 151643, 151643, 151643, 151643, 151643, 151643, 151643, 151643, 151643, 151643, 151643, 151643, 151643, 151643, 151643, 151643, 151643, 151643, 151643, 151643, 151643, 151643, 151643, 151643, 151643, 151643, 151643, 151643, 151643, 151643, 151643, 151643, 151643, 151643, 151643, 151643, 151643, 151643, 151643, 151643, 151643, 151643, 151643, 151643, 151643, 151643, 151643, 151643, 151643, 151643, 151643, 151643, 151643, 151643, 151643, 151643, 151643, 151643, 151643, 151643, 151643, 151643, 151643, 151643, 151643, 151643, 151643, 151643, 151643, 151643, 151643, 151643, 151643, 151643, 151643, 151643, 151643, 151643, 151643, 151643, 151643, 151643, 151643, 151643, 151643, 151643, 151643, 151643, 151643, 151643, 151643, 151643, 151643, 151643, 151643, 151643, 151643, 151643, 151643, 151643, 151643, 151643, 151643, 151643, 151643, 151643, 151643, 151643, 151643, 151643, 151643, 151643, 151643, 151643, 151643, 151643, 151643, 151643, 151643, 151643, 151643, 151643, 151643, 151643, 151643, 151643, 151643, 151643, 151643, 151643, 151643, 151643, 151643, 151643, 151643, 151643, 151643, 151643, 151643, 151643, 151643, 151643, 151643, 151643, 151643, 151643, 151643, 151643, 151643, 151643, 151643, 151643, 151643, 151643, 151643, 151643, 151643, 151643, 151643, 151643, 151643, 151643, 151643, 151643, 151643, 151643, 151643, 151643, 151643, 151643, 151643, 151643, 151643, 151643, 151643, 151643, 151643, 151643, 151643, 151643, 151643, 151643, 151643, 151643, 151643, 151643, 151643, 151643, 151643, 151643, 151643, 151643, 151643, 151643, 151643, 151643, 151643, 151643, 151643, 151643, 151643, 151643, 151643, 151643, 151643, 151643, 151643, 151643, 151643, 151643, 151643, 151643, 151643, 151643, 151643, 151643, 151643, 151643, 151643, 151643, 151643, 151643, 151643, 151643, 151643, 151643, 151643, 151643, 151643, 151643, 151643, 151643, 151643, 151643, 151643, 151643, 151643, 151643, 151643, 151643, 151643, 151643, 151643, 151643, 151643, 151643, 151643, 151643, 151643, 151643, 151643, 151643, 151643, 151643, 151643, 151643, 151643, 151643, 151643, 151643, 151643, 151643, 151643, 151643, 151643, 151643, 151643, 151643, 151643, 151643, 151643, 151643, 151643, 151643, 151643, 151643, 151643, 151643, 151643, 151643, 151643, 151643, 151643, 151643, 151643, 151643, 151643, 151643, 151643, 151643, 151643, 151643, 151643, 151643, 151643, 151643, 151643, 151643, 151643, 151643, 151643, 151643, 151643, 151643, 151643, 151643, 151643, 151643, 151644, 8948, 198, 2610, 525, 1207, 16948, 11, 3465, 553, 54364, 14817, 13, 1446, 525, 264, 10950, 17847, 13, 151645, 198, 151644, 872, 198, 16141, 279, 2701, 5248, 5754, 3405, 13, 576, 1537, 1555, 315, 697, 2033, 1265, 387, 315, 279, 2701, 3561, 25, 364, 16141, 25, 400, 20756, 4198, 6, 320, 28996, 17194, 8, 1380, 44428, 374, 825, 315, 19360, 35, 13, 21149, 3019, 553, 3019, 1573, 35764, 382, 37763, 804, 315, 264, 922, 66938, 3941, 279, 65569, 19745, 525, 1660, 11691, 700, 13, 434, 86495, 389, 279, 3143, 58041, 323, 28293, 19745, 11, 1052, 374, 264, 16162, 518, 45306, 315, 911, 220, 22, 24, 15, 25723, 11, 323, 518, 23327, 92859, 366, 220, 22, 24, 15, 25723, 279, 30305, 21025, 11941, 382, 2679, 582, 12163, 304, 264, 15494, 4512, 553, 44521, 12, 6484, 44, 1614, 1741, 429, 279, 1482, 472, 14600, 6783, 374, 220, 22, 15, 13136, 274, 49309, 16, 386, 3992, 49309, 16, 11, 4925, 17457, 5733, 374, 220, 15, 13, 18, 11, 6319, 4802, 17457, 5733, 374, 220, 15, 13, 22, 11, 323, 15494, 374, 10063, 345, 12555, 646, 387, 19110, 911, 279, 897, 315, 279, 469, 9130, 6010, 320, 1958, 5452, 8168, 264, 28, 16, 8, 315, 419, 922, 66938, 504, 279, 9237, 1939, 32, 8, 220, 21, 479, 3992, 198, 33, 8, 220, 24, 479, 3992, 198, 34, 8, 220, 22, 479, 3992, 198, 35, 8, 220, 23, 479, 3992, 151645, 198, 151644, 77091, 198]",,241,778,1019,0.0,0.0
2fff5133-6398-41b4-8287-1ddf892266be,7,58,"[151643, 151643, 151643, 151643, 151643, 151643, 151643, 151643, 151643, 151643, 151643, 151643, 151643, 151643, 151643, 151643, 151643, 151643, 151643, 151643, 151643, 151643, 151643, 151643, 151643, 151643, 151643, 151643, 151643, 151643, 151643, 151643, 151643, 151643, 151643, 151643, 151643, 151643, 151643, 151643, 151643, 151643, 151643, 151643, 151643, 151643, 151643, 151643, 151643, 151643, 151643, 151643, 151643, 151643, 151643, 151643, 151643, 151643, 151643, 151643, 151643, 151643, 151643, 151643, 151643, 151643, 151643, 151643, 151643, 151643, 151643, 151643, 151643, 151643, 151643, 151643, 151643, 151643, 151643, 151643, 151643, 151643, 151643, 151643, 151643, 151643, 151643, 151643, 151643, 151643, 151643, 151643, 151643, 151643, 151643, 151643, 151643, 151643, 151643, 151643, 151643, 151643, 151643, 151643, 151643, 151643, 151643, 151643, 151643, 151643, 151643, 151643, 151643, 151643, 151643, 151643, 151643, 151643, 151643, 151643, 151643, 151643, 151643, 151643, 151643, 151643, 151643, 151643, 151643, 151643, 151643, 151643, 151643, 151643, 151643, 151643, 151643, 151643, 151643, 151643, 151643, 151643, 151643, 151643, 151643, 151643, 151643, 151643, 151643, 151643, 151643, 151643, 151643, 151643, 151643, 151643, 151643, 151643, 151643, 151643, 151643, 151643, 151643, 151643, 151643, 151643, 151643, 151643, 151643, 151643, 151643, 151643, 151643, 151643, 151643, 151643, 151643, 151643, 151643, 151643, 151643, 151643, 151643, 151643, 151643, 151643, 151643, 151643, 151643, 151643, 151643, 151643, 151643, 151643, 151643, 151643, 151643, 151643, 151643, 151643, 151643, 151643, 151643, 151643, 151643, 151643, 151643, 151643, 151643, 151643, 151643, 151643, 151643, 151643, 151643, 151643, 151643, 151643, 151643, 151643, 151643, 151643, 151643, 151643, 151643, 151643, 151643, 151643, 151643, 151643, 151643, 151643, 151643, 151643, 151643, 151643, 151643, 151643, 151643, 151643, 151643, 151643, 151643, 151643, 151643, 151643, 151643, 151643, 151643, 151643, 151643, 151643, 151643, 151643, 151643, 151643, 151643, 151643, 151643, 151643, 151643, 151643, 151643, 151643, 151643, 151643, 151643, 151643, 151643, 151643, 151643, 151643, 151643, 151643, 151643, 151643, 151643, 151643, 151643, 151643, 151643, 151643, 151643, 151643, 151643, 151643, 151643, 151643, 151643, 151643, 151643, 151643, 151643, 151643, 151643, 151643, 151643, 151643, 151643, 151643, 151643, 151643, 151643, 151643, 151643, 151643, 151643, 151643, 151643, 151643, 151643, 151643, 151643, 151643, 151643, 151643, 151643, 151643, 151643, 151643, 151643, 151643, 151643, 151643, 151643, 151643, 151643, 151643, 151643, 151643, 151643, 151643, 151643, 151643, 151643, 151643, 151643, 151643, 151643, 151643, 151643, 151643, 151643, 151643, 151643, 151643, 151643, 151643, 151643, 151643, 151643, 151643, 151643, 151643, 151643, 151643, 151643, 151643, 151643, 151643, 151643, 151643, 151643, 151643, 151643, 151643, 151643, 151643, 151643, 151643, 151643, 151643, 151643, 151643, 151643, 151643, 151643, 151643, 151643, 151643, 151643, 151643, 151643, 151643, 151643, 151643, 151643, 151643, 151643, 151643, 151643, 151643, 151643, 151643, 151643, 151643, 151643, 151643, 151643, 151643, 151643, 151643, 151643, 151643, 151643, 151643, 151643, 151643, 151643, 151643, 151643, 151643, 151643, 151643, 151643, 151643, 151643, 151643, 151643, 151643, 151643, 151643, 151643, 151643, 151643, 151643, 151643, 151643, 151643, 151643, 151643, 151643, 151643, 151643, 151643, 151643, 151643, 151643, 151643, 151643, 151643, 151643, 151643, 151643, 151643, 151643, 151643, 151643, 151643, 151643, 151643, 151643, 151643, 151643, 151643, 151643, 151643, 151643, 151643, 151643, 151643, 151643, 151643, 151643, 151643, 151643, 151643, 151643, 151643, 151643, 151643, 151643, 151643, 151643, 151643, 151643, 151643, 151643, 151643, 151643, 151643, 151643, 151643, 151643, 151643, 151643, 151643, 151643, 151643, 151643, 151643, 151643, 151643, 151643, 151643, 151643, 151643, 151643, 151643, 151643, 151643, 151643, 151643, 151643, 151643, 151643, 151643, 151643, 151643, 151643, 151643, 151643, 151643, 151643, 151643, 151643, 151643, 151643, 151643, 151643, 151643, 151643, 151643, 151643, 151643, 151643, 151643, 151643, 151643, 151643, 151643, 151643, 151643, 151643, 151643, 151643, 151643, 151643, 151643, 151643, 151643, 151643, 151643, 151643, 151643, 151643, 151643, 151643, 151643, 151643, 151643, 151643, 151643, 151643, 151643, 151643, 151643, 151643, 151643, 151643, 151643, 151643, 151643, 151643, 151643, 151643, 151643, 151643, 151643, 151643, 151643, 151643, 151643, 151643, 151643, 151643, 151643, 151643, 151643, 151643, 151643, 151643, 151643, 151643, 151643, 151643, 151643, 151643, 151643, 151643, 151643, 151643, 151643, 151643, 151643, 151643, 151643, 151643, 151643, 151643, 151643, 151643, 151643, 151643, 151643, 151643, 151643, 151643, 151643, 151643, 151643, 151643, 151643, 151643, 151643, 151643, 151643, 151643, 151643, 151643, 151643, 151643, 151643, 151643, 151643, 151643, 151643, 151643, 151643, 151643, 151643, 151643, 151643, 151643, 151643, 151643, 151643, 151643, 151643, 151643, 151643, 151643, 151643, 151643, 151643, 151643, 151643, 151643, 151643, 151643, 151643, 151643, 151643, 151643, 151643, 151643, 151643, 151643, 151643, 151643, 151643, 151643, 151643, 151643, 151643, 151643, 151643, 151643, 151643, 151643, 151643, 151643, 151643, 151643, 151643, 151643, 151643, 151643, 151643, 151643, 151643, 151643, 151643, 151643, 151643, 151643, 151643, 151643, 151643, 151643, 151643, 151643, 151643, 151643, 151643, 151643, 151643, 151643, 151643, 151643, 151643, 151643, 151643, 151643, 151643, 151643, 151643, 151643, 151643, 151643, 151643, 151643, 151643, 151643, 151643, 151643, 151643, 151643, 151643, 151643, 151643, 151643, 151643, 151643, 151643, 151643, 151643, 151643, 151643, 151643, 151643, 151643, 151643, 151643, 151643, 151643, 151643, 151643, 151643, 151643, 151643, 151643, 151643, 151643, 151643, 151643, 151643, 151643, 151643, 151643, 151643, 151643, 151643, 151643, 151643, 151643, 151643, 151643, 151643, 151643, 151643, 151643, 151643, 151643, 151643, 151643, 151643, 151643, 151643, 151643, 151643, 151643, 151643, 151643, 151643, 151643, 151643, 151643, 151643, 151643, 151643, 151643, 151643, 151643, 151643, 151643, 151643, 151643, 151643, 151643, 151643, 151643, 151643, 151643, 151643, 151643, 151643, 151643, 151643, 151643, 151643, 151643, 151643, 151643, 151643, 151643, 151643, 151643, 151643, 151643, 151643, 151643, 151643, 151643, 151643, 151643, 151643, 151643, 151643, 151644, 8948, 198, 2610, 525, 1207, 16948, 11, 3465, 553, 54364, 14817, 13, 1446, 525, 264, 10950, 17847, 13, 151645, 198, 151644, 872, 198, 16141, 279, 2701, 5248, 5754, 3405, 13, 576, 1537, 1555, 315, 697, 2033, 1265, 387, 315, 279, 2701, 3561, 25, 364, 16141, 25, 400, 20756, 4198, 6, 320, 28996, 17194, 8, 1380, 44428, 374, 825, 315, 19360, 35, 13, 21149, 3019, 553, 3019, 1573, 35764, 382, 32, 12616, 33802, 18790, 374, 304, 264, 13482, 2256, 3487, 220, 15, 13, 20, 22957, 454, 6044, 12016, 4044, 10, 26888, 7, 18, 5620, 17, 22957, 2923, 6044, 12016, 4044, 315, 1181, 12616, 5239, 323, 12616, 14875, 5302, 13, 1416, 63596, 454, 6044, 12016, 4044, 323, 63596, 2923, 6044, 12016, 4044, 525, 279, 28724, 32069, 315, 1124, 24912, 90, 89, 92, 1154, 1221, 1128, 374, 279, 30193, 897, 705, 311, 825, 12122, 1992, 11, 315, 279, 5675, 220, 16, 15, 59, 24912, 90, 89, 92, 10, 20, 59, 24912, 15159, 87, 92, 937, 5692, 11, 17738, 614, 862, 13475, 49700, 271, 32, 8, 481, 16, 13, 19, 198, 33, 8, 220, 15, 13, 23, 20, 198, 34, 8, 481, 15, 13, 22, 198, 35, 8, 220, 16, 13, 21, 20, 151645, 198, 151644, 77091, 198]",,205,1058,1263,1.0,1.0
00445624-e8b2-4705-8f0b-91649ad304b4,7,59,"[151643, 151643, 151643, 151643, 151643, 151643, 151643, 151643, 151643, 151643, 151643, 151643, 151643, 151643, 151643, 151643, 151643, 151643, 151643, 151643, 151643, 151643, 151643, 151643, 151643, 151643, 151643, 151643, 151643, 151643, 151643, 151643, 151643, 151643, 151643, 151643, 151643, 151643, 151643, 151643, 151643, 151643, 151643, 151643, 151643, 151643, 151643, 151643, 151643, 151643, 151643, 151643, 151643, 151643, 151643, 151643, 151643, 151643, 151643, 151643, 151643, 151643, 151643, 151643, 151643, 151643, 151643, 151643, 151643, 151643, 151643, 151643, 151643, 151643, 151643, 151643, 151643, 151643, 151643, 151643, 151643, 151643, 151643, 151643, 151643, 151643, 151643, 151643, 151643, 151643, 151643, 151643, 151643, 151643, 151643, 151643, 151643, 151643, 151643, 151643, 151643, 151643, 151643, 151643, 151643, 151643, 151643, 151643, 151643, 151643, 151643, 151643, 151643, 151643, 151643, 151643, 151643, 151643, 151643, 151643, 151643, 151643, 151643, 151643, 151643, 151643, 151643, 151643, 151643, 151643, 151643, 151643, 151643, 151643, 151643, 151643, 151643, 151643, 151643, 151643, 151643, 151643, 151643, 151643, 151643, 151643, 151643, 151643, 151643, 151643, 151643, 151643, 151643, 151643, 151643, 151643, 151643, 151643, 151643, 151643, 151643, 151643, 151643, 151643, 151643, 151643, 151643, 151643, 151643, 151643, 151643, 151643, 151643, 151643, 151643, 151643, 151643, 151643, 151643, 151643, 151643, 151643, 151643, 151643, 151643, 151643, 151643, 151643, 151643, 151643, 151643, 151643, 151643, 151643, 151643, 151643, 151643, 151643, 151643, 151643, 151643, 151643, 151643, 151643, 151643, 151643, 151643, 151643, 151643, 151643, 151643, 151643, 151643, 151643, 151643, 151643, 151643, 151643, 151643, 151643, 151643, 151643, 151643, 151643, 151643, 151643, 151643, 151643, 151643, 151643, 151643, 151643, 151643, 151643, 151643, 151643, 151643, 151643, 151643, 151643, 151643, 151643, 151643, 151643, 151643, 151643, 151643, 151643, 151643, 151643, 151643, 151643, 151643, 151643, 151643, 151643, 151643, 151643, 151643, 151643, 151643, 151643, 151643, 151643, 151643, 151643, 151643, 151643, 151643, 151643, 151643, 151643, 151643, 151643, 151643, 151643, 151643, 151643, 151643, 151643, 151643, 151643, 151643, 151643, 151643, 151643, 151643, 151643, 151643, 151643, 151643, 151643, 151643, 151643, 151643, 151643, 151643, 151643, 151643, 151643, 151643, 151643, 151643, 151643, 151643, 151643, 151643, 151643, 151643, 151643, 151643, 151643, 151643, 151643, 151643, 151643, 151643, 151643, 151643, 151643, 151643, 151643, 151643, 151643, 151643, 151643, 151643, 151643, 151643, 151643, 151643, 151643, 151643, 151643, 151643, 151643, 151643, 151643, 151643, 151643, 151643, 151643, 151643, 151643, 151643, 151643, 151643, 151643, 151643, 151643, 151643, 151643, 151643, 151643, 151643, 151643, 151643, 151643, 151643, 151643, 151643, 151643, 151643, 151643, 151643, 151643, 151643, 151643, 151643, 151643, 151643, 151643, 151643, 151643, 151643, 151643, 151643, 151643, 151643, 151643, 151643, 151643, 151643, 151643, 151643, 151643, 151643, 151643, 151643, 151643, 151643, 151643, 151643, 151643, 151643, 151643, 151643, 151643, 151643, 151643, 151643, 151643, 151643, 151643, 151643, 151643, 151643, 151643, 151643, 151643, 151643, 151643, 151643, 151643, 151643, 151643, 151643, 151643, 151643, 151643, 151643, 151643, 151643, 151643, 151643, 151643, 151643, 151643, 151643, 151643, 151643, 151643, 151643, 151643, 151643, 151643, 151643, 151643, 151643, 151643, 151643, 151643, 151643, 151643, 151643, 151643, 151643, 151643, 151643, 151643, 151643, 151643, 151643, 151643, 151643, 151643, 151643, 151643, 151643, 151643, 151643, 151643, 151643, 151643, 151643, 151643, 151643, 151643, 151643, 151643, 151643, 151643, 151643, 151643, 151643, 151643, 151643, 151643, 151643, 151643, 151643, 151643, 151643, 151643, 151643, 151643, 151643, 151643, 151643, 151643, 151643, 151643, 151643, 151643, 151643, 151643, 151643, 151643, 151643, 151643, 151643, 151643, 151643, 151643, 151643, 151643, 151643, 151643, 151643, 151643, 151643, 151643, 151643, 151643, 151643, 151643, 151643, 151643, 151643, 151643, 151643, 151643, 151643, 151643, 151643, 151643, 151643, 151643, 151643, 151643, 151643, 151643, 151643, 151643, 151643, 151643, 151643, 151643, 151643, 151643, 151643, 151643, 151643, 151643, 151643, 151643, 151643, 151643, 151643, 151643, 151643, 151643, 151643, 151643, 151643, 151643, 151643, 151643, 151643, 151643, 151643, 151643, 151643, 151643, 151643, 151643, 151643, 151643, 151643, 151643, 151643, 151643, 151643, 151643, 151643, 151643, 151643, 151643, 151643, 151643, 151643, 151643, 151643, 151643, 151643, 151643, 151643, 151643, 151643, 151643, 151643, 151643, 151643, 151643, 151643, 151643, 151643, 151643, 151643, 151643, 151643, 151643, 151643, 151643, 151643, 151643, 151643, 151643, 151643, 151643, 151643, 151643, 151643, 151643, 151643, 151643, 151643, 151643, 151643, 151643, 151643, 151643, 151643, 151643, 151643, 151643, 151643, 151643, 151643, 151643, 151643, 151643, 151643, 151643, 151643, 151643, 151643, 151643, 151643, 151643, 151643, 151643, 151643, 151643, 151643, 151643, 151643, 151643, 151643, 151643, 151643, 151643, 151643, 151643, 151643, 151643, 151643, 151643, 151643, 151643, 151643, 151643, 151643, 151643, 151643, 151643, 151643, 151643, 151643, 151643, 151643, 151643, 151643, 151643, 151643, 151643, 151643, 151643, 151643, 151643, 151643, 151643, 151643, 151643, 151643, 151643, 151643, 151643, 151643, 151643, 151643, 151643, 151643, 151643, 151643, 151643, 151643, 151643, 151643, 151643, 151643, 151643, 151643, 151643, 151643, 151643, 151643, 151643, 151643, 151643, 151643, 151644, 8948, 198, 2610, 525, 1207, 16948, 11, 3465, 553, 54364, 14817, 13, 1446, 525, 264, 10950, 17847, 13, 151645, 198, 151644, 872, 198, 16141, 279, 2701, 5248, 5754, 3405, 13, 576, 1537, 1555, 315, 697, 2033, 1265, 387, 315, 279, 2701, 3561, 25, 364, 16141, 25, 400, 20756, 4198, 6, 320, 28996, 17194, 8, 1380, 44428, 374, 825, 315, 19360, 35, 13, 21149, 3019, 553, 3019, 1573, 35764, 382, 18, 8013, 66129, 87, 1600, 41872, 7287, 20, 8013, 2674, 12, 16, 20767, 12, 17, 12, 3923, 46986, 3337, 385, 17308, 276, 12, 16, 18589, 374, 11758, 448, 38595, 6275, 67, 1399, 11, 8110, 553, 70946, 3923, 93471, 577, 11, 29064, 1985, 220, 16, 382, 16, 374, 11758, 448, 281, 2385, 337, 10316, 288, 360, 13172, 75, 6275, 67, 8703, 577, 304, 279, 9362, 315, 264, 33354, 69404, 3311, 315, 472, 5066, 11, 29064, 1985, 220, 17, 382, 17, 374, 11758, 518, 3347, 9315, 448, 308, 1455, 20237, 654, 410, 2356, 11, 8110, 553, 65200, 782, 68811, 2356, 81782, 11, 29064, 1985, 220, 18, 382, 18, 374, 74840, 448, 393, 67, 11295, 1212, 264, 34684, 16566, 11, 29064, 1985, 220, 19, 382, 3838, 374, 279, 5944, 315, 1985, 220, 19, 1939, 32, 8, 320, 18, 30430, 453, 887, 3923, 66, 3337, 385, 17308, 3923, 46607, 769, 38610, 198, 33, 8, 451, 6, 8013, 18, 8013, 66129, 87, 1600, 41872, 7287, 20, 30430, 453, 887, 3923, 66, 3337, 385, 17308, 3923, 7287, 19, 1448, 41872, 7964, 5679, 288, 14308, 263, 2267, 40121, 8703, 577, 198, 34, 8, 11600, 18, 30430, 453, 887, 3923, 66, 3337, 385, 17308, 3923, 46607, 769, 60163, 46607, 41872, 8, 7964, 89, 1952, 198, 35, 8, 220, 18, 12, 1188, 7964, 4246, 385, 4130, 46607, 41872, 7287, 16, 69796, 3923, 12, 20, 30430, 453, 887, 3923, 66, 3337, 385, 17308, 276, 12, 16, 12, 337, 151645, 198, 151644, 77091, 198]",,313,783,1096,0.0,0.0
7a679ed1-b54a-4c91-ba31-8a1a32441eeb,7,60,"[151643, 151643, 151643, 151643, 151643, 151643, 151643, 151643, 151643, 151643, 151643, 151643, 151643, 151643, 151643, 151643, 151643, 151643, 151643, 151643, 151643, 151643, 151643, 151643, 151643, 151643, 151643, 151643, 151643, 151643, 151643, 151643, 151643, 151643, 151643, 151643, 151643, 151643, 151643, 151643, 151643, 151643, 151643, 151643, 151643, 151643, 151643, 151643, 151643, 151643, 151643, 151643, 151643, 151643, 151643, 151643, 151643, 151643, 151643, 151643, 151643, 151643, 151643, 151643, 151643, 151643, 151643, 151643, 151643, 151643, 151643, 151643, 151643, 151643, 151643, 151643, 151643, 151643, 151643, 151643, 151643, 151643, 151643, 151643, 151643, 151643, 151643, 151643, 151643, 151643, 151643, 151643, 151643, 151643, 151643, 151643, 151643, 151643, 151643, 151643, 151643, 151643, 151643, 151643, 151643, 151643, 151643, 151643, 151643, 151643, 151643, 151643, 151643, 151643, 151643, 151643, 151643, 151643, 151643, 151643, 151643, 151643, 151643, 151643, 151643, 151643, 151643, 151643, 151643, 151643, 151643, 151643, 151643, 151643, 151643, 151643, 151643, 151643, 151643, 151643, 151643, 151643, 151643, 151643, 151643, 151643, 151643, 151643, 151643, 151643, 151643, 151643, 151643, 151643, 151643, 151643, 151643, 151643, 151643, 151643, 151643, 151643, 151643, 151643, 151643, 151643, 151643, 151643, 151643, 151643, 151643, 151643, 151643, 151643, 151643, 151643, 151643, 151643, 151643, 151643, 151643, 151643, 151643, 151643, 151643, 151643, 151643, 151643, 151643, 151643, 151643, 151643, 151643, 151643, 151643, 151643, 151643, 151643, 151643, 151643, 151643, 151643, 151643, 151643, 151643, 151643, 151643, 151643, 151643, 151643, 151643, 151643, 151643, 151643, 151643, 151643, 151643, 151643, 151643, 151643, 151643, 151643, 151643, 151643, 151643, 151643, 151643, 151643, 151643, 151643, 151643, 151643, 151643, 151643, 151643, 151643, 151643, 151643, 151643, 151643, 151643, 151643, 151643, 151643, 151643, 151643, 151643, 151643, 151643, 151643, 151643, 151643, 151643, 151643, 151643, 151643, 151643, 151643, 151643, 151643, 151643, 151643, 151643, 151643, 151643, 151643, 151643, 151643, 151643, 151643, 151643, 151643, 151643, 151643, 151643, 151643, 151643, 151643, 151643, 151643, 151643, 151643, 151643, 151643, 151643, 151643, 151643, 151643, 151643, 151643, 151643, 151643, 151643, 151643, 151643, 151643, 151643, 151643, 151643, 151643, 151643, 151643, 151643, 151643, 151643, 151643, 151643, 151643, 151643, 151643, 151643, 151643, 151643, 151643, 151643, 151643, 151643, 151643, 151643, 151643, 151643, 151643, 151643, 151643, 151643, 151643, 151643, 151643, 151643, 151643, 151643, 151643, 151643, 151643, 151643, 151643, 151643, 151643, 151643, 151643, 151643, 151643, 151643, 151643, 151643, 151643, 151643, 151643, 151643, 151643, 151643, 151643, 151643, 151643, 151643, 151643, 151643, 151643, 151643, 151643, 151643, 151643, 151643, 151643, 151643, 151643, 151643, 151643, 151643, 151643, 151643, 151643, 151643, 151643, 151643, 151643, 151643, 151643, 151643, 151643, 151643, 151643, 151643, 151643, 151643, 151643, 151643, 151643, 151643, 151643, 151643, 151643, 151643, 151643, 151643, 151643, 151643, 151643, 151643, 151643, 151643, 151643, 151643, 151643, 151643, 151643, 151643, 151643, 151643, 151643, 151643, 151643, 151643, 151643, 151643, 151643, 151643, 151643, 151643, 151643, 151643, 151643, 151643, 151643, 151643, 151643, 151643, 151643, 151643, 151643, 151643, 151643, 151643, 151643, 151643, 151643, 151643, 151643, 151643, 151643, 151643, 151643, 151643, 151643, 151643, 151643, 151643, 151643, 151643, 151643, 151643, 151643, 151643, 151643, 151643, 151643, 151643, 151643, 151643, 151643, 151643, 151643, 151643, 151643, 151643, 151643, 151643, 151643, 151643, 151643, 151643, 151643, 151643, 151643, 151643, 151643, 151643, 151643, 151643, 151643, 151643, 151643, 151643, 151643, 151643, 151643, 151643, 151643, 151643, 151643, 151643, 151643, 151643, 151643, 151643, 151643, 151643, 151643, 151643, 151643, 151643, 151643, 151643, 151643, 151643, 151643, 151643, 151643, 151643, 151643, 151643, 151643, 151643, 151643, 151643, 151643, 151643, 151643, 151643, 151643, 151643, 151643, 151643, 151643, 151643, 151643, 151643, 151643, 151643, 151643, 151643, 151643, 151643, 151643, 151643, 151643, 151643, 151643, 151643, 151643, 151643, 151643, 151643, 151643, 151643, 151643, 151643, 151643, 151643, 151643, 151643, 151643, 151643, 151643, 151643, 151643, 151643, 151643, 151643, 151643, 151643, 151643, 151643, 151643, 151643, 151643, 151643, 151643, 151643, 151643, 151643, 151643, 151643, 151643, 151643, 151643, 151643, 151643, 151643, 151643, 151643, 151643, 151643, 151643, 151643, 151643, 151643, 151643, 151643, 151643, 151643, 151643, 151643, 151643, 151643, 151643, 151643, 151643, 151643, 151643, 151643, 151643, 151643, 151643, 151643, 151643, 151643, 151643, 151643, 151643, 151643, 151643, 151643, 151643, 151643, 151643, 151643, 151643, 151643, 151643, 151643, 151643, 151643, 151643, 151643, 151643, 151643, 151643, 151643, 151643, 151643, 151643, 151643, 151643, 151643, 151643, 151643, 151643, 151643, 151643, 151643, 151643, 151643, 151643, 151643, 151643, 151643, 151643, 151643, 151643, 151643, 151643, 151643, 151643, 151643, 151643, 151643, 151643, 151643, 151643, 151643, 151643, 151643, 151643, 151643, 151643, 151643, 151643, 151643, 151643, 151643, 151643, 151643, 151643, 151643, 151643, 151643, 151643, 151643, 151643, 151643, 151643, 151643, 151643, 151643, 151643, 151643, 151643, 151643, 151643, 151643, 151643, 151643, 151643, 151643, 151643, 151643, 151643, 151643, 151643, 151643, 151643, 151643, 151643, 151643, 151643, 151643, 151643, 151643, 151643, 151643, 151643, 151643, 151643, 151643, 151643, 151643, 151643, 151643, 151643, 151643, 151643, 151643, 151643, 151643, 151643, 151643, 151643, 151643, 151643, 151643, 151643, 151643, 151643, 151643, 151643, 151643, 151643, 151643, 151643, 151643, 151643, 151643, 151643, 151643, 151643, 151643, 151643, 151643, 151643, 151643, 151643, 151643, 151643, 151643, 151643, 151643, 151643, 151643, 151643, 151643, 151643, 151643, 151643, 151643, 151643, 151643, 151643, 151643, 151643, 151643, 151643, 151643, 151643, 151643, 151643, 151643, 151643, 151643, 151643, 151643, 151643, 151643, 151643, 151643, 151643, 151643, 151643, 151643, 151643, 151643, 151643, 151643, 151643, 151643, 151643, 151643, 151643, 151643, 151643, 151643, 151643, 151643, 151643, 151643, 151643, 151643, 151643, 151643, 151643, 151643, 151643, 151643, 151643, 151643, 151643, 151643, 151643, 151643, 151643, 151643, 151643, 151643, 151643, 151643, 151643, 151643, 151643, 151643, 151643, 151643, 151643, 151643, 151643, 151643, 151643, 151643, 151643, 151644, 8948, 198, 2610, 525, 1207, 16948, 11, 3465, 553, 54364, 14817, 13, 1446, 525, 264, 10950, 17847, 13, 151645, 198, 151644, 872, 198, 16141, 279, 2701, 5248, 5754, 3405, 13, 576, 1537, 1555, 315, 697, 2033, 1265, 387, 315, 279, 2701, 3561, 25, 364, 16141, 25, 400, 20756, 4198, 6, 320, 28996, 17194, 8, 1380, 44428, 374, 825, 315, 19360, 35, 13, 21149, 3019, 553, 3019, 1573, 35764, 382, 3862, 374, 264, 12616, 220, 16, 14, 17, 18790, 448, 23970, 4445, 11834, 38738, 21619, 68207, 89, 701, 26118, 448, 264, 23970, 2070, 21633, 304, 279, 488, 57, 5106, 13, 57701, 11, 279, 23970, 2070, 374, 6519, 1007, 11, 323, 2441, 825, 374, 6519, 389, 3156, 279, 488, 56, 5106, 26, 2176, 5043, 614, 279, 1852, 25621, 11, 425, 13, 576, 5461, 315, 279, 1147, 41387, 315, 279, 18790, 748, 4445, 8471, 42424, 1095, 13, 3555, 374, 1181, 42424, 367, 11639, 1939, 32, 8, 21619, 81339, 14, 17, 198, 33, 8, 17946, 7, 17, 4806, 32214, 81339, 198, 34, 8, 21619, 81339, 2687, 8140, 7, 17, 340, 35, 8, 21619, 81339, 151645, 198, 151644, 77091, 198]",,186,456,642,1.0,1.0
8b6482fa-2955-4b4d-b5a1-34c93fbd7da8,7,61,"[151643, 151643, 151643, 151643, 151643, 151643, 151643, 151643, 151643, 151643, 151643, 151643, 151643, 151643, 151643, 151643, 151643, 151643, 151643, 151643, 151643, 151643, 151643, 151643, 151643, 151643, 151643, 151643, 151643, 151643, 151643, 151643, 151643, 151643, 151643, 151643, 151643, 151643, 151643, 151643, 151643, 151643, 151643, 151643, 151643, 151643, 151643, 151643, 151643, 151643, 151643, 151643, 151643, 151643, 151643, 151643, 151643, 151643, 151643, 151643, 151643, 151643, 151643, 151643, 151643, 151643, 151643, 151643, 151643, 151643, 151643, 151643, 151643, 151643, 151643, 151643, 151643, 151643, 151643, 151643, 151643, 151643, 151643, 151643, 151643, 151643, 151643, 151643, 151643, 151643, 151643, 151643, 151643, 151643, 151643, 151643, 151643, 151643, 151643, 151643, 151643, 151643, 151643, 151643, 151643, 151643, 151643, 151643, 151643, 151643, 151643, 151643, 151643, 151643, 151643, 151643, 151643, 151643, 151643, 151643, 151643, 151643, 151643, 151643, 151643, 151643, 151643, 151643, 151643, 151643, 151643, 151643, 151643, 151643, 151643, 151643, 151643, 151643, 151643, 151643, 151643, 151643, 151643, 151643, 151643, 151643, 151643, 151643, 151643, 151643, 151643, 151643, 151643, 151643, 151643, 151643, 151643, 151643, 151643, 151643, 151643, 151643, 151643, 151643, 151643, 151643, 151643, 151643, 151643, 151643, 151643, 151643, 151643, 151643, 151643, 151643, 151643, 151643, 151643, 151643, 151643, 151643, 151643, 151643, 151643, 151643, 151643, 151643, 151643, 151643, 151643, 151643, 151643, 151643, 151643, 151643, 151643, 151643, 151643, 151643, 151643, 151643, 151643, 151643, 151643, 151643, 151643, 151643, 151643, 151643, 151643, 151643, 151643, 151643, 151643, 151643, 151643, 151643, 151643, 151643, 151643, 151643, 151643, 151643, 151643, 151643, 151643, 151643, 151643, 151643, 151643, 151643, 151643, 151643, 151643, 151643, 151643, 151643, 151643, 151643, 151643, 151643, 151643, 151643, 151643, 151643, 151643, 151643, 151643, 151643, 151643, 151643, 151643, 151643, 151643, 151643, 151643, 151643, 151643, 151643, 151643, 151643, 151643, 151643, 151643, 151643, 151643, 151643, 151643, 151643, 151643, 151643, 151643, 151643, 151643, 151643, 151643, 151643, 151643, 151643, 151643, 151643, 151643, 151643, 151643, 151643, 151643, 151643, 151643, 151643, 151643, 151643, 151643, 151643, 151643, 151643, 151643, 151643, 151643, 151643, 151643, 151643, 151643, 151643, 151643, 151643, 151643, 151643, 151643, 151643, 151643, 151643, 151643, 151643, 151643, 151643, 151643, 151643, 151643, 151643, 151643, 151643, 151643, 151643, 151643, 151643, 151643, 151643, 151643, 151643, 151643, 151643, 151643, 151643, 151643, 151643, 151643, 151643, 151643, 151643, 151643, 151643, 151643, 151643, 151643, 151643, 151643, 151643, 151643, 151643, 151643, 151643, 151643, 151643, 151643, 151643, 151643, 151643, 151643, 151643, 151643, 151643, 151643, 151643, 151643, 151643, 151643, 151643, 151643, 151643, 151643, 151643, 151643, 151643, 151643, 151643, 151643, 151643, 151643, 151643, 151643, 151643, 151643, 151643, 151643, 151643, 151643, 151643, 151643, 151643, 151643, 151643, 151643, 151643, 151643, 151643, 151643, 151643, 151643, 151643, 151643, 151643, 151643, 151643, 151643, 151643, 151643, 151643, 151643, 151643, 151643, 151643, 151643, 151643, 151643, 151643, 151643, 151643, 151643, 151643, 151643, 151643, 151643, 151643, 151643, 151643, 151643, 151643, 151643, 151643, 151643, 151643, 151643, 151643, 151643, 151643, 151643, 151643, 151643, 151643, 151643, 151643, 151643, 151643, 151643, 151643, 151643, 151643, 151643, 151643, 151643, 151643, 151643, 151643, 151643, 151643, 151643, 151643, 151643, 151643, 151643, 151643, 151643, 151643, 151643, 151643, 151643, 151643, 151643, 151643, 151643, 151643, 151643, 151643, 151643, 151643, 151643, 151643, 151643, 151643, 151643, 151643, 151643, 151643, 151643, 151643, 151643, 151643, 151643, 151643, 151643, 151643, 151643, 151643, 151643, 151643, 151643, 151643, 151643, 151643, 151643, 151643, 151643, 151643, 151643, 151643, 151643, 151643, 151643, 151643, 151643, 151643, 151643, 151643, 151643, 151643, 151643, 151643, 151643, 151643, 151643, 151643, 151643, 151643, 151643, 151643, 151643, 151643, 151643, 151643, 151643, 151643, 151643, 151643, 151643, 151643, 151643, 151643, 151643, 151643, 151643, 151643, 151643, 151643, 151643, 151643, 151643, 151643, 151643, 151643, 151643, 151643, 151643, 151643, 151643, 151643, 151643, 151643, 151643, 151643, 151643, 151643, 151643, 151643, 151643, 151643, 151643, 151643, 151643, 151643, 151643, 151643, 151643, 151643, 151643, 151643, 151643, 151643, 151643, 151643, 151643, 151643, 151643, 151643, 151643, 151643, 151643, 151643, 151643, 151643, 151643, 151643, 151643, 151643, 151643, 151643, 151643, 151643, 151643, 151643, 151643, 151643, 151643, 151643, 151643, 151643, 151643, 151643, 151643, 151643, 151643, 151643, 151643, 151643, 151643, 151643, 151643, 151643, 151643, 151643, 151643, 151643, 151643, 151643, 151643, 151643, 151643, 151643, 151643, 151643, 151643, 151643, 151643, 151643, 151643, 151643, 151643, 151643, 151643, 151643, 151643, 151643, 151643, 151643, 151643, 151643, 151643, 151643, 151643, 151643, 151643, 151643, 151643, 151643, 151643, 151643, 151643, 151643, 151643, 151643, 151643, 151643, 151643, 151643, 151643, 151643, 151643, 151643, 151643, 151643, 151643, 151643, 151643, 151643, 151643, 151643, 151643, 151643, 151643, 151643, 151643, 151643, 151643, 151643, 151643, 151643, 151643, 151643, 151643, 151643, 151643, 151643, 151643, 151643, 151643, 151643, 151643, 151643, 151643, 151643, 151643, 151643, 151643, 151643, 151643, 151643, 151643, 151643, 151643, 151643, 151643, 151643, 151643, 151643, 151643, 151643, 151643, 151643, 151643, 151643, 151643, 151643, 151643, 151643, 151643, 151643, 151643, 151643, 151643, 151643, 151643, 151643, 151643, 151643, 151643, 151643, 151643, 151643, 151643, 151643, 151643, 151643, 151643, 151643, 151643, 151643, 151643, 151643, 151643, 151643, 151643, 151643, 151643, 151643, 151643, 151643, 151643, 151643, 151643, 151643, 151643, 151643, 151643, 151643, 151643, 151643, 151643, 151643, 151643, 151643, 151643, 151643, 151643, 151643, 151643, 151643, 151643, 151643, 151643, 151643, 151643, 151643, 151643, 151643, 151643, 151643, 151643, 151643, 151643, 151643, 151643, 151643, 151644, 8948, 198, 2610, 525, 1207, 16948, 11, 3465, 553, 54364, 14817, 13, 1446, 525, 264, 10950, 17847, 13, 151645, 198, 151644, 872, 198, 16141, 279, 2701, 5248, 5754, 3405, 13, 576, 1537, 1555, 315, 697, 2033, 1265, 387, 315, 279, 2701, 3561, 25, 364, 16141, 25, 400, 20756, 4198, 6, 320, 28996, 17194, 8, 1380, 44428, 374, 825, 315, 19360, 35, 13, 21149, 3019, 553, 3019, 1573, 35764, 382, 28301, 1437, 279, 3204, 1985, 979, 320, 16, 50, 11, 19, 49, 7287, 17, 8273, 258, 3923, 12, 17, 12, 1370, 370, 2842, 32578, 58, 17, 13, 17, 13, 16, 60, 383, 417, 12, 20, 12, 1952, 36671, 288, 356, 2792, 55327, 56633, 382, 32, 8, 220, 19, 11, 21, 11, 22, 11, 22, 64, 2385, 295, 956, 66129, 12, 18, 39, 1786, 3337, 22288, 16576, 12447, 60, 3288, 1869, 482, 198, 33, 8, 220, 19, 11, 19, 64, 11, 22, 11, 22, 64, 2385, 295, 956, 66129, 12, 16, 39, 1786, 3337, 22288, 16576, 12447, 60, 3288, 1869, 482, 198, 34, 8, 220, 19, 11, 19, 64, 11, 20, 11, 21, 2385, 295, 956, 66129, 12, 16, 39, 1786, 3337, 22288, 16576, 12447, 60, 3288, 1869, 482, 198, 35, 8, 220, 19, 11, 19, 64, 11, 20, 11, 22, 64, 2385, 295, 956, 66129, 12, 18, 39, 1786, 3337, 22288, 16576, 12447, 60, 3288, 1869, 482, 151645, 198, 151644, 77091, 198]",,232,490,722,1.0,1.0
676c8359-4397-4887-8f4b-20a5d5a81b9a,7,62,"[151643, 151643, 151643, 151643, 151643, 151643, 151643, 151643, 151643, 151643, 151643, 151643, 151643, 151643, 151643, 151643, 151643, 151643, 151643, 151643, 151643, 151643, 151643, 151643, 151643, 151643, 151643, 151643, 151643, 151643, 151643, 151643, 151643, 151643, 151643, 151643, 151643, 151643, 151643, 151643, 151643, 151643, 151643, 151643, 151643, 151643, 151643, 151643, 151643, 151643, 151643, 151643, 151643, 151643, 151643, 151643, 151643, 151643, 151643, 151643, 151643, 151643, 151643, 151643, 151643, 151643, 151643, 151643, 151643, 151643, 151643, 151643, 151643, 151643, 151643, 151643, 151643, 151643, 151643, 151643, 151643, 151643, 151643, 151643, 151643, 151643, 151643, 151643, 151643, 151643, 151643, 151643, 151643, 151643, 151643, 151643, 151643, 151643, 151643, 151643, 151643, 151643, 151643, 151643, 151643, 151643, 151643, 151643, 151643, 151643, 151643, 151643, 151643, 151643, 151643, 151643, 151643, 151643, 151643, 151643, 151643, 151643, 151643, 151643, 151643, 151643, 151643, 151643, 151643, 151643, 151643, 151643, 151643, 151643, 151643, 151643, 151643, 151643, 151643, 151643, 151643, 151643, 151643, 151643, 151643, 151643, 151643, 151643, 151643, 151643, 151643, 151643, 151643, 151643, 151643, 151643, 151643, 151643, 151643, 151643, 151643, 151643, 151643, 151643, 151643, 151643, 151643, 151643, 151643, 151643, 151643, 151643, 151643, 151643, 151643, 151643, 151643, 151643, 151643, 151643, 151643, 151643, 151643, 151643, 151643, 151643, 151643, 151643, 151643, 151643, 151643, 151643, 151643, 151643, 151643, 151643, 151643, 151643, 151643, 151643, 151643, 151643, 151643, 151643, 151643, 151643, 151643, 151643, 151643, 151643, 151643, 151643, 151643, 151643, 151643, 151643, 151643, 151643, 151643, 151643, 151643, 151643, 151643, 151643, 151643, 151643, 151643, 151643, 151643, 151643, 151643, 151643, 151643, 151643, 151643, 151643, 151643, 151643, 151643, 151643, 151643, 151643, 151643, 151643, 151643, 151643, 151643, 151643, 151643, 151643, 151643, 151643, 151643, 151643, 151643, 151643, 151643, 151643, 151643, 151643, 151643, 151643, 151643, 151643, 151643, 151643, 151643, 151643, 151643, 151643, 151643, 151643, 151643, 151643, 151643, 151643, 151643, 151643, 151643, 151643, 151643, 151643, 151643, 151643, 151643, 151643, 151643, 151643, 151643, 151643, 151643, 151643, 151643, 151643, 151643, 151643, 151643, 151643, 151643, 151643, 151643, 151643, 151643, 151643, 151643, 151643, 151643, 151643, 151643, 151643, 151643, 151643, 151643, 151643, 151643, 151643, 151643, 151643, 151643, 151643, 151643, 151643, 151643, 151643, 151643, 151643, 151643, 151643, 151643, 151643, 151643, 151643, 151643, 151643, 151643, 151643, 151643, 151643, 151643, 151643, 151643, 151643, 151643, 151643, 151643, 151643, 151643, 151643, 151643, 151643, 151643, 151643, 151643, 151643, 151643, 151643, 151643, 151643, 151643, 151643, 151643, 151643, 151643, 151643, 151643, 151643, 151643, 151643, 151643, 151643, 151643, 151643, 151643, 151643, 151643, 151643, 151643, 151643, 151643, 151643, 151643, 151643, 151643, 151643, 151643, 151643, 151643, 151643, 151643, 151643, 151643, 151643, 151643, 151643, 151643, 151643, 151643, 151643, 151643, 151643, 151643, 151643, 151643, 151643, 151643, 151643, 151643, 151643, 151643, 151643, 151643, 151643, 151643, 151643, 151643, 151643, 151643, 151643, 151643, 151643, 151643, 151643, 151643, 151643, 151643, 151643, 151643, 151643, 151643, 151643, 151643, 151643, 151643, 151643, 151643, 151643, 151643, 151643, 151643, 151643, 151643, 151643, 151643, 151643, 151643, 151643, 151643, 151643, 151643, 151643, 151643, 151643, 151643, 151643, 151643, 151643, 151643, 151643, 151643, 151643, 151643, 151643, 151643, 151643, 151643, 151643, 151643, 151643, 151643, 151643, 151643, 151643, 151643, 151643, 151643, 151643, 151643, 151643, 151643, 151643, 151643, 151643, 151643, 151643, 151643, 151643, 151643, 151643, 151643, 151643, 151643, 151643, 151643, 151643, 151643, 151643, 151643, 151643, 151643, 151643, 151643, 151643, 151643, 151643, 151643, 151643, 151643, 151643, 151643, 151643, 151643, 151643, 151643, 151643, 151643, 151643, 151643, 151643, 151643, 151643, 151643, 151643, 151643, 151643, 151643, 151643, 151643, 151643, 151643, 151643, 151643, 151643, 151643, 151643, 151643, 151643, 151643, 151643, 151643, 151643, 151643, 151643, 151643, 151643, 151643, 151643, 151643, 151643, 151643, 151643, 151643, 151643, 151643, 151643, 151643, 151643, 151643, 151643, 151643, 151643, 151643, 151643, 151643, 151643, 151643, 151643, 151643, 151643, 151643, 151643, 151643, 151643, 151643, 151643, 151643, 151643, 151643, 151643, 151643, 151643, 151643, 151643, 151643, 151643, 151643, 151643, 151643, 151643, 151643, 151643, 151643, 151643, 151643, 151643, 151643, 151643, 151643, 151643, 151643, 151643, 151643, 151643, 151643, 151643, 151643, 151643, 151643, 151643, 151643, 151643, 151643, 151643, 151643, 151643, 151643, 151643, 151643, 151643, 151643, 151643, 151643, 151643, 151643, 151643, 151643, 151643, 151643, 151643, 151643, 151643, 151643, 151643, 151643, 151643, 151643, 151643, 151643, 151643, 151643, 151643, 151643, 151643, 151643, 151643, 151643, 151643, 151643, 151643, 151643, 151643, 151643, 151643, 151643, 151643, 151643, 151643, 151643, 151643, 151643, 151643, 151643, 151643, 151643, 151643, 151643, 151643, 151643, 151643, 151643, 151643, 151643, 151643, 151643, 151643, 151643, 151643, 151643, 151643, 151643, 151643, 151643, 151643, 151643, 151643, 151643, 151643, 151643, 151643, 151643, 151643, 151643, 151643, 151643, 151643, 151643, 151643, 151643, 151643, 151643, 151643, 151643, 151643, 151643, 151643, 151643, 151643, 151643, 151643, 151643, 151643, 151643, 151643, 151643, 151643, 151643, 151643, 151643, 151643, 151643, 151643, 151643, 151643, 151643, 151643, 151643, 151643, 151643, 151643, 151643, 151643, 151643, 151643, 151643, 151643, 151643, 151643, 151643, 151643, 151643, 151643, 151643, 151643, 151643, 151643, 151643, 151643, 151643, 151643, 151643, 151643, 151643, 151643, 151643, 151644, 8948, 198, 2610, 525, 1207, 16948, 11, 3465, 553, 54364, 14817, 13, 1446, 525, 264, 10950, 17847, 13, 151645, 198, 151644, 872, 198, 16141, 279, 2701, 5248, 5754, 3405, 13, 576, 1537, 1555, 315, 697, 2033, 1265, 387, 315, 279, 2701, 3561, 25, 364, 16141, 25, 400, 20756, 4198, 6, 320, 28996, 17194, 8, 1380, 44428, 374, 825, 315, 19360, 35, 13, 21149, 3019, 553, 3019, 1573, 35764, 382, 11613, 9759, 525, 1660, 19476, 13, 1084, 702, 1012, 13166, 429, 11001, 32199, 304, 279, 7249, 8023, 315, 6774, 62, 16, 525, 10917, 438, 12035, 304, 264, 3151, 4802, 2188, 979, 7707, 311, 279, 11001, 32199, 304, 6774, 62, 17, 13, 758, 2097, 11, 279, 4802, 6672, 1948, 279, 6509, 4802, 5866, 572, 10838, 311, 387, 13187, 220, 16, 13, 18, 23, 856, 220, 16, 15, 61, 4080, 17, 18, 8, 619, 13, 63964, 429, 279, 47217, 7249, 64633, 525, 304, 51398, 11, 892, 315, 1493, 37906, 369, 279, 7373, 19879, 315, 279, 9759, 320, 51, 62, 16, 323, 350, 62, 17, 8, 374, 4396, 1939, 32, 8, 29390, 7, 17, 8, 284, 508, 320, 51, 62, 16, 488, 350, 62, 17, 8, 608, 320, 51, 16, 60634, 17, 5563, 33, 8, 29390, 7, 17, 8, 284, 508, 320, 51, 62, 16, 481, 350, 62, 17, 8, 608, 320, 51, 16, 60634, 17, 5563, 34, 8, 29390, 7, 17, 8, 284, 508, 350, 62, 17, 608, 350, 62, 16, 921, 35, 8, 29390, 7, 17, 8, 284, 508, 320, 51, 62, 16, 481, 350, 62, 17, 8, 608, 320, 51, 16, 60634, 17, 29776, 17, 2279, 151645, 198, 151644, 77091, 198]",,271,603,874,1.0,1.0
41f066cb-3881-4f20-a0e7-aacc9b3d6453,7,63,"[151643, 151643, 151643, 151643, 151643, 151643, 151643, 151643, 151643, 151643, 151643, 151643, 151643, 151643, 151643, 151643, 151643, 151643, 151643, 151643, 151643, 151643, 151643, 151643, 151643, 151643, 151643, 151643, 151643, 151643, 151643, 151643, 151643, 151643, 151643, 151643, 151643, 151643, 151643, 151643, 151643, 151643, 151643, 151643, 151643, 151643, 151643, 151643, 151643, 151643, 151643, 151643, 151643, 151643, 151643, 151643, 151643, 151643, 151643, 151643, 151643, 151643, 151643, 151643, 151643, 151643, 151643, 151643, 151643, 151643, 151643, 151643, 151643, 151643, 151643, 151643, 151643, 151643, 151643, 151643, 151643, 151643, 151643, 151643, 151643, 151643, 151643, 151643, 151643, 151643, 151643, 151643, 151643, 151643, 151643, 151643, 151643, 151643, 151643, 151643, 151643, 151643, 151643, 151643, 151643, 151643, 151643, 151643, 151643, 151643, 151643, 151643, 151643, 151643, 151643, 151643, 151643, 151643, 151643, 151643, 151643, 151643, 151643, 151643, 151643, 151643, 151643, 151643, 151643, 151643, 151643, 151643, 151643, 151643, 151643, 151643, 151643, 151643, 151643, 151643, 151643, 151643, 151643, 151643, 151643, 151643, 151643, 151643, 151643, 151643, 151643, 151643, 151643, 151643, 151643, 151643, 151643, 151643, 151643, 151643, 151643, 151643, 151643, 151643, 151643, 151643, 151643, 151643, 151643, 151643, 151643, 151643, 151643, 151643, 151643, 151643, 151643, 151643, 151643, 151643, 151643, 151643, 151643, 151643, 151643, 151643, 151643, 151643, 151643, 151643, 151643, 151643, 151643, 151643, 151643, 151643, 151643, 151643, 151643, 151643, 151643, 151643, 151643, 151643, 151643, 151643, 151643, 151643, 151643, 151643, 151643, 151643, 151643, 151643, 151643, 151643, 151643, 151643, 151643, 151643, 151643, 151643, 151643, 151643, 151643, 151643, 151643, 151643, 151643, 151643, 151643, 151643, 151643, 151643, 151643, 151643, 151643, 151643, 151643, 151643, 151643, 151643, 151643, 151643, 151643, 151643, 151643, 151643, 151643, 151643, 151643, 151643, 151643, 151643, 151643, 151643, 151643, 151643, 151643, 151643, 151643, 151643, 151643, 151643, 151643, 151643, 151643, 151643, 151643, 151643, 151643, 151643, 151643, 151643, 151643, 151643, 151643, 151643, 151643, 151643, 151643, 151643, 151643, 151643, 151643, 151643, 151643, 151643, 151643, 151643, 151643, 151643, 151643, 151643, 151643, 151643, 151643, 151643, 151643, 151643, 151643, 151643, 151643, 151643, 151643, 151643, 151643, 151643, 151643, 151643, 151643, 151643, 151643, 151643, 151643, 151643, 151643, 151643, 151643, 151643, 151643, 151643, 151643, 151643, 151643, 151643, 151643, 151643, 151643, 151643, 151643, 151643, 151643, 151643, 151643, 151643, 151643, 151643, 151643, 151643, 151643, 151643, 151643, 151643, 151643, 151643, 151643, 151643, 151643, 151643, 151643, 151643, 151643, 151643, 151643, 151643, 151643, 151643, 151643, 151643, 151643, 151643, 151643, 151643, 151643, 151643, 151643, 151643, 151643, 151643, 151643, 151643, 151643, 151643, 151643, 151643, 151643, 151643, 151643, 151643, 151643, 151643, 151643, 151643, 151643, 151643, 151643, 151643, 151643, 151643, 151643, 151643, 151643, 151643, 151643, 151643, 151643, 151643, 151643, 151643, 151643, 151643, 151643, 151643, 151643, 151643, 151643, 151643, 151643, 151643, 151643, 151643, 151643, 151643, 151643, 151643, 151643, 151643, 151643, 151643, 151643, 151643, 151643, 151643, 151643, 151643, 151643, 151643, 151643, 151643, 151643, 151643, 151643, 151643, 151643, 151643, 151643, 151643, 151643, 151643, 151643, 151643, 151643, 151643, 151643, 151643, 151643, 151643, 151643, 151643, 151643, 151643, 151643, 151643, 151643, 151643, 151643, 151643, 151643, 151643, 151643, 151643, 151643, 151643, 151643, 151643, 151643, 151643, 151643, 151643, 151643, 151643, 151643, 151643, 151643, 151643, 151643, 151643, 151643, 151643, 151643, 151643, 151643, 151643, 151643, 151643, 151643, 151643, 151643, 151643, 151643, 151643, 151643, 151643, 151643, 151643, 151643, 151643, 151643, 151643, 151643, 151643, 151643, 151643, 151643, 151643, 151643, 151643, 151643, 151643, 151643, 151643, 151643, 151643, 151643, 151643, 151643, 151643, 151643, 151643, 151643, 151643, 151643, 151643, 151643, 151643, 151643, 151643, 151643, 151643, 151643, 151643, 151643, 151643, 151643, 151643, 151643, 151643, 151643, 151643, 151643, 151643, 151643, 151643, 151643, 151643, 151643, 151643, 151643, 151643, 151643, 151643, 151643, 151643, 151643, 151643, 151643, 151643, 151643, 151643, 151643, 151643, 151643, 151643, 151643, 151643, 151643, 151643, 151643, 151643, 151643, 151643, 151643, 151643, 151643, 151643, 151643, 151643, 151643, 151643, 151643, 151643, 151643, 151643, 151643, 151643, 151643, 151643, 151643, 151643, 151643, 151643, 151643, 151643, 151643, 151643, 151643, 151643, 151643, 151643, 151643, 151643, 151643, 151643, 151643, 151643, 151643, 151643, 151643, 151643, 151643, 151643, 151643, 151643, 151643, 151643, 151643, 151643, 151643, 151643, 151643, 151643, 151643, 151643, 151643, 151643, 151643, 151643, 151643, 151643, 151643, 151643, 151643, 151643, 151643, 151643, 151643, 151643, 151643, 151643, 151643, 151643, 151643, 151643, 151643, 151643, 151643, 151643, 151643, 151643, 151643, 151643, 151643, 151643, 151643, 151643, 151643, 151643, 151643, 151643, 151643, 151643, 151643, 151643, 151643, 151643, 151643, 151643, 151643, 151643, 151643, 151643, 151643, 151643, 151643, 151643, 151643, 151643, 151643, 151643, 151643, 151643, 151643, 151643, 151643, 151643, 151643, 151643, 151643, 151643, 151643, 151643, 151643, 151643, 151643, 151643, 151643, 151643, 151643, 151643, 151643, 151643, 151643, 151643, 151643, 151643, 151643, 151643, 151643, 151643, 151643, 151643, 151643, 151643, 151643, 151643, 151643, 151643, 151643, 151643, 151643, 151643, 151643, 151643, 151643, 151643, 151643, 151643, 151643, 151643, 151643, 151643, 151643, 151643, 151643, 151643, 151643, 151643, 151643, 151643, 151643, 151643, 151643, 151643, 151643, 151643, 151643, 151643, 151643, 151643, 151643, 151643, 151643, 151643, 151643, 151643, 151643, 151643, 151643, 151643, 151643, 151643, 151643, 151643, 151643, 151643, 151643, 151643, 151643, 151643, 151643, 151643, 151643, 151643, 151643, 151643, 151643, 151643, 151643, 151643, 151643, 151643, 151643, 151643, 151643, 151643, 151643, 151643, 151643, 151643, 151643, 151643, 151643, 151643, 151643, 151643, 151643, 151643, 151644, 8948, 198, 2610, 525, 1207, 16948, 11, 3465, 553, 54364, 14817, 13, 1446, 525, 264, 10950, 17847, 13, 151645, 198, 151644, 872, 198, 16141, 279, 2701, 5248, 5754, 3405, 13, 576, 1537, 1555, 315, 697, 2033, 1265, 387, 315, 279, 2701, 3561, 25, 364, 16141, 25, 400, 20756, 4198, 6, 320, 28996, 17194, 8, 1380, 44428, 374, 825, 315, 19360, 35, 13, 21149, 3019, 553, 3019, 1573, 35764, 382, 32, 30128, 22148, 18790, 315, 3072, 296, 10797, 304, 1378, 15336, 304, 279, 2701, 4650, 11, 438, 264, 729, 315, 320, 81, 11, 88538, 1648, 647, 320, 81, 11, 7851, 116, 8, 284, 220, 16, 14, 17, 23103, 61, 17, 488, 220, 18, 14, 17, 23103, 61, 17, 7960, 61, 17, 7, 88538, 340, 9885, 279, 4802, 19745, 382, 32, 8, 468, 284, 320, 18, 77, 3212, 10, 17, 77, 4178, 10, 16, 14, 17, 8, 28653, 237, 9, 26888, 5969, 3183, 1171, 33, 8, 468, 284, 320, 17, 77, 3212, 38334, 4178, 10, 18, 14, 17, 8, 147544, 9, 26888, 5969, 3183, 340, 34, 8, 468, 284, 320, 17, 77, 3212, 10, 18, 77, 4178, 10, 16, 14, 17, 8, 28653, 237, 9, 26888, 5969, 3183, 1171, 35, 8, 468, 284, 320, 77, 3212, 10, 18, 23986, 4178, 10, 18, 14, 17, 8, 28653, 237, 9, 26888, 5969, 3183, 593, 151645, 198, 151644, 77091, 198]",,226,512,738,0.0,0.0
d870484e-cdce-43d5-b615-a7dd47c5ea4c,7,64,"[151643, 151643, 151643, 151643, 151643, 151643, 151643, 151643, 151643, 151643, 151643, 151643, 151643, 151643, 151643, 151643, 151643, 151643, 151643, 151643, 151643, 151643, 151643, 151643, 151643, 151643, 151643, 151643, 151643, 151643, 151643, 151643, 151643, 151643, 151643, 151643, 151643, 151643, 151643, 151643, 151643, 151643, 151643, 151643, 151643, 151643, 151643, 151643, 151643, 151643, 151643, 151643, 151643, 151643, 151643, 151643, 151643, 151643, 151643, 151643, 151643, 151643, 151643, 151643, 151643, 151643, 151643, 151643, 151643, 151643, 151643, 151643, 151643, 151643, 151643, 151643, 151643, 151643, 151643, 151643, 151643, 151643, 151643, 151643, 151643, 151643, 151643, 151643, 151643, 151643, 151643, 151643, 151643, 151643, 151643, 151643, 151643, 151643, 151643, 151643, 151643, 151643, 151643, 151643, 151643, 151643, 151643, 151643, 151643, 151643, 151643, 151643, 151643, 151643, 151643, 151643, 151643, 151643, 151643, 151643, 151643, 151643, 151643, 151643, 151643, 151643, 151643, 151643, 151643, 151643, 151643, 151643, 151643, 151643, 151643, 151643, 151643, 151643, 151643, 151643, 151643, 151643, 151643, 151643, 151643, 151643, 151643, 151643, 151643, 151643, 151643, 151643, 151643, 151643, 151643, 151643, 151643, 151643, 151643, 151643, 151643, 151643, 151643, 151643, 151643, 151643, 151643, 151643, 151643, 151643, 151643, 151643, 151643, 151643, 151643, 151643, 151643, 151643, 151643, 151643, 151643, 151643, 151643, 151643, 151643, 151643, 151643, 151643, 151643, 151643, 151643, 151643, 151643, 151643, 151643, 151643, 151643, 151643, 151643, 151643, 151643, 151643, 151643, 151643, 151643, 151643, 151643, 151643, 151643, 151643, 151643, 151643, 151643, 151643, 151643, 151643, 151643, 151643, 151643, 151643, 151643, 151643, 151643, 151643, 151643, 151643, 151643, 151643, 151643, 151643, 151643, 151643, 151643, 151643, 151643, 151643, 151643, 151643, 151643, 151643, 151643, 151643, 151643, 151643, 151643, 151643, 151643, 151643, 151643, 151643, 151643, 151643, 151643, 151643, 151643, 151643, 151643, 151643, 151643, 151643, 151643, 151643, 151643, 151643, 151643, 151643, 151643, 151643, 151643, 151643, 151643, 151643, 151643, 151643, 151643, 151643, 151643, 151643, 151643, 151643, 151643, 151643, 151643, 151643, 151643, 151643, 151643, 151643, 151643, 151643, 151643, 151643, 151643, 151643, 151643, 151643, 151643, 151643, 151643, 151643, 151643, 151643, 151643, 151643, 151643, 151643, 151643, 151643, 151643, 151643, 151643, 151643, 151643, 151643, 151643, 151643, 151643, 151643, 151643, 151643, 151643, 151643, 151643, 151643, 151643, 151643, 151643, 151643, 151643, 151643, 151643, 151643, 151643, 151643, 151643, 151643, 151643, 151643, 151643, 151643, 151643, 151643, 151643, 151643, 151643, 151643, 151643, 151643, 151643, 151643, 151643, 151643, 151643, 151643, 151643, 151643, 151643, 151643, 151643, 151643, 151643, 151643, 151643, 151643, 151643, 151643, 151643, 151643, 151643, 151643, 151643, 151643, 151643, 151643, 151643, 151643, 151643, 151643, 151643, 151643, 151643, 151643, 151643, 151643, 151643, 151643, 151643, 151643, 151643, 151643, 151643, 151643, 151643, 151643, 151643, 151643, 151643, 151643, 151643, 151643, 151643, 151643, 151643, 151643, 151643, 151643, 151643, 151643, 151643, 151643, 151643, 151643, 151643, 151643, 151643, 151643, 151643, 151643, 151643, 151643, 151643, 151643, 151643, 151643, 151643, 151643, 151643, 151643, 151643, 151643, 151643, 151643, 151643, 151643, 151643, 151643, 151643, 151643, 151643, 151643, 151643, 151643, 151643, 151643, 151643, 151643, 151643, 151643, 151643, 151643, 151643, 151643, 151643, 151643, 151643, 151643, 151643, 151643, 151643, 151643, 151643, 151643, 151643, 151643, 151643, 151643, 151643, 151643, 151643, 151643, 151643, 151643, 151643, 151643, 151643, 151643, 151643, 151643, 151643, 151643, 151643, 151643, 151643, 151643, 151643, 151643, 151643, 151643, 151643, 151643, 151643, 151643, 151643, 151643, 151643, 151643, 151643, 151643, 151643, 151643, 151643, 151643, 151643, 151643, 151643, 151643, 151643, 151643, 151643, 151643, 151643, 151643, 151643, 151643, 151643, 151643, 151643, 151643, 151643, 151643, 151643, 151643, 151643, 151643, 151643, 151643, 151643, 151643, 151643, 151643, 151643, 151643, 151643, 151643, 151643, 151643, 151643, 151643, 151643, 151643, 151643, 151643, 151643, 151643, 151643, 151643, 151643, 151643, 151643, 151643, 151643, 151643, 151643, 151643, 151643, 151643, 151643, 151643, 151643, 151643, 151643, 151643, 151643, 151643, 151643, 151643, 151643, 151643, 151643, 151643, 151643, 151643, 151643, 151643, 151643, 151643, 151643, 151643, 151643, 151643, 151643, 151643, 151643, 151643, 151643, 151643, 151643, 151643, 151643, 151643, 151643, 151643, 151643, 151643, 151643, 151643, 151643, 151643, 151643, 151643, 151643, 151643, 151643, 151643, 151643, 151643, 151643, 151643, 151643, 151643, 151643, 151643, 151643, 151643, 151643, 151643, 151643, 151643, 151643, 151643, 151643, 151643, 151643, 151643, 151643, 151643, 151643, 151643, 151643, 151643, 151643, 151643, 151643, 151643, 151643, 151643, 151643, 151643, 151643, 151643, 151643, 151643, 151643, 151643, 151643, 151643, 151643, 151643, 151643, 151643, 151643, 151643, 151643, 151643, 151643, 151643, 151643, 151643, 151643, 151643, 151643, 151643, 151643, 151643, 151643, 151643, 151643, 151643, 151643, 151643, 151643, 151643, 151643, 151643, 151643, 151643, 151643, 151643, 151643, 151644, 8948, 198, 2610, 525, 1207, 16948, 11, 3465, 553, 54364, 14817, 13, 1446, 525, 264, 10950, 17847, 13, 151645, 198, 151644, 872, 198, 16141, 279, 2701, 5248, 5754, 3405, 13, 576, 1537, 1555, 315, 697, 2033, 1265, 387, 315, 279, 2701, 3561, 25, 364, 16141, 25, 400, 20756, 4198, 6, 320, 28996, 17194, 8, 1380, 44428, 374, 825, 315, 19360, 35, 13, 21149, 3019, 553, 3019, 1573, 35764, 382, 28301, 1437, 1985, 422, 304, 279, 2701, 4013, 315, 24473, 624, 20, 1455, 98539, 12, 18, 64, 11, 19, 64, 1737, 318, 41872, 450, 924, 66129, 66, 3337, 22288, 16576, 58, 16, 11, 19, 60, 66, 3337, 1684, 15999, 58, 16, 11, 17, 60, 7964, 89, 1952, 488, 472, 17, 46, 69726, 362, 198, 32, 488, 393, 5626, 69726, 425, 198, 33, 488, 472, 17, 7123, 3357, 18, 69726, 356, 198, 34, 488, 25076, 46761, 69726, 422, 271, 32, 8, 220, 18, 64, 11, 19, 64, 11, 20, 11, 20, 2385, 295, 2396, 41872, 12, 17, 11, 18, 11, 18, 64, 11, 19, 11, 19, 64, 11, 20, 2832, 327, 1466, 67007, 12, 16, 39, 1786, 3337, 1684, 15999, 58, 16, 11, 17, 25, 16, 11, 19, 60, 8579, 58, 20, 60, 1020, 360, 1952, 198, 33, 8, 220, 18, 64, 11, 20, 11, 20, 10188, 318, 41872, 12, 16, 11, 17, 11, 18, 11, 18, 64, 11, 20, 11, 21, 11, 22, 11, 23, 16022, 302, 1466, 67007, 66, 3337, 22288, 16576, 58, 16, 11, 19, 60, 66, 3337, 1684, 15999, 58, 16, 11, 17, 60, 7964, 89, 1952, 198, 34, 8, 220, 18, 64, 11, 19, 11, 20, 64, 10188, 318, 41872, 12, 16, 11, 17, 11, 18, 11, 18, 64, 11, 20, 64, 11, 21, 11, 22, 11, 23, 16022, 302, 1466, 67007, 66, 3337, 22288, 16576, 12447, 60, 79, 6296, 1952, 198, 35, 8, 220, 18, 64, 11, 20, 1737, 318, 41872, 450, 924, 66129, 66, 3337, 22288, 16576, 58, 16, 11, 19, 60, 66, 3337, 1684, 15999, 58, 16, 11, 17, 60, 7964, 89, 1952, 151645, 198, 151644, 77091, 198]",,345,587,932,0.0,0.0
d881c0bc-fc80-4c18-95ad-ba1ba2fde3b4,7,65,"[151643, 151643, 151643, 151643, 151643, 151643, 151643, 151643, 151643, 151643, 151643, 151643, 151643, 151643, 151643, 151643, 151643, 151643, 151643, 151643, 151643, 151643, 151643, 151643, 151643, 151643, 151643, 151643, 151643, 151643, 151643, 151643, 151643, 151643, 151643, 151643, 151643, 151643, 151643, 151643, 151643, 151643, 151643, 151643, 151643, 151643, 151643, 151643, 151643, 151643, 151643, 151643, 151643, 151643, 151643, 151643, 151643, 151643, 151643, 151643, 151643, 151643, 151643, 151643, 151643, 151643, 151643, 151643, 151643, 151643, 151643, 151643, 151643, 151643, 151643, 151643, 151643, 151643, 151643, 151643, 151643, 151643, 151643, 151643, 151643, 151643, 151643, 151643, 151643, 151643, 151643, 151643, 151643, 151643, 151643, 151643, 151643, 151643, 151643, 151643, 151643, 151643, 151643, 151643, 151643, 151643, 151643, 151643, 151643, 151643, 151643, 151643, 151643, 151643, 151643, 151643, 151643, 151643, 151643, 151643, 151643, 151643, 151643, 151643, 151643, 151643, 151643, 151643, 151643, 151643, 151643, 151643, 151643, 151643, 151643, 151643, 151643, 151643, 151643, 151643, 151643, 151643, 151643, 151643, 151643, 151643, 151643, 151643, 151643, 151643, 151643, 151643, 151643, 151643, 151643, 151643, 151643, 151643, 151643, 151643, 151643, 151643, 151643, 151643, 151643, 151643, 151643, 151643, 151643, 151643, 151643, 151643, 151643, 151643, 151643, 151643, 151643, 151643, 151643, 151643, 151643, 151643, 151643, 151643, 151643, 151643, 151643, 151643, 151643, 151643, 151643, 151643, 151643, 151643, 151643, 151643, 151643, 151643, 151643, 151643, 151643, 151643, 151643, 151643, 151643, 151643, 151643, 151643, 151643, 151643, 151643, 151643, 151643, 151643, 151643, 151643, 151643, 151643, 151643, 151643, 151643, 151643, 151643, 151643, 151643, 151643, 151643, 151643, 151643, 151643, 151643, 151643, 151643, 151643, 151643, 151643, 151643, 151643, 151643, 151643, 151643, 151643, 151643, 151643, 151643, 151643, 151643, 151643, 151643, 151643, 151643, 151643, 151643, 151643, 151643, 151643, 151643, 151643, 151643, 151643, 151643, 151643, 151643, 151643, 151643, 151643, 151643, 151643, 151643, 151643, 151643, 151643, 151643, 151643, 151643, 151643, 151643, 151643, 151643, 151643, 151643, 151643, 151643, 151643, 151643, 151643, 151643, 151643, 151643, 151643, 151643, 151643, 151643, 151643, 151643, 151643, 151643, 151643, 151643, 151643, 151643, 151643, 151643, 151643, 151643, 151643, 151643, 151643, 151643, 151643, 151643, 151643, 151643, 151643, 151643, 151643, 151643, 151643, 151643, 151643, 151643, 151643, 151643, 151643, 151643, 151643, 151643, 151643, 151643, 151643, 151643, 151643, 151643, 151643, 151643, 151643, 151643, 151643, 151643, 151643, 151643, 151643, 151643, 151643, 151643, 151643, 151643, 151643, 151643, 151643, 151643, 151643, 151643, 151643, 151643, 151643, 151643, 151643, 151643, 151643, 151643, 151643, 151643, 151643, 151643, 151643, 151643, 151643, 151643, 151643, 151643, 151643, 151643, 151643, 151643, 151643, 151643, 151643, 151643, 151643, 151643, 151643, 151643, 151643, 151643, 151643, 151643, 151643, 151643, 151643, 151643, 151643, 151643, 151643, 151643, 151643, 151643, 151643, 151643, 151643, 151643, 151643, 151643, 151643, 151643, 151643, 151643, 151643, 151643, 151643, 151643, 151643, 151643, 151643, 151643, 151643, 151643, 151643, 151643, 151643, 151643, 151643, 151643, 151643, 151643, 151643, 151643, 151643, 151643, 151643, 151643, 151643, 151643, 151643, 151643, 151643, 151643, 151643, 151643, 151643, 151643, 151643, 151643, 151643, 151643, 151643, 151643, 151643, 151643, 151643, 151643, 151643, 151643, 151643, 151643, 151643, 151643, 151643, 151643, 151643, 151643, 151643, 151643, 151643, 151643, 151643, 151643, 151643, 151643, 151643, 151643, 151643, 151643, 151643, 151643, 151643, 151643, 151643, 151643, 151643, 151643, 151643, 151643, 151643, 151643, 151643, 151643, 151643, 151643, 151643, 151643, 151643, 151643, 151643, 151643, 151643, 151643, 151643, 151643, 151643, 151643, 151643, 151643, 151643, 151643, 151643, 151643, 151643, 151643, 151643, 151643, 151643, 151643, 151643, 151643, 151643, 151643, 151643, 151643, 151643, 151643, 151643, 151643, 151643, 151643, 151643, 151644, 8948, 198, 2610, 525, 1207, 16948, 11, 3465, 553, 54364, 14817, 13, 1446, 525, 264, 10950, 17847, 13, 151645, 198, 151644, 872, 198, 16141, 279, 2701, 5248, 5754, 3405, 13, 576, 1537, 1555, 315, 697, 2033, 1265, 387, 315, 279, 2701, 3561, 25, 364, 16141, 25, 400, 20756, 4198, 6, 320, 28996, 17194, 8, 1380, 44428, 374, 825, 315, 19360, 35, 13, 21149, 3019, 553, 3019, 1573, 35764, 382, 1, 16, 11, 17, 10911, 682, 81, 56633, 12720, 304, 892, 31431, 977, 1853, 3069, 525, 5420, 311, 13767, 448, 13621, 374, 2598, 17471, 580, 337, 17471, 580, 337, 603, 55327, 56633, 12720, 13, 1096, 12720, 33455, 1526, 279, 18003, 315, 34772, 2276, 429, 5240, 279, 31831, 315, 825, 315, 279, 5203, 624, 2461, 279, 31146, 2661, 3685, 892, 525, 279, 3204, 3871, 315, 279, 17471, 580, 337, 55327, 56633, 5267, 18, 1448, 41872, 12, 19, 12, 14769, 3923, 17308, 2145, 12, 18, 11, 19, 1737, 24903, 488, 472, 10, 69726, 362, 198, 18, 8013, 19, 2832, 67007, 4130, 14769, 3923, 7287, 17, 12, 14769, 3923, 45125, 2145, 12, 17, 11, 18, 1737, 24903, 488, 472, 10, 69726, 425, 198, 16, 11, 16, 11, 17, 10188, 285, 7, 19, 1448, 769, 60163, 14769, 3923, 7287, 17, 12, 14769, 967, 85085, 12, 16, 11, 17, 1737, 24903, 488, 472, 10, 69726, 356, 271, 32, 8, 362, 284, 220, 17, 1448, 41872, 12, 16, 12, 14769, 3923, 8088, 276, 12, 16, 18589, 11, 425, 284, 220, 17, 8013, 19, 2832, 67007, 4130, 14769, 3923, 7287, 16, 12, 14769, 3923, 8088, 276, 12, 16, 18589, 11, 356, 284, 220, 17, 11, 17, 11, 17, 10188, 285, 7, 19, 1448, 769, 60163, 14769, 3923, 7287, 16, 12, 14769, 967, 53795, 12, 16, 18589, 198, 33, 8, 362, 284, 220, 18, 12, 41872, 12, 18, 12, 14769, 3923, 45125, 276, 12, 17, 18589, 11, 425, 284, 220, 18, 8013, 19, 2832, 67007, 4130, 14769, 3923, 7287, 18, 12, 14769, 3923, 45125, 276, 12, 17, 18589, 11, 356, 284, 220, 16, 11, 17, 11, 17, 10188, 285, 7, 19, 1448, 769, 60163, 14769, 3923, 7287, 17, 12, 14769, 967, 53795, 12, 16, 18589, 198, 34, 8, 362, 284, 220, 17, 1448, 41872, 12, 16, 12, 14769, 3923, 8088, 276, 12, 16, 18589, 11, 425, 284, 220, 17, 8013, 19, 2832, 67007, 4130, 14769, 3923, 7287, 16, 12, 14769, 3923, 8088, 276, 12, 16, 18589, 11, 356, 284, 220, 16, 11, 17, 11, 17, 10188, 285, 7, 19, 1448, 769, 60163, 14769, 3923, 7287, 17, 12, 14769, 967, 53795, 12, 16, 18589, 198, 35, 8, 362, 284, 220, 18, 12, 41872, 12, 18, 12, 14769, 3923, 45125, 276, 12, 17, 18589, 11, 425, 284, 220, 18, 8013, 19, 2832, 67007, 4130, 14769, 3923, 7287, 18, 12, 14769, 3923, 45125, 276, 12, 17, 18589, 11, 356, 284, 220, 17, 11, 17, 11, 17, 10188, 285, 7, 19, 1448, 769, 60163, 14769, 3923, 7287, 16, 12, 14769, 967, 53795, 12, 16, 18589, 151645, 198, 151644, 77091, 198]",,498,492,990,0.0,0.0
a6a426ca-7585-48a0-8d4e-cca19d1243f8,7,66,"[151643, 151643, 151643, 151643, 151643, 151643, 151643, 151643, 151643, 151643, 151643, 151643, 151643, 151643, 151643, 151643, 151643, 151643, 151643, 151643, 151643, 151643, 151643, 151643, 151643, 151643, 151643, 151643, 151643, 151643, 151643, 151643, 151643, 151643, 151643, 151643, 151643, 151643, 151643, 151643, 151643, 151643, 151643, 151643, 151643, 151643, 151643, 151643, 151643, 151643, 151643, 151643, 151643, 151643, 151643, 151643, 151643, 151643, 151643, 151643, 151643, 151643, 151643, 151643, 151643, 151643, 151643, 151643, 151643, 151643, 151643, 151643, 151643, 151643, 151643, 151643, 151643, 151643, 151643, 151643, 151643, 151643, 151643, 151643, 151643, 151643, 151643, 151643, 151643, 151643, 151643, 151643, 151643, 151643, 151643, 151643, 151643, 151643, 151643, 151643, 151643, 151643, 151643, 151643, 151643, 151643, 151643, 151643, 151643, 151643, 151643, 151643, 151643, 151643, 151643, 151643, 151643, 151643, 151643, 151643, 151643, 151643, 151643, 151643, 151643, 151643, 151643, 151643, 151643, 151643, 151643, 151643, 151643, 151643, 151643, 151643, 151643, 151643, 151643, 151643, 151643, 151643, 151643, 151643, 151643, 151643, 151643, 151643, 151643, 151643, 151643, 151643, 151643, 151643, 151643, 151643, 151643, 151643, 151643, 151643, 151643, 151643, 151643, 151643, 151643, 151643, 151643, 151643, 151643, 151643, 151643, 151643, 151643, 151643, 151643, 151643, 151643, 151643, 151643, 151643, 151643, 151643, 151643, 151643, 151643, 151643, 151643, 151643, 151643, 151643, 151643, 151643, 151643, 151643, 151643, 151643, 151643, 151643, 151643, 151643, 151643, 151643, 151643, 151643, 151643, 151643, 151643, 151643, 151643, 151643, 151643, 151643, 151643, 151643, 151643, 151643, 151643, 151643, 151643, 151643, 151643, 151643, 151643, 151643, 151643, 151643, 151643, 151643, 151643, 151643, 151643, 151643, 151643, 151643, 151643, 151643, 151643, 151643, 151643, 151643, 151643, 151643, 151643, 151643, 151643, 151643, 151643, 151643, 151643, 151643, 151643, 151643, 151643, 151643, 151643, 151643, 151643, 151643, 151643, 151643, 151643, 151643, 151643, 151643, 151643, 151643, 151643, 151643, 151643, 151643, 151643, 151643, 151643, 151643, 151643, 151643, 151643, 151643, 151643, 151643, 151643, 151643, 151643, 151643, 151643, 151643, 151643, 151643, 151643, 151643, 151643, 151643, 151643, 151643, 151643, 151643, 151643, 151643, 151643, 151643, 151643, 151643, 151643, 151643, 151643, 151643, 151643, 151643, 151643, 151643, 151643, 151643, 151643, 151643, 151643, 151643, 151643, 151643, 151643, 151643, 151643, 151643, 151643, 151643, 151643, 151643, 151643, 151643, 151643, 151643, 151643, 151643, 151643, 151643, 151643, 151643, 151643, 151643, 151643, 151643, 151643, 151643, 151643, 151643, 151643, 151643, 151643, 151643, 151643, 151643, 151643, 151643, 151643, 151643, 151643, 151643, 151643, 151643, 151643, 151643, 151643, 151643, 151643, 151643, 151643, 151643, 151643, 151643, 151643, 151643, 151643, 151643, 151643, 151643, 151643, 151643, 151643, 151643, 151643, 151643, 151643, 151643, 151643, 151643, 151643, 151643, 151643, 151643, 151643, 151643, 151643, 151643, 151643, 151643, 151643, 151643, 151643, 151643, 151643, 151643, 151643, 151643, 151643, 151643, 151643, 151643, 151643, 151643, 151643, 151643, 151643, 151643, 151643, 151643, 151643, 151643, 151643, 151643, 151643, 151643, 151643, 151643, 151643, 151643, 151643, 151643, 151643, 151643, 151643, 151643, 151643, 151643, 151643, 151643, 151643, 151643, 151643, 151643, 151643, 151643, 151643, 151643, 151643, 151643, 151643, 151643, 151643, 151643, 151643, 151643, 151643, 151643, 151643, 151643, 151643, 151643, 151643, 151643, 151643, 151643, 151643, 151643, 151644, 8948, 198, 2610, 525, 1207, 16948, 11, 3465, 553, 54364, 14817, 13, 1446, 525, 264, 10950, 17847, 13, 151645, 198, 151644, 872, 198, 16141, 279, 2701, 5248, 5754, 3405, 13, 576, 1537, 1555, 315, 697, 2033, 1265, 387, 315, 279, 2701, 3561, 25, 364, 16141, 25, 400, 20756, 4198, 6, 320, 28996, 17194, 8, 1380, 44428, 374, 825, 315, 19360, 35, 13, 21149, 3019, 553, 3019, 1573, 35764, 382, 18945, 12, 51255, 6975, 34367, 34772, 3549, 4730, 614, 264, 1753, 803, 4045, 21990, 321, 292, 12499, 1990, 10815, 13, 4220, 1990, 26363, 1160, 438, 264, 1661, 20607, 13621, 323, 13767, 448, 30384, 5127, 3658, 311, 8193, 662, 33066, 64025, 13, 758, 419, 1142, 11, 979, 264, 30384, 67446, 8776, 279, 33218, 2309, 11, 432, 18644, 264, 56981, 5477, 12762, 1506, 28439, 13, 3197, 264, 30384, 67446, 22818, 279, 33218, 23992, 5970, 374, 662, 33066, 11, 1741, 12720, 374, 3881, 438, 279, 7937, 12720, 624, 3838, 525, 279, 13767, 1783, 323, 3598, 1590, 3871, 315, 279, 2701, 7937, 5256, 24473, 5267, 12927, 41872, 8641, 263, 349, 488, 78474, 320, 36, 7287, 18, 8013, 79, 2385, 337, 3923, 8, 580, 884, 5075, 488, 320, 16193, 46, 31860, 11, 18888, 46761, 8, 1177, 2235, 32, 340, 16, 8013, 66, 3337, 385, 17308, 12, 16, 20767, 12, 16, 12, 3923, 49248, 12858, 89973, 488, 320, 36, 7287, 8088, 12, 17, 20767, 268, 21561, 457, 488, 320, 7823, 46761, 11, 472, 18, 46, 36197, 3844, 320, 33, 340, 34, 488, 714, 12, 18, 20767, 12, 17, 18589, 488, 320, 42, 46761, 11, 472, 17, 46, 8, 69726, 220, 17, 8013, 18, 12, 5131, 674, 332, 3923, 46986, 3337, 385, 17308, 2145, 12, 16, 11, 18, 1737, 6339, 271, 32, 8, 362, 284, 11013, 41872, 220, 17, 8013, 79, 2385, 337, 3923, 8, 776, 25325, 12, 16, 11, 16, 11, 18, 10188, 292, 277, 2011, 3923, 349, 11, 425, 284, 220, 18, 8013, 17, 12, 5131, 509, 3337, 385, 17308, 3923, 8, 8088, 276, 268, 21561, 457, 11, 356, 284, 43348, 385, 17308, 2145, 12, 16, 11, 18, 1737, 6339, 198, 33, 8, 362, 284, 11013, 41872, 220, 18, 8013, 79, 2385, 337, 3923, 8, 776, 25325, 12, 16, 11, 16, 11, 17, 10188, 292, 277, 2011, 3923, 349, 11, 425, 284, 220, 18, 8013, 17, 2832, 67007, 87, 3337, 3337, 385, 17308, 12, 16, 20767, 12, 16, 12, 3923, 8, 8088, 276, 268, 21561, 457, 11, 356, 284, 220, 17, 2832, 67007, 87, 3337, 3337, 385, 17308, 2145, 12, 16, 11, 18, 1737, 6339, 198, 34, 8, 362, 284, 11013, 41872, 220, 17, 8013, 79, 2385, 337, 3923, 8, 776, 25325, 12, 16, 11, 16, 11, 18, 10188, 292, 277, 2011, 3923, 349, 11, 425, 284, 220, 18, 8013, 17, 12, 5131, 509, 3337, 385, 17308, 3923, 8, 8088, 276, 268, 21561, 457, 11, 356, 284, 220, 17, 2832, 67007, 87, 3337, 3337, 385, 17308, 2145, 12, 16, 11, 18, 1737, 6339, 198, 35, 8, 362, 284, 11013, 41872, 220, 18, 8013, 79, 2385, 337, 3923, 8, 776, 25325, 12, 16, 11, 16, 11, 17, 10188, 292, 277, 2011, 3923, 349, 11, 425, 284, 220, 18, 8013, 17, 2832, 67007, 87, 3337, 3337, 385, 17308, 12, 16, 20767, 12, 16, 12, 3923, 8, 8088, 276, 268, 21561, 457, 11, 356, 284, 43348, 385, 17308, 2145, 12, 16, 11, 18, 1737, 6339, 151645, 198, 151644, 77091, 198]",,562,766,1328,0.0,0.0
c2933bde-2135-4f87-9749-7c9a775f1974,7,67,"[151643, 151643, 151643, 151643, 151643, 151643, 151643, 151643, 151643, 151643, 151643, 151643, 151643, 151643, 151643, 151643, 151643, 151643, 151643, 151643, 151643, 151643, 151643, 151643, 151643, 151643, 151643, 151643, 151643, 151643, 151643, 151643, 151643, 151643, 151643, 151643, 151643, 151643, 151643, 151643, 151643, 151643, 151643, 151643, 151643, 151643, 151643, 151643, 151643, 151643, 151643, 151643, 151643, 151643, 151643, 151643, 151643, 151643, 151643, 151643, 151643, 151643, 151643, 151643, 151643, 151643, 151643, 151643, 151643, 151643, 151643, 151643, 151643, 151643, 151643, 151643, 151643, 151643, 151643, 151643, 151643, 151643, 151643, 151643, 151643, 151643, 151643, 151643, 151643, 151643, 151643, 151643, 151643, 151643, 151643, 151643, 151643, 151643, 151643, 151643, 151643, 151643, 151643, 151643, 151643, 151643, 151643, 151643, 151643, 151643, 151643, 151643, 151643, 151643, 151643, 151643, 151643, 151643, 151643, 151643, 151643, 151643, 151643, 151643, 151643, 151643, 151643, 151643, 151643, 151643, 151643, 151643, 151643, 151643, 151643, 151643, 151643, 151643, 151643, 151643, 151643, 151643, 151643, 151643, 151643, 151643, 151643, 151643, 151643, 151643, 151643, 151643, 151643, 151643, 151643, 151643, 151643, 151643, 151643, 151643, 151643, 151643, 151643, 151643, 151643, 151643, 151643, 151643, 151643, 151643, 151643, 151643, 151643, 151643, 151643, 151643, 151643, 151643, 151643, 151643, 151643, 151643, 151643, 151643, 151643, 151643, 151643, 151643, 151643, 151643, 151643, 151643, 151643, 151643, 151643, 151643, 151643, 151643, 151643, 151643, 151643, 151643, 151643, 151643, 151643, 151643, 151643, 151643, 151643, 151643, 151643, 151643, 151643, 151643, 151643, 151643, 151643, 151643, 151643, 151643, 151643, 151643, 151643, 151643, 151643, 151643, 151643, 151643, 151643, 151643, 151643, 151643, 151643, 151643, 151643, 151643, 151643, 151643, 151643, 151643, 151643, 151643, 151643, 151643, 151643, 151643, 151643, 151643, 151643, 151643, 151643, 151643, 151643, 151643, 151643, 151643, 151643, 151643, 151643, 151643, 151643, 151643, 151643, 151643, 151643, 151643, 151643, 151643, 151643, 151643, 151643, 151643, 151643, 151643, 151643, 151643, 151643, 151643, 151643, 151643, 151643, 151643, 151643, 151643, 151643, 151643, 151643, 151643, 151643, 151643, 151643, 151643, 151643, 151643, 151643, 151643, 151643, 151643, 151643, 151643, 151643, 151643, 151643, 151643, 151643, 151643, 151643, 151643, 151643, 151643, 151643, 151643, 151643, 151643, 151643, 151643, 151643, 151643, 151643, 151643, 151643, 151643, 151643, 151643, 151643, 151643, 151643, 151643, 151643, 151643, 151643, 151643, 151643, 151643, 151643, 151643, 151643, 151643, 151643, 151643, 151643, 151643, 151643, 151643, 151643, 151643, 151643, 151643, 151643, 151643, 151643, 151643, 151643, 151643, 151643, 151643, 151643, 151643, 151643, 151643, 151643, 151643, 151643, 151643, 151643, 151643, 151643, 151643, 151643, 151643, 151643, 151643, 151643, 151643, 151643, 151643, 151643, 151643, 151643, 151643, 151643, 151643, 151643, 151643, 151643, 151643, 151643, 151643, 151643, 151643, 151643, 151643, 151643, 151643, 151643, 151643, 151643, 151643, 151643, 151643, 151643, 151643, 151643, 151643, 151643, 151643, 151643, 151643, 151643, 151643, 151643, 151643, 151643, 151643, 151643, 151643, 151643, 151643, 151643, 151643, 151643, 151643, 151643, 151643, 151643, 151643, 151643, 151643, 151643, 151643, 151643, 151643, 151643, 151643, 151643, 151643, 151643, 151643, 151643, 151643, 151643, 151643, 151643, 151643, 151643, 151643, 151643, 151643, 151643, 151643, 151643, 151643, 151643, 151643, 151643, 151643, 151643, 151643, 151643, 151643, 151643, 151643, 151643, 151643, 151643, 151643, 151643, 151643, 151643, 151643, 151643, 151643, 151643, 151643, 151643, 151643, 151643, 151643, 151643, 151643, 151643, 151643, 151643, 151643, 151643, 151643, 151643, 151643, 151643, 151643, 151643, 151643, 151643, 151643, 151643, 151643, 151643, 151643, 151643, 151643, 151643, 151643, 151643, 151643, 151643, 151643, 151643, 151643, 151643, 151643, 151643, 151643, 151643, 151643, 151643, 151643, 151643, 151643, 151643, 151643, 151643, 151643, 151643, 151643, 151643, 151643, 151643, 151643, 151643, 151643, 151643, 151643, 151643, 151643, 151643, 151643, 151643, 151643, 151643, 151643, 151643, 151643, 151643, 151643, 151643, 151643, 151643, 151643, 151643, 151643, 151643, 151643, 151643, 151643, 151643, 151643, 151643, 151643, 151643, 151643, 151643, 151643, 151643, 151643, 151643, 151643, 151643, 151643, 151643, 151643, 151643, 151643, 151643, 151643, 151643, 151643, 151643, 151643, 151643, 151643, 151643, 151643, 151643, 151643, 151643, 151643, 151643, 151643, 151643, 151643, 151643, 151643, 151643, 151643, 151643, 151643, 151643, 151643, 151643, 151643, 151643, 151643, 151643, 151643, 151643, 151643, 151643, 151643, 151643, 151643, 151643, 151643, 151643, 151643, 151643, 151643, 151643, 151643, 151643, 151643, 151643, 151643, 151643, 151643, 151643, 151643, 151643, 151643, 151643, 151643, 151643, 151643, 151643, 151643, 151643, 151643, 151643, 151643, 151643, 151643, 151643, 151643, 151643, 151643, 151643, 151643, 151643, 151643, 151643, 151643, 151643, 151643, 151643, 151643, 151643, 151643, 151643, 151643, 151643, 151643, 151643, 151643, 151643, 151643, 151643, 151643, 151643, 151643, 151643, 151643, 151643, 151643, 151643, 151643, 151643, 151643, 151643, 151643, 151643, 151643, 151643, 151643, 151643, 151643, 151643, 151643, 151643, 151643, 151643, 151643, 151643, 151643, 151643, 151643, 151643, 151643, 151643, 151643, 151643, 151643, 151643, 151643, 151643, 151643, 151643, 151643, 151643, 151643, 151643, 151643, 151643, 151643, 151643, 151643, 151643, 151643, 151643, 151643, 151643, 151643, 151643, 151643, 151643, 151643, 151643, 151643, 151643, 151643, 151643, 151643, 151643, 151643, 151643, 151643, 151643, 151643, 151643, 151643, 151643, 151643, 151643, 151643, 151643, 151643, 151643, 151643, 151643, 151643, 151643, 151643, 151643, 151643, 151643, 151643, 151643, 151643, 151644, 8948, 198, 2610, 525, 1207, 16948, 11, 3465, 553, 54364, 14817, 13, 1446, 525, 264, 10950, 17847, 13, 151645, 198, 151644, 872, 198, 16141, 279, 2701, 5248, 5754, 3405, 13, 576, 1537, 1555, 315, 697, 2033, 1265, 387, 315, 279, 2701, 3561, 25, 364, 16141, 25, 400, 20756, 4198, 6, 320, 28996, 17194, 8, 1380, 44428, 374, 825, 315, 19360, 35, 13, 21149, 3019, 553, 3019, 1573, 35764, 382, 37175, 1378, 56578, 525, 304, 281, 64591, 20314, 23270, 1584, 13, 33781, 5503, 1052, 12616, 20314, 23270, 11, 279, 33256, 20314, 23270, 1584, 315, 279, 220, 17, 35981, 2248, 1849, 374, 15251, 553, 400, 91, 75, 62, 16, 11, 326, 62, 17, 11, 326, 11, 296, 29, 284, 760, 16, 11, 16, 11, 220, 17, 11, 481, 16, 14276, 5692, 11, 400, 75, 62, 16, 11, 326, 62, 17, 3, 525, 279, 64591, 20314, 23270, 30128, 5109, 315, 18730, 220, 16, 323, 220, 17, 15576, 13, 1597, 11, 400, 75, 11, 296, 3, 525, 279, 2790, 20314, 23270, 30128, 1372, 323, 279, 12159, 1863, 3692, 315, 279, 220, 17, 35981, 2248, 1849, 15576, 13, 1416, 18662, 374, 1865, 315, 279, 64591, 20314, 23270, 6813, 400, 43, 15159, 16, 89, 31716, 323, 400, 43, 15159, 17, 89, 31716, 11, 1128, 374, 279, 10284, 18927, 315, 3709, 279, 28724, 3661, 315, 2176, 400, 43, 15159, 16, 89, 31716, 323, 400, 43, 15159, 17, 89, 31716, 438, 400, 30529, 71, 2257, 3, 1939, 32, 8, 220, 17, 14, 18, 198, 33, 8, 220, 15, 198, 34, 8, 220, 16, 198, 35, 8, 220, 16, 14, 17, 151645, 198, 151644, 77091, 198]",,268,405,673,1.0,1.0
b337f9c9-15fa-4b01-b719-d80125c8076d,7,68,"[151643, 151643, 151643, 151643, 151643, 151643, 151643, 151643, 151643, 151643, 151643, 151643, 151643, 151643, 151643, 151643, 151643, 151643, 151643, 151643, 151643, 151643, 151643, 151643, 151643, 151643, 151643, 151643, 151643, 151643, 151643, 151643, 151643, 151643, 151643, 151643, 151643, 151643, 151643, 151643, 151643, 151643, 151643, 151643, 151643, 151643, 151643, 151643, 151643, 151643, 151643, 151643, 151643, 151643, 151643, 151643, 151643, 151643, 151643, 151643, 151643, 151643, 151643, 151643, 151643, 151643, 151643, 151643, 151643, 151643, 151643, 151643, 151643, 151643, 151643, 151643, 151643, 151643, 151643, 151643, 151643, 151643, 151643, 151643, 151643, 151643, 151643, 151643, 151643, 151643, 151643, 151643, 151643, 151643, 151643, 151643, 151643, 151643, 151643, 151643, 151643, 151643, 151643, 151643, 151643, 151643, 151643, 151643, 151643, 151643, 151643, 151643, 151643, 151643, 151643, 151643, 151643, 151643, 151643, 151643, 151643, 151643, 151643, 151643, 151643, 151643, 151643, 151643, 151643, 151643, 151643, 151643, 151643, 151643, 151643, 151643, 151643, 151643, 151643, 151643, 151643, 151643, 151643, 151643, 151643, 151643, 151643, 151643, 151643, 151643, 151643, 151643, 151643, 151643, 151643, 151643, 151643, 151643, 151643, 151643, 151643, 151643, 151643, 151643, 151643, 151643, 151643, 151643, 151643, 151643, 151643, 151643, 151643, 151643, 151643, 151643, 151643, 151643, 151643, 151643, 151643, 151643, 151643, 151643, 151643, 151643, 151643, 151643, 151643, 151643, 151643, 151643, 151643, 151643, 151643, 151643, 151643, 151643, 151643, 151643, 151643, 151643, 151643, 151643, 151643, 151643, 151643, 151643, 151643, 151643, 151643, 151643, 151643, 151643, 151643, 151643, 151643, 151643, 151643, 151643, 151643, 151643, 151643, 151643, 151643, 151643, 151643, 151643, 151643, 151643, 151643, 151643, 151643, 151643, 151643, 151643, 151643, 151643, 151643, 151643, 151643, 151643, 151643, 151643, 151643, 151643, 151643, 151643, 151643, 151643, 151643, 151643, 151643, 151643, 151643, 151643, 151643, 151643, 151643, 151643, 151643, 151643, 151643, 151643, 151643, 151643, 151643, 151643, 151643, 151643, 151643, 151643, 151643, 151643, 151643, 151643, 151643, 151643, 151643, 151643, 151643, 151643, 151643, 151643, 151643, 151643, 151643, 151643, 151643, 151643, 151643, 151643, 151643, 151643, 151643, 151643, 151643, 151643, 151643, 151643, 151643, 151643, 151643, 151643, 151643, 151643, 151643, 151643, 151643, 151643, 151643, 151643, 151643, 151643, 151643, 151643, 151643, 151643, 151643, 151643, 151643, 151643, 151643, 151643, 151643, 151643, 151643, 151643, 151643, 151643, 151643, 151643, 151643, 151643, 151643, 151643, 151643, 151643, 151643, 151643, 151643, 151643, 151643, 151643, 151643, 151643, 151643, 151643, 151643, 151643, 151643, 151643, 151643, 151643, 151643, 151643, 151643, 151643, 151643, 151643, 151643, 151643, 151643, 151643, 151643, 151643, 151643, 151643, 151643, 151643, 151643, 151643, 151643, 151643, 151643, 151643, 151643, 151643, 151643, 151643, 151643, 151643, 151643, 151643, 151643, 151643, 151643, 151643, 151643, 151643, 151643, 151643, 151643, 151643, 151643, 151643, 151643, 151643, 151643, 151643, 151643, 151643, 151643, 151643, 151643, 151643, 151643, 151643, 151643, 151643, 151643, 151643, 151643, 151643, 151643, 151643, 151643, 151643, 151643, 151643, 151643, 151643, 151643, 151643, 151643, 151643, 151643, 151643, 151643, 151643, 151643, 151643, 151643, 151643, 151643, 151643, 151643, 151643, 151643, 151643, 151643, 151643, 151643, 151643, 151643, 151643, 151643, 151643, 151643, 151643, 151643, 151643, 151643, 151643, 151643, 151643, 151643, 151643, 151643, 151643, 151643, 151643, 151643, 151643, 151643, 151643, 151643, 151643, 151643, 151643, 151643, 151643, 151643, 151643, 151643, 151643, 151643, 151643, 151643, 151643, 151643, 151643, 151643, 151643, 151643, 151643, 151643, 151643, 151643, 151643, 151643, 151643, 151643, 151643, 151643, 151643, 151643, 151643, 151643, 151643, 151643, 151643, 151643, 151643, 151643, 151643, 151643, 151643, 151643, 151643, 151643, 151643, 151643, 151643, 151643, 151643, 151643, 151643, 151643, 151643, 151643, 151643, 151643, 151643, 151643, 151643, 151643, 151643, 151643, 151643, 151643, 151643, 151643, 151643, 151643, 151643, 151643, 151643, 151643, 151643, 151643, 151643, 151643, 151643, 151643, 151643, 151643, 151643, 151643, 151643, 151643, 151643, 151643, 151643, 151643, 151643, 151643, 151643, 151643, 151643, 151643, 151643, 151643, 151643, 151643, 151643, 151643, 151643, 151643, 151643, 151643, 151643, 151643, 151643, 151643, 151643, 151643, 151643, 151643, 151643, 151643, 151643, 151643, 151643, 151643, 151643, 151643, 151643, 151643, 151643, 151643, 151643, 151643, 151643, 151643, 151643, 151643, 151643, 151643, 151643, 151643, 151643, 151643, 151643, 151643, 151643, 151643, 151643, 151643, 151643, 151643, 151643, 151643, 151643, 151643, 151643, 151643, 151643, 151643, 151643, 151643, 151643, 151643, 151643, 151643, 151643, 151643, 151643, 151643, 151643, 151643, 151643, 151643, 151643, 151643, 151643, 151643, 151643, 151643, 151643, 151643, 151643, 151643, 151643, 151643, 151643, 151643, 151643, 151643, 151643, 151643, 151643, 151643, 151643, 151643, 151643, 151643, 151643, 151643, 151643, 151643, 151643, 151643, 151643, 151643, 151643, 151643, 151643, 151643, 151643, 151643, 151643, 151643, 151643, 151643, 151643, 151643, 151643, 151643, 151643, 151643, 151643, 151643, 151643, 151643, 151643, 151643, 151643, 151643, 151643, 151643, 151643, 151643, 151643, 151643, 151643, 151643, 151643, 151643, 151643, 151643, 151643, 151643, 151643, 151643, 151643, 151643, 151643, 151643, 151643, 151643, 151643, 151643, 151643, 151643, 151643, 151643, 151643, 151643, 151643, 151643, 151643, 151643, 151643, 151643, 151643, 151643, 151643, 151643, 151643, 151643, 151643, 151643, 151643, 151643, 151643, 151643, 151643, 151643, 151643, 151643, 151643, 151643, 151643, 151643, 151643, 151643, 151643, 151643, 151643, 151643, 151643, 151643, 151643, 151643, 151643, 151643, 151643, 151643, 151643, 151644, 8948, 198, 2610, 525, 1207, 16948, 11, 3465, 553, 54364, 14817, 13, 1446, 525, 264, 10950, 17847, 13, 151645, 198, 151644, 872, 198, 16141, 279, 2701, 5248, 5754, 3405, 13, 576, 1537, 1555, 315, 697, 2033, 1265, 387, 315, 279, 2701, 3561, 25, 364, 16141, 25, 400, 20756, 4198, 6, 320, 28996, 17194, 8, 1380, 44428, 374, 825, 315, 19360, 35, 13, 21149, 3019, 553, 3019, 1573, 35764, 382, 22043, 279, 2701, 32371, 92583, 1103, 271, 59, 10374, 5416, 90, 43, 51535, 396, 92, 34433, 74, 27180, 59, 2257, 35702, 30765, 11035, 24912, 15159, 59, 15128, 1699, 84, 11035, 30765, 434, 61, 35702, 15128, 1699, 84, 630, 2870, 1124, 24912, 15159, 59, 15128, 1699, 84, 92, 34433, 37018, 24204, 15170, 17, 11035, 2359, 26056, 32214, 15159, 59, 15128, 2137, 59, 32214, 15159, 59, 8933, 11035, 1291, 29562, 3838, 374, 279, 3072, 12871, 315, 1124, 74, 27180, 30, 2160, 279, 10126, 5672, 2492, 8335, 1939, 32, 8, 576, 3072, 12871, 1124, 2359, 26056, 74, 27180, 59, 1291, 60, 15159, 44, 51185, 16, 13, 576, 10126, 374, 5672, 2492, 8335, 624, 33, 8, 576, 3072, 12871, 1124, 2359, 26056, 74, 27180, 59, 1291, 60, 15159, 44, 92, 10829, 16, 13, 576, 10126, 374, 5672, 2492, 8335, 624, 34, 8, 576, 3072, 12871, 1124, 2359, 26056, 74, 27180, 59, 1291, 60, 15159, 44, 51185, 16, 13, 576, 10126, 374, 537, 5672, 2492, 8335, 624, 35, 8, 576, 3072, 12871, 1124, 2359, 26056, 74, 27180, 59, 1291, 60, 15159, 44, 92, 10829, 16, 13, 576, 10126, 374, 537, 5672, 2492, 8335, 13, 151645, 198, 151644, 77091, 198]",,264,491,755,0.0,0.0
9a70f081-39d0-4d6d-9934-e76c12476143,7,69,"[151643, 151643, 151643, 151643, 151643, 151643, 151643, 151643, 151643, 151643, 151643, 151643, 151643, 151643, 151643, 151643, 151643, 151643, 151643, 151643, 151643, 151643, 151643, 151643, 151643, 151643, 151643, 151643, 151643, 151643, 151643, 151643, 151643, 151643, 151643, 151643, 151643, 151643, 151643, 151643, 151643, 151643, 151643, 151643, 151643, 151643, 151643, 151643, 151643, 151643, 151643, 151643, 151643, 151643, 151643, 151643, 151643, 151643, 151643, 151643, 151643, 151643, 151643, 151643, 151643, 151643, 151643, 151643, 151643, 151643, 151643, 151643, 151643, 151643, 151643, 151643, 151643, 151643, 151643, 151643, 151643, 151643, 151643, 151643, 151643, 151643, 151643, 151643, 151643, 151643, 151643, 151643, 151643, 151643, 151643, 151643, 151643, 151643, 151643, 151643, 151643, 151643, 151643, 151643, 151643, 151643, 151643, 151643, 151643, 151643, 151643, 151643, 151643, 151643, 151643, 151643, 151643, 151643, 151643, 151643, 151643, 151643, 151643, 151643, 151643, 151643, 151643, 151643, 151643, 151643, 151643, 151643, 151643, 151643, 151643, 151643, 151643, 151643, 151643, 151643, 151643, 151643, 151643, 151643, 151643, 151643, 151643, 151643, 151643, 151643, 151643, 151643, 151643, 151643, 151643, 151643, 151643, 151643, 151643, 151643, 151643, 151643, 151643, 151643, 151643, 151643, 151643, 151643, 151643, 151643, 151643, 151643, 151643, 151643, 151643, 151643, 151643, 151643, 151643, 151643, 151643, 151643, 151643, 151643, 151643, 151643, 151643, 151643, 151643, 151643, 151643, 151643, 151643, 151643, 151643, 151643, 151643, 151643, 151643, 151643, 151643, 151643, 151643, 151643, 151643, 151643, 151643, 151643, 151643, 151643, 151643, 151643, 151643, 151643, 151643, 151643, 151643, 151643, 151643, 151643, 151643, 151643, 151643, 151643, 151643, 151643, 151643, 151643, 151643, 151643, 151643, 151643, 151643, 151643, 151643, 151643, 151643, 151643, 151643, 151643, 151643, 151643, 151643, 151643, 151643, 151643, 151643, 151643, 151643, 151643, 151643, 151643, 151643, 151643, 151643, 151643, 151643, 151643, 151643, 151643, 151643, 151643, 151643, 151643, 151643, 151643, 151643, 151643, 151643, 151643, 151643, 151643, 151643, 151643, 151643, 151643, 151643, 151643, 151643, 151643, 151643, 151643, 151643, 151643, 151643, 151643, 151643, 151643, 151643, 151643, 151643, 151643, 151643, 151643, 151643, 151643, 151643, 151643, 151643, 151643, 151643, 151643, 151643, 151643, 151643, 151643, 151643, 151643, 151643, 151643, 151643, 151643, 151643, 151643, 151643, 151643, 151643, 151643, 151643, 151643, 151643, 151643, 151643, 151643, 151643, 151643, 151643, 151643, 151643, 151643, 151643, 151643, 151643, 151643, 151643, 151643, 151643, 151643, 151643, 151643, 151643, 151643, 151643, 151643, 151643, 151643, 151643, 151643, 151643, 151643, 151643, 151643, 151643, 151643, 151643, 151643, 151643, 151643, 151643, 151643, 151643, 151643, 151643, 151643, 151643, 151643, 151643, 151643, 151643, 151643, 151643, 151643, 151643, 151643, 151643, 151643, 151643, 151643, 151643, 151643, 151643, 151643, 151643, 151643, 151643, 151643, 151643, 151643, 151643, 151643, 151643, 151643, 151643, 151643, 151643, 151643, 151643, 151643, 151643, 151643, 151643, 151643, 151643, 151643, 151643, 151643, 151643, 151643, 151643, 151643, 151643, 151643, 151643, 151643, 151643, 151643, 151643, 151643, 151643, 151643, 151643, 151643, 151643, 151643, 151643, 151643, 151643, 151643, 151643, 151643, 151643, 151643, 151643, 151643, 151643, 151643, 151643, 151643, 151643, 151643, 151643, 151643, 151643, 151643, 151643, 151643, 151643, 151643, 151643, 151643, 151643, 151643, 151643, 151643, 151643, 151643, 151643, 151643, 151643, 151643, 151643, 151643, 151643, 151643, 151643, 151643, 151643, 151643, 151643, 151643, 151643, 151643, 151643, 151643, 151643, 151643, 151643, 151643, 151643, 151643, 151643, 151643, 151643, 151643, 151643, 151643, 151643, 151643, 151643, 151643, 151643, 151643, 151643, 151643, 151643, 151643, 151643, 151643, 151643, 151643, 151643, 151643, 151643, 151643, 151643, 151643, 151643, 151643, 151643, 151643, 151643, 151643, 151643, 151643, 151643, 151643, 151643, 151643, 151643, 151643, 151643, 151643, 151643, 151643, 151643, 151643, 151643, 151643, 151643, 151643, 151643, 151643, 151643, 151643, 151643, 151643, 151643, 151643, 151643, 151643, 151643, 151643, 151643, 151643, 151643, 151643, 151643, 151643, 151643, 151643, 151643, 151643, 151643, 151643, 151643, 151643, 151643, 151643, 151643, 151643, 151643, 151643, 151643, 151643, 151643, 151643, 151643, 151643, 151643, 151643, 151643, 151643, 151643, 151643, 151643, 151643, 151643, 151643, 151643, 151643, 151643, 151643, 151643, 151643, 151643, 151643, 151643, 151643, 151643, 151643, 151643, 151643, 151643, 151644, 8948, 198, 2610, 525, 1207, 16948, 11, 3465, 553, 54364, 14817, 13, 1446, 525, 264, 10950, 17847, 13, 151645, 198, 151644, 872, 198, 16141, 279, 2701, 5248, 5754, 3405, 13, 576, 1537, 1555, 315, 697, 2033, 1265, 387, 315, 279, 2701, 3561, 25, 364, 16141, 25, 400, 20756, 4198, 6, 320, 28996, 17194, 8, 1380, 44428, 374, 825, 315, 19360, 35, 13, 21149, 3019, 553, 3019, 1573, 35764, 382, 785, 17471, 580, 337, 9299, 258, 580, 337, 603, 55327, 56633, 374, 264, 11483, 12720, 15860, 279, 14409, 315, 264, 8983, 580, 337, 41930, 11, 8482, 1378, 23942, 12904, 5203, 11, 1119, 264, 8983, 580, 337, 603, 1212, 83803, 4682, 13, 1084, 33455, 1526, 279, 81486, 367, 315, 825, 12904, 1874, 11, 8110, 553, 264, 220, 16, 11, 17, 2832, 40121, 1399, 6407, 11, 6388, 311, 279, 18003, 315, 264, 31281, 603, 320, 13273, 580, 337, 603, 8, 323, 279, 55327, 56633, 315, 279, 41930, 594, 5944, 624, 3838, 525, 279, 5916, 7236, 323, 3871, 315, 279, 2701, 17471, 580, 337, 17471, 580, 337, 603, 55327, 56633, 24473, 5267, 32, 488, 472, 17, 13880, 19, 69726, 220, 17, 11, 17, 50289, 2268, 2385, 337, 3923, 66, 3337, 385, 17308, 276, 12, 16, 18589, 198, 76, 41872, 220, 17, 11, 18, 1737, 6996, 67007, 4130, 12, 17, 8013, 79, 2385, 337, 3923, 8, 8088, 5652, 349, 488, 472, 17, 13880, 19, 69726, 425, 271, 32, 8, 362, 284, 220, 16, 8013, 66129, 4130, 8579, 2268, 2385, 337, 3923, 76, 41872, 46986, 3337, 385, 17308, 276, 12, 16, 12, 337, 11, 425, 284, 78474, 220, 17, 1448, 41872, 12, 18, 12, 5131, 78, 12, 17, 8013, 79, 2385, 337, 3923, 8, 776, 848, 78, 349, 198, 33, 8, 362, 284, 220, 16, 8013, 66129, 4130, 8579, 2268, 2385, 337, 3923, 76, 41872, 46986, 3337, 385, 17308, 276, 12, 16, 12, 337, 11, 425, 284, 78474, 220, 18, 12, 5131, 78, 12, 17, 8013, 79, 2385, 337, 3923, 8, 8088, 5652, 349, 198, 34, 8, 362, 284, 220, 16, 8013, 66129, 4130, 8579, 2268, 2385, 337, 3923, 76, 41872, 46986, 3337, 22288, 306, 276, 12, 16, 12, 337, 11, 425, 284, 78474, 220, 18, 12, 5131, 78, 12, 17, 8013, 79, 2385, 337, 3923, 8, 8088, 5652, 349, 198, 35, 8, 362, 284, 220, 16, 8013, 66129, 4130, 8579, 2268, 2385, 337, 3923, 76, 41872, 46986, 3337, 22288, 306, 276, 12, 16, 12, 337, 11, 425, 284, 78474, 220, 17, 1448, 41872, 12, 18, 12, 5131, 78, 12, 17, 8013, 79, 2385, 337, 3923, 8, 776, 848, 78, 349, 151645, 198, 151644, 77091, 198]",,431,670,1101,0.0,0.0
34c2f7ce-b952-4f1f-9500-eb844642c884,7,70,"[151643, 151643, 151643, 151643, 151643, 151643, 151643, 151643, 151643, 151643, 151643, 151643, 151643, 151643, 151643, 151643, 151643, 151643, 151643, 151643, 151643, 151643, 151643, 151643, 151643, 151643, 151643, 151643, 151643, 151643, 151643, 151643, 151643, 151643, 151643, 151643, 151643, 151643, 151643, 151643, 151643, 151643, 151643, 151643, 151643, 151643, 151643, 151643, 151643, 151643, 151643, 151643, 151643, 151643, 151643, 151643, 151643, 151643, 151643, 151643, 151643, 151643, 151643, 151643, 151643, 151643, 151643, 151643, 151643, 151643, 151643, 151643, 151643, 151643, 151643, 151643, 151643, 151643, 151643, 151643, 151643, 151643, 151643, 151643, 151643, 151643, 151643, 151643, 151643, 151643, 151643, 151643, 151643, 151643, 151643, 151643, 151643, 151643, 151643, 151643, 151643, 151643, 151643, 151643, 151643, 151643, 151643, 151643, 151643, 151643, 151643, 151643, 151643, 151643, 151643, 151643, 151643, 151643, 151643, 151643, 151643, 151643, 151643, 151643, 151643, 151643, 151643, 151643, 151643, 151643, 151643, 151643, 151643, 151643, 151643, 151643, 151643, 151643, 151643, 151643, 151643, 151643, 151643, 151643, 151643, 151643, 151643, 151643, 151643, 151643, 151643, 151643, 151643, 151643, 151643, 151643, 151643, 151643, 151643, 151643, 151643, 151643, 151643, 151643, 151643, 151643, 151643, 151643, 151643, 151643, 151643, 151643, 151643, 151643, 151643, 151643, 151643, 151643, 151643, 151643, 151643, 151643, 151643, 151643, 151643, 151643, 151643, 151643, 151643, 151643, 151643, 151643, 151643, 151643, 151643, 151643, 151643, 151643, 151643, 151643, 151643, 151643, 151643, 151643, 151643, 151643, 151643, 151643, 151643, 151643, 151643, 151643, 151643, 151643, 151643, 151643, 151643, 151643, 151643, 151643, 151643, 151643, 151643, 151643, 151643, 151643, 151643, 151643, 151643, 151643, 151643, 151643, 151643, 151643, 151643, 151643, 151643, 151643, 151643, 151643, 151643, 151643, 151643, 151643, 151643, 151643, 151643, 151643, 151643, 151643, 151643, 151643, 151643, 151643, 151643, 151643, 151643, 151643, 151643, 151643, 151643, 151643, 151643, 151643, 151643, 151643, 151643, 151643, 151643, 151643, 151643, 151643, 151643, 151643, 151643, 151643, 151643, 151643, 151643, 151643, 151643, 151643, 151643, 151643, 151643, 151643, 151643, 151643, 151643, 151643, 151643, 151643, 151643, 151643, 151643, 151643, 151643, 151643, 151643, 151643, 151643, 151643, 151643, 151643, 151643, 151643, 151643, 151643, 151643, 151643, 151643, 151643, 151643, 151643, 151643, 151643, 151643, 151643, 151643, 151643, 151643, 151643, 151643, 151643, 151643, 151643, 151643, 151643, 151643, 151643, 151643, 151643, 151643, 151643, 151643, 151643, 151643, 151643, 151643, 151643, 151643, 151643, 151643, 151643, 151643, 151643, 151643, 151643, 151643, 151643, 151643, 151643, 151643, 151643, 151643, 151643, 151643, 151643, 151643, 151643, 151643, 151643, 151643, 151643, 151643, 151643, 151643, 151643, 151643, 151643, 151643, 151643, 151643, 151643, 151643, 151643, 151643, 151643, 151643, 151643, 151643, 151643, 151643, 151643, 151643, 151643, 151643, 151643, 151643, 151643, 151643, 151643, 151643, 151643, 151643, 151643, 151643, 151643, 151643, 151643, 151643, 151643, 151643, 151643, 151643, 151643, 151643, 151643, 151643, 151643, 151643, 151643, 151643, 151643, 151643, 151643, 151643, 151643, 151643, 151643, 151643, 151643, 151643, 151643, 151643, 151643, 151643, 151643, 151643, 151643, 151643, 151643, 151643, 151643, 151643, 151643, 151643, 151643, 151643, 151643, 151643, 151643, 151643, 151643, 151643, 151643, 151643, 151643, 151643, 151643, 151643, 151643, 151643, 151643, 151643, 151643, 151643, 151643, 151643, 151643, 151643, 151643, 151643, 151643, 151643, 151643, 151643, 151643, 151643, 151643, 151643, 151643, 151643, 151643, 151643, 151643, 151643, 151643, 151643, 151643, 151643, 151643, 151643, 151643, 151643, 151643, 151643, 151643, 151643, 151643, 151643, 151643, 151643, 151643, 151643, 151643, 151643, 151643, 151643, 151643, 151643, 151643, 151643, 151643, 151643, 151643, 151643, 151643, 151643, 151643, 151643, 151643, 151643, 151643, 151643, 151643, 151643, 151643, 151643, 151643, 151643, 151643, 151643, 151643, 151643, 151643, 151643, 151643, 151643, 151643, 151643, 151643, 151643, 151643, 151643, 151643, 151643, 151643, 151643, 151643, 151643, 151643, 151643, 151643, 151643, 151643, 151643, 151643, 151643, 151643, 151643, 151643, 151643, 151643, 151643, 151643, 151643, 151643, 151643, 151643, 151643, 151643, 151643, 151643, 151643, 151643, 151643, 151643, 151643, 151643, 151643, 151643, 151643, 151643, 151643, 151643, 151643, 151643, 151643, 151643, 151643, 151643, 151643, 151643, 151643, 151643, 151643, 151643, 151643, 151643, 151643, 151643, 151643, 151643, 151643, 151643, 151643, 151643, 151643, 151643, 151643, 151643, 151643, 151643, 151643, 151643, 151643, 151643, 151643, 151643, 151643, 151643, 151643, 151643, 151643, 151643, 151643, 151643, 151643, 151643, 151643, 151643, 151643, 151643, 151643, 151643, 151643, 151643, 151643, 151643, 151643, 151643, 151643, 151643, 151643, 151643, 151643, 151643, 151643, 151643, 151643, 151643, 151643, 151643, 151643, 151643, 151643, 151643, 151643, 151643, 151643, 151643, 151643, 151643, 151643, 151643, 151643, 151643, 151643, 151643, 151643, 151643, 151643, 151643, 151643, 151643, 151643, 151643, 151643, 151643, 151643, 151643, 151643, 151643, 151643, 151643, 151643, 151643, 151643, 151643, 151643, 151643, 151643, 151643, 151643, 151643, 151643, 151643, 151643, 151643, 151643, 151643, 151643, 151643, 151643, 151643, 151643, 151643, 151643, 151643, 151643, 151643, 151643, 151643, 151643, 151643, 151643, 151643, 151643, 151643, 151643, 151643, 151643, 151643, 151643, 151643, 151643, 151643, 151643, 151643, 151643, 151643, 151643, 151643, 151643, 151643, 151643, 151643, 151643, 151643, 151643, 151643, 151643, 151643, 151643, 151643, 151643, 151643, 151643, 151643, 151643, 151643, 151643, 151643, 151643, 151643, 151643, 151643, 151643, 151643, 151643, 151643, 151643, 151643, 151643, 151643, 151643, 151643, 151643, 151643, 151643, 151643, 151643, 151643, 151643, 151643, 151643, 151643, 151643, 151643, 151643, 151643, 151643, 151643, 151643, 151643, 151643, 151643, 151643, 151643, 151643, 151643, 151643, 151643, 151643, 151643, 151643, 151643, 151643, 151643, 151643, 151643, 151643, 151643, 151643, 151643, 151643, 151643, 151643, 151643, 151643, 151643, 151643, 151643, 151643, 151643, 151643, 151643, 151643, 151643, 151643, 151643, 151643, 151643, 151643, 151643, 151643, 151643, 151643, 151643, 151643, 151643, 151643, 151643, 151643, 151643, 151643, 151643, 151643, 151643, 151643, 151643, 151643, 151643, 151643, 151643, 151643, 151643, 151643, 151643, 151643, 151643, 151643, 151643, 151643, 151643, 151643, 151643, 151643, 151643, 151643, 151643, 151643, 151643, 151643, 151643, 151643, 151643, 151643, 151643, 151643, 151643, 151643, 151643, 151643, 151643, 151643, 151643, 151643, 151643, 151644, 8948, 198, 2610, 525, 1207, 16948, 11, 3465, 553, 54364, 14817, 13, 1446, 525, 264, 10950, 17847, 13, 151645, 198, 151644, 872, 198, 16141, 279, 2701, 5248, 5754, 3405, 13, 576, 1537, 1555, 315, 697, 2033, 1265, 387, 315, 279, 2701, 3561, 25, 364, 16141, 25, 400, 20756, 4198, 6, 320, 28996, 17194, 8, 1380, 44428, 374, 825, 315, 19360, 35, 13, 21149, 3019, 553, 3019, 1573, 35764, 382, 7983, 21828, 5080, 55887, 8628, 37906, 3832, 311, 14452, 2856, 323, 18732, 4682, 1526, 5080, 1973, 34226, 6672, 9848, 96376, 323, 15279, 44373, 11, 279, 6172, 58755, 729, 374, 9848, 7145, 553, 264, 68209, 56204, 13, 576, 1376, 8168, 315, 33437, 51000, 12111, 1119, 15279, 12111, 374, 271, 32, 8, 28263, 7130, 19419, 315, 68209, 56204, 198, 33, 8, 22096, 19703, 315, 68209, 56204, 198, 34, 8, 61809, 763, 315, 2477, 2438, 18732, 4682, 198, 35, 8, 80138, 6358, 151645, 198, 151644, 77091, 198]",,154,203,357,0.0,0.0
14ed2681-babd-48a2-905b-dc0af76eca8f,7,71,"[151643, 151643, 151643, 151643, 151643, 151643, 151643, 151643, 151643, 151643, 151643, 151643, 151643, 151643, 151643, 151643, 151643, 151643, 151643, 151643, 151643, 151643, 151643, 151643, 151643, 151643, 151643, 151643, 151643, 151643, 151643, 151643, 151643, 151643, 151643, 151643, 151643, 151643, 151643, 151643, 151643, 151643, 151643, 151643, 151643, 151643, 151643, 151643, 151643, 151643, 151643, 151643, 151643, 151643, 151643, 151643, 151643, 151643, 151643, 151643, 151643, 151643, 151643, 151643, 151643, 151643, 151643, 151643, 151643, 151643, 151643, 151643, 151643, 151643, 151643, 151643, 151643, 151643, 151643, 151643, 151643, 151643, 151643, 151643, 151643, 151643, 151643, 151643, 151643, 151643, 151643, 151643, 151643, 151643, 151643, 151643, 151643, 151643, 151643, 151643, 151643, 151643, 151643, 151643, 151643, 151643, 151643, 151643, 151643, 151643, 151643, 151643, 151643, 151643, 151643, 151643, 151643, 151643, 151643, 151643, 151643, 151643, 151643, 151643, 151643, 151643, 151643, 151643, 151643, 151643, 151643, 151643, 151643, 151643, 151643, 151643, 151643, 151643, 151643, 151643, 151643, 151643, 151643, 151643, 151643, 151643, 151643, 151643, 151643, 151643, 151643, 151643, 151643, 151643, 151643, 151643, 151643, 151643, 151643, 151643, 151643, 151643, 151643, 151643, 151643, 151643, 151643, 151643, 151643, 151643, 151643, 151643, 151643, 151643, 151643, 151643, 151643, 151643, 151643, 151643, 151643, 151643, 151643, 151643, 151643, 151643, 151643, 151643, 151643, 151643, 151643, 151643, 151643, 151643, 151643, 151643, 151643, 151643, 151643, 151643, 151643, 151643, 151643, 151643, 151643, 151643, 151643, 151643, 151643, 151643, 151643, 151643, 151643, 151643, 151643, 151643, 151643, 151643, 151643, 151643, 151643, 151643, 151643, 151643, 151643, 151643, 151643, 151643, 151643, 151643, 151643, 151643, 151643, 151643, 151643, 151643, 151643, 151643, 151643, 151643, 151643, 151643, 151643, 151643, 151643, 151643, 151643, 151643, 151643, 151643, 151643, 151643, 151643, 151643, 151643, 151643, 151643, 151643, 151643, 151643, 151643, 151643, 151643, 151643, 151643, 151643, 151643, 151643, 151643, 151643, 151643, 151643, 151643, 151643, 151643, 151643, 151643, 151643, 151643, 151643, 151643, 151643, 151643, 151643, 151643, 151643, 151643, 151643, 151643, 151643, 151643, 151643, 151643, 151643, 151643, 151643, 151643, 151643, 151643, 151643, 151643, 151643, 151643, 151643, 151643, 151643, 151643, 151643, 151643, 151643, 151643, 151643, 151643, 151643, 151643, 151643, 151643, 151643, 151643, 151643, 151643, 151643, 151643, 151643, 151643, 151643, 151643, 151643, 151643, 151643, 151643, 151643, 151643, 151643, 151643, 151643, 151643, 151643, 151643, 151643, 151643, 151643, 151643, 151643, 151643, 151643, 151643, 151643, 151643, 151643, 151643, 151643, 151643, 151643, 151643, 151643, 151643, 151643, 151643, 151643, 151643, 151643, 151643, 151643, 151643, 151643, 151643, 151643, 151643, 151643, 151643, 151643, 151643, 151643, 151643, 151643, 151643, 151643, 151643, 151643, 151643, 151643, 151643, 151643, 151643, 151643, 151643, 151643, 151643, 151643, 151643, 151643, 151643, 151643, 151643, 151643, 151643, 151643, 151643, 151643, 151643, 151643, 151643, 151643, 151643, 151643, 151643, 151643, 151643, 151643, 151643, 151643, 151643, 151643, 151643, 151643, 151643, 151643, 151643, 151643, 151643, 151643, 151643, 151643, 151643, 151643, 151643, 151643, 151643, 151643, 151643, 151643, 151643, 151643, 151643, 151643, 151643, 151643, 151643, 151643, 151643, 151643, 151643, 151643, 151643, 151643, 151643, 151643, 151643, 151643, 151643, 151643, 151643, 151643, 151643, 151643, 151643, 151643, 151643, 151643, 151643, 151643, 151643, 151643, 151643, 151643, 151643, 151643, 151643, 151643, 151643, 151643, 151643, 151643, 151643, 151643, 151643, 151643, 151643, 151643, 151643, 151643, 151643, 151643, 151643, 151643, 151643, 151643, 151643, 151643, 151643, 151643, 151643, 151643, 151643, 151643, 151643, 151643, 151643, 151643, 151643, 151643, 151643, 151643, 151643, 151643, 151643, 151643, 151643, 151643, 151643, 151643, 151643, 151643, 151643, 151643, 151643, 151643, 151643, 151643, 151643, 151643, 151643, 151643, 151643, 151643, 151643, 151643, 151643, 151643, 151643, 151643, 151643, 151643, 151643, 151643, 151643, 151643, 151643, 151643, 151643, 151643, 151643, 151643, 151643, 151643, 151643, 151643, 151643, 151643, 151643, 151643, 151643, 151643, 151643, 151643, 151643, 151643, 151643, 151643, 151643, 151643, 151643, 151643, 151643, 151643, 151643, 151643, 151643, 151643, 151643, 151643, 151643, 151643, 151643, 151643, 151643, 151643, 151643, 151643, 151643, 151643, 151643, 151643, 151643, 151643, 151643, 151643, 151643, 151643, 151643, 151643, 151643, 151643, 151643, 151643, 151643, 151643, 151643, 151643, 151643, 151643, 151643, 151643, 151643, 151643, 151643, 151643, 151643, 151643, 151643, 151643, 151643, 151643, 151643, 151643, 151643, 151643, 151643, 151643, 151643, 151643, 151643, 151643, 151643, 151643, 151643, 151643, 151643, 151643, 151643, 151643, 151643, 151643, 151643, 151643, 151643, 151643, 151643, 151643, 151643, 151643, 151643, 151643, 151643, 151643, 151643, 151643, 151643, 151643, 151643, 151643, 151643, 151643, 151643, 151643, 151643, 151643, 151643, 151643, 151643, 151643, 151643, 151643, 151643, 151643, 151643, 151643, 151643, 151643, 151643, 151643, 151643, 151643, 151643, 151643, 151643, 151643, 151643, 151643, 151643, 151643, 151643, 151643, 151643, 151643, 151643, 151643, 151643, 151643, 151643, 151643, 151643, 151643, 151643, 151643, 151643, 151643, 151643, 151643, 151643, 151643, 151643, 151643, 151643, 151644, 8948, 198, 2610, 525, 1207, 16948, 11, 3465, 553, 54364, 14817, 13, 1446, 525, 264, 10950, 17847, 13, 151645, 198, 151644, 872, 198, 16141, 279, 2701, 5248, 5754, 3405, 13, 576, 1537, 1555, 315, 697, 2033, 1265, 387, 315, 279, 2701, 3561, 25, 364, 16141, 25, 400, 20756, 4198, 6, 320, 28996, 17194, 8, 1380, 44428, 374, 825, 315, 19360, 35, 13, 21149, 3019, 553, 3019, 1573, 35764, 382, 4498, 49485, 4155, 5131, 3341, 525, 54741, 448, 2872, 72125, 66485, 11, 279, 57898, 3923, 1874, 315, 279, 312, 8092, 374, 2677, 11523, 518, 2686, 56680, 291, 12499, 315, 279, 4155, 54089, 10058, 13, 758, 279, 827, 392, 3696, 2774, 4155, 5131, 3341, 11, 46488, 315, 6546, 13666, 518, 264, 12499, 311, 892, 32324, 374, 3694, 13, 64547, 279, 1985, 979, 320, 16, 49, 11, 18, 49, 11, 19, 49, 11, 21, 50, 7287, 16, 11, 18, 11, 19, 10188, 318, 41872, 12, 22, 12, 5131, 370, 2842, 32578, 508, 19, 13, 16, 13, 15, 60, 566, 417, 2145, 374, 54741, 448, 2157, 17, 44819, 45421, 1447, 32, 8, 320, 16, 49, 11, 17, 49, 11, 19, 49, 11, 20, 49, 7287, 16, 11, 17, 11, 19, 11, 20, 2385, 295, 2396, 41872, 66, 3337, 385, 17308, 276, 12, 16, 12, 337, 198, 33, 8, 320, 16, 50, 11, 19, 49, 11, 20, 50, 7287, 17, 11, 17, 11, 19, 11, 20, 2385, 295, 2396, 41872, 66, 3337, 385, 17308, 276, 12, 16, 12, 337, 198, 34, 8, 320, 16, 49, 11, 17, 50, 11, 19, 49, 11, 20, 49, 7287, 16, 11, 17, 11, 19, 11, 20, 2385, 295, 2396, 41872, 66, 3337, 385, 17308, 276, 12, 16, 12, 337, 198, 35, 8, 320, 16, 49, 11, 19, 49, 11, 20, 49, 7287, 17, 11, 17, 11, 19, 11, 20, 2385, 295, 2396, 41872, 66, 3337, 385, 17308, 276, 12, 16, 12, 337, 151645, 198, 151644, 77091, 198]",,319,480,799,0.0,0.0
e583fc93-e001-4439-bb50-f0bf1101e4d8,7,72,"[151643, 151643, 151643, 151643, 151643, 151643, 151643, 151643, 151643, 151643, 151643, 151643, 151643, 151643, 151643, 151643, 151643, 151643, 151643, 151643, 151643, 151643, 151643, 151643, 151643, 151643, 151643, 151643, 151643, 151643, 151643, 151643, 151643, 151643, 151643, 151643, 151643, 151643, 151643, 151643, 151643, 151643, 151643, 151643, 151643, 151643, 151643, 151643, 151643, 151643, 151643, 151643, 151643, 151643, 151643, 151643, 151643, 151643, 151643, 151643, 151643, 151643, 151643, 151643, 151643, 151643, 151643, 151643, 151643, 151643, 151643, 151643, 151643, 151643, 151643, 151643, 151643, 151643, 151643, 151643, 151643, 151643, 151643, 151643, 151643, 151643, 151643, 151643, 151643, 151643, 151643, 151643, 151643, 151643, 151643, 151643, 151643, 151643, 151643, 151643, 151643, 151643, 151643, 151643, 151643, 151643, 151643, 151643, 151643, 151643, 151643, 151643, 151643, 151643, 151643, 151643, 151643, 151643, 151643, 151643, 151643, 151643, 151643, 151643, 151643, 151643, 151643, 151643, 151643, 151643, 151643, 151643, 151643, 151643, 151643, 151643, 151643, 151643, 151643, 151643, 151643, 151643, 151643, 151643, 151643, 151643, 151643, 151643, 151643, 151643, 151643, 151643, 151643, 151643, 151643, 151643, 151643, 151643, 151643, 151643, 151643, 151643, 151643, 151643, 151643, 151643, 151643, 151643, 151643, 151643, 151643, 151643, 151643, 151643, 151643, 151643, 151643, 151643, 151643, 151643, 151643, 151643, 151643, 151643, 151643, 151643, 151643, 151643, 151643, 151643, 151643, 151643, 151643, 151643, 151643, 151643, 151643, 151643, 151643, 151643, 151643, 151643, 151643, 151643, 151643, 151643, 151643, 151643, 151643, 151643, 151643, 151643, 151643, 151643, 151643, 151643, 151643, 151643, 151643, 151643, 151643, 151643, 151643, 151643, 151643, 151643, 151643, 151643, 151643, 151643, 151643, 151643, 151643, 151643, 151643, 151643, 151643, 151643, 151643, 151643, 151643, 151643, 151643, 151643, 151643, 151643, 151643, 151643, 151643, 151643, 151643, 151643, 151643, 151643, 151643, 151643, 151643, 151643, 151643, 151643, 151643, 151643, 151643, 151643, 151643, 151643, 151643, 151643, 151643, 151643, 151643, 151643, 151643, 151643, 151643, 151643, 151643, 151643, 151643, 151643, 151643, 151643, 151643, 151643, 151643, 151643, 151643, 151643, 151643, 151643, 151643, 151643, 151643, 151643, 151643, 151643, 151643, 151643, 151643, 151643, 151643, 151643, 151643, 151643, 151643, 151643, 151643, 151643, 151643, 151643, 151643, 151643, 151643, 151643, 151643, 151643, 151643, 151643, 151643, 151643, 151643, 151643, 151643, 151643, 151643, 151643, 151643, 151643, 151643, 151643, 151643, 151643, 151643, 151643, 151643, 151643, 151643, 151643, 151643, 151643, 151643, 151643, 151643, 151643, 151643, 151643, 151643, 151643, 151643, 151643, 151643, 151643, 151643, 151643, 151643, 151643, 151643, 151643, 151643, 151643, 151643, 151643, 151643, 151643, 151643, 151643, 151643, 151643, 151643, 151643, 151643, 151643, 151643, 151643, 151643, 151643, 151643, 151643, 151643, 151643, 151643, 151643, 151643, 151643, 151643, 151643, 151643, 151643, 151643, 151643, 151643, 151643, 151643, 151643, 151643, 151643, 151643, 151643, 151643, 151643, 151643, 151643, 151643, 151643, 151643, 151643, 151643, 151643, 151643, 151643, 151643, 151643, 151643, 151643, 151643, 151643, 151643, 151643, 151643, 151643, 151643, 151643, 151643, 151643, 151643, 151643, 151643, 151643, 151643, 151643, 151643, 151643, 151643, 151643, 151643, 151643, 151643, 151643, 151643, 151643, 151643, 151643, 151643, 151643, 151643, 151643, 151643, 151643, 151643, 151643, 151643, 151643, 151643, 151643, 151643, 151643, 151643, 151643, 151643, 151643, 151643, 151643, 151643, 151643, 151643, 151643, 151643, 151643, 151643, 151643, 151643, 151643, 151643, 151643, 151643, 151643, 151643, 151643, 151643, 151643, 151643, 151643, 151643, 151643, 151643, 151643, 151643, 151643, 151643, 151643, 151643, 151643, 151643, 151643, 151643, 151643, 151643, 151643, 151643, 151643, 151643, 151643, 151643, 151643, 151643, 151643, 151643, 151643, 151643, 151643, 151643, 151643, 151643, 151643, 151643, 151643, 151643, 151643, 151643, 151643, 151643, 151643, 151643, 151643, 151643, 151643, 151643, 151643, 151643, 151643, 151643, 151643, 151643, 151643, 151643, 151643, 151643, 151643, 151643, 151643, 151643, 151643, 151643, 151643, 151643, 151643, 151643, 151643, 151643, 151643, 151643, 151643, 151643, 151643, 151643, 151643, 151643, 151643, 151643, 151643, 151643, 151643, 151643, 151643, 151643, 151643, 151643, 151643, 151643, 151643, 151643, 151643, 151643, 151643, 151643, 151643, 151643, 151643, 151643, 151643, 151643, 151643, 151643, 151643, 151643, 151643, 151643, 151643, 151643, 151643, 151643, 151643, 151643, 151643, 151643, 151643, 151643, 151643, 151643, 151643, 151643, 151643, 151643, 151643, 151643, 151643, 151643, 151643, 151643, 151643, 151643, 151643, 151643, 151643, 151643, 151643, 151643, 151643, 151643, 151643, 151643, 151643, 151643, 151643, 151643, 151643, 151643, 151643, 151643, 151643, 151643, 151643, 151643, 151643, 151643, 151643, 151643, 151643, 151643, 151643, 151643, 151643, 151643, 151643, 151643, 151643, 151643, 151643, 151643, 151643, 151643, 151643, 151643, 151643, 151643, 151643, 151643, 151643, 151643, 151643, 151643, 151643, 151643, 151643, 151643, 151643, 151643, 151643, 151643, 151643, 151643, 151643, 151643, 151643, 151643, 151643, 151643, 151643, 151643, 151643, 151643, 151643, 151643, 151643, 151643, 151643, 151643, 151643, 151643, 151643, 151643, 151643, 151643, 151643, 151643, 151643, 151643, 151643, 151643, 151644, 8948, 198, 2610, 525, 1207, 16948, 11, 3465, 553, 54364, 14817, 13, 1446, 525, 264, 10950, 17847, 13, 151645, 198, 151644, 872, 198, 16141, 279, 2701, 5248, 5754, 3405, 13, 576, 1537, 1555, 315, 697, 2033, 1265, 387, 315, 279, 2701, 3561, 25, 364, 16141, 25, 400, 20756, 4198, 6, 320, 28996, 17194, 8, 1380, 44428, 374, 825, 315, 19360, 35, 13, 21149, 3019, 553, 3019, 1573, 35764, 382, 7983, 29729, 264, 1550, 62936, 18368, 16715, 72657, 10350, 518, 458, 68641, 21720, 315, 220, 16, 15, 15, 15, 595, 53, 11, 11268, 8433, 28202, 42775, 311, 1855, 458, 23998, 27561, 28202, 1584, 22438, 220, 16, 15, 49309, 24, 8444, 81, 8, 304, 279, 6077, 43498, 11, 37078, 311, 29337, 279, 9362, 315, 6819, 34615, 369, 12944, 16715, 91814, 13, 4354, 11, 438, 3601, 11, 1045, 6819, 18730, 14616, 4766, 279, 43498, 11, 438, 16507, 553, 279, 3072, 9431, 87271, 13, 11268, 29257, 10838, 279, 3076, 1910, 1815, 315, 1493, 6819, 34615, 304, 279, 28202, 1584, 22438, 220, 16, 15, 49309, 24, 8444, 81, 8, 311, 387, 48338, 16, 11, 3118, 389, 9363, 1741, 438, 6077, 43498, 8123, 11, 7262, 11, 323, 9315, 13, 4354, 11, 5193, 78416, 279, 16715, 23418, 11, 566, 1865, 458, 40665, 21930, 18310, 279, 3076, 1910, 1815, 3118, 389, 16715, 71816, 448, 279, 6819, 34615, 13, 1260, 1730, 429, 279, 3076, 1910, 1815, 572, 902, 5021, 6144, 311, 48338, 16, 26, 4751, 11, 432, 572, 48338, 17, 11, 1496, 3498, 279, 6077, 43498, 9315, 14616, 279, 1852, 382, 3838, 646, 582, 31094, 911, 48338, 17, 3118, 389, 279, 45652, 15048, 1939, 32, 8, 48338, 17, 2604, 220, 16, 13, 17, 17, 9, 33486, 16, 198, 33, 8, 48338, 17, 366, 48338, 16, 198, 34, 8, 48338, 17, 284, 48338, 16, 11, 18860, 264, 78005, 304, 11268, 594, 21930, 198, 35, 8, 48338, 16, 366, 48338, 17, 366, 220, 16, 13, 17, 17, 9, 33486, 16, 151645, 198, 151644, 77091, 198]",,325,222,547,1.0,1.0
0ec7f792-8100-40aa-a270-faa9d6fc59bf,7,73,"[151643, 151643, 151643, 151643, 151643, 151643, 151643, 151643, 151643, 151643, 151643, 151643, 151643, 151643, 151643, 151643, 151643, 151643, 151643, 151643, 151643, 151643, 151643, 151643, 151643, 151643, 151643, 151643, 151643, 151643, 151643, 151643, 151643, 151643, 151643, 151643, 151643, 151643, 151643, 151643, 151643, 151643, 151643, 151643, 151643, 151643, 151643, 151643, 151643, 151643, 151643, 151643, 151643, 151643, 151643, 151643, 151643, 151643, 151643, 151643, 151643, 151643, 151643, 151643, 151643, 151643, 151643, 151643, 151643, 151643, 151643, 151643, 151643, 151643, 151643, 151643, 151643, 151643, 151643, 151643, 151643, 151643, 151643, 151643, 151643, 151643, 151643, 151643, 151643, 151643, 151643, 151643, 151643, 151643, 151643, 151643, 151643, 151643, 151643, 151643, 151643, 151643, 151643, 151643, 151643, 151643, 151643, 151643, 151643, 151643, 151643, 151643, 151643, 151643, 151643, 151643, 151643, 151643, 151643, 151643, 151643, 151643, 151643, 151643, 151643, 151643, 151643, 151643, 151643, 151643, 151643, 151643, 151643, 151643, 151643, 151643, 151643, 151643, 151643, 151643, 151643, 151643, 151643, 151643, 151643, 151643, 151643, 151643, 151643, 151643, 151643, 151643, 151643, 151643, 151643, 151643, 151643, 151643, 151643, 151643, 151643, 151643, 151643, 151643, 151643, 151643, 151643, 151643, 151643, 151643, 151643, 151643, 151643, 151643, 151643, 151643, 151643, 151643, 151643, 151643, 151643, 151643, 151643, 151643, 151643, 151643, 151643, 151643, 151643, 151643, 151643, 151643, 151643, 151643, 151643, 151643, 151643, 151643, 151643, 151643, 151643, 151643, 151643, 151643, 151643, 151643, 151643, 151643, 151643, 151643, 151643, 151643, 151643, 151643, 151643, 151643, 151643, 151643, 151643, 151643, 151643, 151643, 151643, 151643, 151643, 151643, 151643, 151643, 151643, 151643, 151643, 151643, 151643, 151643, 151643, 151643, 151643, 151643, 151643, 151643, 151643, 151643, 151643, 151643, 151643, 151643, 151643, 151643, 151643, 151643, 151643, 151643, 151643, 151643, 151643, 151643, 151643, 151643, 151643, 151643, 151643, 151643, 151643, 151643, 151643, 151643, 151643, 151643, 151643, 151643, 151643, 151643, 151643, 151643, 151643, 151643, 151643, 151643, 151643, 151643, 151643, 151643, 151643, 151643, 151643, 151643, 151643, 151643, 151643, 151643, 151643, 151643, 151643, 151643, 151643, 151643, 151643, 151643, 151643, 151643, 151643, 151643, 151643, 151643, 151643, 151643, 151643, 151643, 151643, 151643, 151643, 151643, 151643, 151643, 151643, 151643, 151643, 151643, 151643, 151643, 151643, 151643, 151643, 151643, 151643, 151643, 151643, 151643, 151643, 151643, 151643, 151643, 151643, 151643, 151643, 151643, 151643, 151643, 151643, 151643, 151643, 151643, 151643, 151643, 151643, 151643, 151643, 151643, 151643, 151643, 151643, 151643, 151643, 151643, 151643, 151643, 151643, 151643, 151643, 151643, 151643, 151643, 151643, 151643, 151643, 151643, 151643, 151643, 151643, 151643, 151643, 151643, 151643, 151643, 151643, 151643, 151643, 151643, 151643, 151643, 151643, 151643, 151643, 151643, 151643, 151643, 151643, 151643, 151643, 151643, 151643, 151643, 151643, 151643, 151643, 151643, 151643, 151643, 151643, 151643, 151643, 151643, 151643, 151643, 151643, 151643, 151643, 151643, 151643, 151643, 151643, 151643, 151643, 151643, 151643, 151643, 151643, 151643, 151643, 151643, 151643, 151643, 151643, 151643, 151643, 151643, 151643, 151643, 151643, 151643, 151643, 151643, 151643, 151643, 151643, 151643, 151643, 151643, 151643, 151643, 151643, 151643, 151643, 151643, 151643, 151643, 151643, 151643, 151643, 151643, 151643, 151643, 151643, 151643, 151643, 151643, 151643, 151643, 151643, 151643, 151643, 151643, 151643, 151643, 151643, 151643, 151643, 151643, 151643, 151643, 151643, 151643, 151643, 151643, 151643, 151643, 151643, 151643, 151643, 151643, 151643, 151643, 151643, 151643, 151643, 151643, 151643, 151643, 151643, 151643, 151643, 151643, 151643, 151643, 151643, 151643, 151643, 151643, 151643, 151643, 151643, 151643, 151643, 151643, 151643, 151643, 151643, 151643, 151643, 151643, 151643, 151643, 151643, 151643, 151643, 151643, 151643, 151643, 151643, 151643, 151643, 151643, 151643, 151643, 151643, 151643, 151643, 151643, 151643, 151643, 151643, 151643, 151643, 151643, 151643, 151643, 151643, 151643, 151643, 151643, 151643, 151643, 151643, 151643, 151643, 151643, 151643, 151643, 151643, 151643, 151643, 151643, 151643, 151643, 151643, 151643, 151643, 151643, 151643, 151643, 151643, 151643, 151643, 151643, 151643, 151643, 151643, 151643, 151643, 151643, 151643, 151643, 151643, 151643, 151643, 151643, 151643, 151643, 151643, 151643, 151643, 151643, 151643, 151643, 151643, 151643, 151643, 151643, 151643, 151643, 151643, 151643, 151643, 151643, 151643, 151643, 151643, 151643, 151643, 151643, 151643, 151643, 151643, 151643, 151643, 151643, 151643, 151643, 151643, 151643, 151643, 151643, 151643, 151643, 151643, 151643, 151643, 151643, 151643, 151643, 151643, 151643, 151643, 151643, 151643, 151643, 151643, 151643, 151643, 151643, 151643, 151643, 151643, 151643, 151643, 151643, 151643, 151643, 151643, 151643, 151643, 151643, 151643, 151643, 151643, 151643, 151643, 151643, 151643, 151643, 151643, 151643, 151643, 151643, 151643, 151643, 151643, 151643, 151643, 151643, 151643, 151643, 151643, 151643, 151643, 151643, 151643, 151643, 151643, 151643, 151643, 151643, 151643, 151643, 151643, 151643, 151643, 151643, 151643, 151643, 151643, 151643, 151643, 151643, 151643, 151643, 151643, 151643, 151643, 151643, 151643, 151643, 151643, 151643, 151643, 151643, 151643, 151643, 151643, 151643, 151643, 151643, 151643, 151643, 151643, 151643, 151643, 151643, 151643, 151643, 151643, 151643, 151643, 151643, 151643, 151643, 151643, 151643, 151643, 151643, 151643, 151643, 151643, 151643, 151643, 151643, 151643, 151643, 151643, 151643, 151643, 151643, 151643, 151643, 151643, 151643, 151643, 151643, 151643, 151643, 151643, 151643, 151643, 151643, 151643, 151643, 151643, 151643, 151643, 151643, 151643, 151643, 151643, 151643, 151643, 151643, 151643, 151643, 151643, 151643, 151643, 151643, 151643, 151643, 151643, 151643, 151643, 151643, 151643, 151643, 151643, 151643, 151643, 151643, 151643, 151643, 151643, 151643, 151643, 151643, 151643, 151643, 151643, 151643, 151643, 151643, 151643, 151643, 151644, 8948, 198, 2610, 525, 1207, 16948, 11, 3465, 553, 54364, 14817, 13, 1446, 525, 264, 10950, 17847, 13, 151645, 198, 151644, 872, 198, 16141, 279, 2701, 5248, 5754, 3405, 13, 576, 1537, 1555, 315, 697, 2033, 1265, 387, 315, 279, 2701, 3561, 25, 364, 16141, 25, 400, 20756, 4198, 6, 320, 28996, 17194, 8, 1380, 44428, 374, 825, 315, 19360, 35, 13, 21149, 3019, 553, 3019, 1573, 35764, 382, 641, 458, 31799, 1584, 11, 264, 45840, 8168, 1186, 3843, 70804, 458, 15099, 8286, 504, 279, 38554, 93989, 2302, 42018, 13, 29438, 93989, 2302, 389, 279, 8245, 70683, 304, 279, 1356, 23002, 7947, 11, 432, 294, 3134, 4756, 11, 9311, 83, 642, 1119, 279, 61507, 11, 323, 17045, 304, 14862, 45840, 13, 362, 3116, 1117, 26374, 1599, 304, 279, 1356, 23002, 7947, 374, 264, 46762, 533, 4709, 8668, 33749, 26374, 13, 1446, 22986, 429, 264, 29448, 75423, 70, 782, 26374, 809, 304, 279, 294, 3134, 2022, 7947, 14056, 438, 264, 24456, 60935, 26374, 13, 15920, 315, 279, 2701, 30106, 14018, 21830, 374, 1429, 4363, 13166, 304, 279, 9362, 315, 26374, 809, 1939, 32, 8, 12833, 52468, 323, 4709, 8668, 33749, 315, 279, 8380, 10604, 69410, 198, 33, 8, 2297, 315, 12833, 390, 1627, 323, 8722, 8668, 33749, 81323, 198, 34, 8, 4709, 315, 12833, 294, 3134, 2022, 323, 8380, 10604, 81323, 198, 35, 8, 12833, 51629, 323, 4709, 8668, 33749, 81323, 151645, 198, 151644, 77091, 198]",,236,366,602,0.0,0.0
4d9d0fb7-dbe2-4e29-b9b7-388f2f22facc,7,74,"[151643, 151643, 151643, 151643, 151643, 151643, 151643, 151643, 151643, 151643, 151643, 151643, 151643, 151643, 151643, 151643, 151643, 151643, 151643, 151643, 151643, 151643, 151643, 151643, 151643, 151643, 151643, 151643, 151643, 151643, 151643, 151643, 151643, 151643, 151643, 151643, 151643, 151643, 151643, 151643, 151643, 151643, 151643, 151643, 151643, 151643, 151643, 151643, 151643, 151643, 151643, 151643, 151643, 151643, 151643, 151643, 151643, 151643, 151643, 151643, 151643, 151643, 151643, 151643, 151643, 151643, 151643, 151643, 151643, 151643, 151643, 151643, 151643, 151643, 151643, 151643, 151643, 151643, 151643, 151643, 151643, 151643, 151643, 151643, 151643, 151643, 151643, 151643, 151643, 151643, 151643, 151643, 151643, 151643, 151643, 151643, 151643, 151643, 151643, 151643, 151643, 151643, 151643, 151643, 151643, 151643, 151643, 151643, 151643, 151643, 151643, 151643, 151643, 151643, 151643, 151643, 151643, 151643, 151643, 151643, 151643, 151643, 151643, 151643, 151643, 151643, 151643, 151643, 151643, 151643, 151643, 151643, 151643, 151643, 151643, 151643, 151643, 151643, 151643, 151643, 151643, 151643, 151643, 151643, 151643, 151643, 151643, 151643, 151643, 151643, 151643, 151643, 151643, 151643, 151643, 151643, 151643, 151643, 151643, 151643, 151643, 151643, 151643, 151643, 151643, 151643, 151643, 151643, 151643, 151643, 151643, 151643, 151643, 151643, 151643, 151643, 151643, 151643, 151643, 151643, 151643, 151643, 151643, 151643, 151643, 151643, 151643, 151643, 151643, 151643, 151643, 151643, 151643, 151643, 151643, 151643, 151643, 151643, 151643, 151643, 151643, 151643, 151643, 151643, 151643, 151643, 151643, 151643, 151643, 151643, 151643, 151643, 151643, 151643, 151643, 151643, 151643, 151643, 151643, 151643, 151643, 151643, 151643, 151643, 151643, 151643, 151643, 151643, 151643, 151643, 151643, 151643, 151643, 151643, 151643, 151643, 151643, 151643, 151643, 151643, 151643, 151643, 151643, 151643, 151643, 151643, 151643, 151643, 151643, 151643, 151643, 151643, 151643, 151643, 151643, 151643, 151643, 151643, 151643, 151643, 151643, 151643, 151643, 151643, 151643, 151643, 151643, 151643, 151643, 151643, 151643, 151643, 151643, 151643, 151643, 151643, 151643, 151643, 151643, 151643, 151643, 151643, 151643, 151643, 151643, 151643, 151643, 151643, 151643, 151643, 151643, 151643, 151643, 151643, 151643, 151643, 151643, 151643, 151643, 151643, 151643, 151643, 151643, 151643, 151643, 151643, 151643, 151643, 151643, 151643, 151643, 151643, 151643, 151643, 151643, 151643, 151643, 151643, 151643, 151643, 151643, 151643, 151643, 151643, 151643, 151643, 151643, 151643, 151643, 151643, 151643, 151643, 151643, 151643, 151643, 151643, 151643, 151643, 151643, 151643, 151643, 151643, 151643, 151643, 151643, 151643, 151643, 151643, 151643, 151643, 151643, 151643, 151643, 151643, 151643, 151643, 151643, 151643, 151643, 151643, 151643, 151643, 151643, 151643, 151643, 151643, 151643, 151643, 151643, 151643, 151643, 151643, 151643, 151643, 151643, 151643, 151643, 151643, 151643, 151643, 151643, 151643, 151643, 151643, 151643, 151643, 151643, 151643, 151643, 151643, 151643, 151643, 151643, 151643, 151643, 151643, 151643, 151643, 151643, 151643, 151643, 151643, 151643, 151643, 151643, 151643, 151643, 151643, 151643, 151643, 151643, 151643, 151643, 151643, 151643, 151643, 151643, 151643, 151643, 151643, 151643, 151643, 151643, 151643, 151643, 151643, 151643, 151643, 151643, 151643, 151643, 151643, 151643, 151643, 151643, 151643, 151643, 151643, 151643, 151643, 151643, 151643, 151643, 151643, 151643, 151643, 151643, 151643, 151643, 151643, 151643, 151643, 151643, 151643, 151643, 151643, 151643, 151643, 151643, 151643, 151643, 151643, 151643, 151643, 151643, 151643, 151643, 151643, 151643, 151643, 151643, 151643, 151643, 151643, 151643, 151643, 151643, 151643, 151643, 151643, 151643, 151643, 151643, 151643, 151643, 151643, 151643, 151643, 151643, 151643, 151643, 151643, 151643, 151643, 151643, 151643, 151643, 151643, 151643, 151643, 151643, 151643, 151643, 151643, 151643, 151643, 151643, 151643, 151643, 151643, 151643, 151643, 151643, 151643, 151643, 151643, 151643, 151643, 151643, 151643, 151643, 151643, 151643, 151643, 151643, 151643, 151643, 151643, 151643, 151643, 151643, 151643, 151643, 151643, 151643, 151643, 151643, 151643, 151643, 151643, 151643, 151643, 151643, 151643, 151643, 151643, 151643, 151643, 151643, 151643, 151643, 151643, 151643, 151643, 151643, 151643, 151643, 151643, 151643, 151643, 151643, 151643, 151643, 151643, 151643, 151643, 151643, 151643, 151643, 151643, 151643, 151643, 151643, 151643, 151643, 151643, 151643, 151643, 151643, 151643, 151643, 151643, 151643, 151643, 151643, 151643, 151643, 151643, 151643, 151643, 151643, 151643, 151643, 151643, 151643, 151643, 151643, 151643, 151643, 151643, 151643, 151643, 151643, 151643, 151643, 151643, 151643, 151643, 151643, 151643, 151643, 151643, 151643, 151643, 151643, 151643, 151643, 151643, 151643, 151643, 151643, 151643, 151643, 151643, 151643, 151643, 151643, 151643, 151643, 151643, 151643, 151643, 151643, 151643, 151643, 151644, 8948, 198, 2610, 525, 1207, 16948, 11, 3465, 553, 54364, 14817, 13, 1446, 525, 264, 10950, 17847, 13, 151645, 198, 151644, 872, 198, 16141, 279, 2701, 5248, 5754, 3405, 13, 576, 1537, 1555, 315, 697, 2033, 1265, 387, 315, 279, 2701, 3561, 25, 364, 16141, 25, 400, 20756, 4198, 6, 320, 28996, 17194, 8, 1380, 44428, 374, 825, 315, 19360, 35, 13, 21149, 3019, 553, 3019, 1573, 35764, 382, 675, 24473, 304, 29803, 8300, 311, 264, 3151, 738, 315, 1632, 21309, 11483, 24473, 429, 525, 11136, 6941, 1283, 862, 6997, 388, 476, 279, 13923, 879, 1865, 5089, 19026, 311, 862, 4401, 13, 4220, 24473, 614, 1030, 264, 27155, 5421, 389, 279, 2070, 315, 29803, 323, 525, 3545, 1483, 438, 15811, 4752, 10010, 304, 5257, 11483, 6782, 38322, 624, 28301, 1437, 279, 13767, 1783, 369, 279, 2701, 829, 24473, 624, 32, 488, 472, 17, 13880, 19, 69726, 220, 17, 11, 23, 1737, 318, 41872, 2154, 8698, 58, 19, 13, 20, 60, 450, 4814, 12, 21, 18589, 198, 33, 488, 27227, 45421, 488, 472, 10, 69726, 220, 19, 1448, 41872, 12, 16, 12, 14769, 3923, 45125, 12, 18, 20767, 12, 16, 12, 337, 271, 32, 8, 362, 284, 220, 17, 11, 22, 1737, 318, 769, 88, 385, 302, 1466, 40121, 2248, 1342, 30292, 1952, 12, 19, 64, 11, 23, 64, 1737, 24903, 11, 425, 284, 11600, 18, 1448, 41872, 8088, 12, 17, 20767, 12, 16, 12, 3923, 8, 60163, 46607, 41872, 8, 7964, 89, 1952, 198, 33, 8, 362, 284, 220, 17, 11, 23, 1737, 318, 41872, 2154, 8698, 58, 19, 13, 20, 60, 450, 4814, 12, 21, 12, 337, 11, 425, 284, 220, 19, 1448, 41872, 12, 16, 12, 14769, 3923, 45125, 12, 18, 20767, 12, 16, 18589, 198, 34, 8, 362, 284, 220, 17, 11, 23, 1737, 318, 41872, 2154, 8698, 58, 19, 13, 20, 60, 450, 4814, 12, 21, 12, 337, 11, 425, 284, 11600, 18, 1448, 41872, 8088, 12, 17, 20767, 12, 16, 12, 3923, 8, 60163, 46607, 41872, 8, 7964, 89, 1952, 198, 35, 8, 362, 284, 220, 17, 11, 22, 1737, 318, 769, 88, 385, 302, 1466, 40121, 2248, 1342, 30292, 1952, 12, 19, 64, 11, 23, 64, 1737, 24903, 11, 425, 284, 220, 19, 1448, 41872, 12, 16, 12, 14769, 3923, 45125, 12, 18, 20767, 12, 16, 18589, 151645, 198, 151644, 77091, 198]",,389,302,691,0.0,0.0
74e663ec-6a95-4155-8515-fc048494a494,7,75,"[151643, 151643, 151643, 151643, 151643, 151643, 151643, 151643, 151643, 151643, 151643, 151643, 151643, 151643, 151643, 151643, 151643, 151643, 151643, 151643, 151643, 151643, 151643, 151643, 151643, 151643, 151643, 151643, 151643, 151643, 151643, 151643, 151643, 151643, 151643, 151643, 151643, 151643, 151643, 151643, 151643, 151643, 151643, 151643, 151643, 151643, 151643, 151643, 151643, 151643, 151643, 151643, 151643, 151643, 151643, 151643, 151643, 151643, 151643, 151643, 151643, 151643, 151643, 151643, 151643, 151643, 151643, 151643, 151643, 151643, 151643, 151643, 151643, 151643, 151643, 151643, 151643, 151643, 151643, 151643, 151643, 151643, 151643, 151643, 151643, 151643, 151643, 151643, 151643, 151643, 151643, 151643, 151643, 151643, 151643, 151643, 151643, 151643, 151643, 151643, 151643, 151643, 151643, 151643, 151643, 151643, 151643, 151643, 151643, 151643, 151643, 151643, 151643, 151643, 151643, 151643, 151643, 151643, 151643, 151643, 151643, 151643, 151643, 151643, 151643, 151643, 151643, 151643, 151643, 151643, 151643, 151643, 151643, 151643, 151643, 151643, 151643, 151643, 151643, 151643, 151643, 151643, 151643, 151643, 151643, 151643, 151643, 151643, 151643, 151643, 151643, 151643, 151643, 151643, 151643, 151643, 151643, 151643, 151643, 151643, 151643, 151643, 151643, 151643, 151643, 151643, 151643, 151643, 151643, 151643, 151643, 151643, 151643, 151643, 151643, 151643, 151643, 151643, 151643, 151643, 151643, 151643, 151643, 151643, 151643, 151643, 151643, 151643, 151643, 151643, 151643, 151643, 151643, 151643, 151643, 151643, 151643, 151643, 151643, 151643, 151643, 151643, 151643, 151643, 151643, 151643, 151643, 151643, 151643, 151643, 151643, 151643, 151643, 151643, 151643, 151643, 151643, 151643, 151643, 151643, 151643, 151643, 151643, 151643, 151643, 151643, 151643, 151643, 151643, 151643, 151643, 151643, 151643, 151643, 151643, 151643, 151643, 151643, 151643, 151643, 151643, 151643, 151643, 151643, 151643, 151643, 151643, 151643, 151643, 151643, 151643, 151643, 151643, 151643, 151643, 151643, 151643, 151643, 151643, 151643, 151643, 151643, 151643, 151643, 151643, 151643, 151643, 151643, 151643, 151643, 151643, 151643, 151643, 151643, 151643, 151643, 151643, 151643, 151643, 151643, 151643, 151643, 151643, 151643, 151643, 151643, 151643, 151643, 151643, 151643, 151643, 151643, 151643, 151643, 151643, 151643, 151643, 151643, 151643, 151643, 151643, 151643, 151643, 151643, 151643, 151643, 151643, 151643, 151643, 151643, 151643, 151643, 151643, 151643, 151643, 151643, 151643, 151643, 151643, 151643, 151643, 151643, 151643, 151643, 151643, 151643, 151643, 151643, 151643, 151643, 151643, 151643, 151643, 151643, 151643, 151643, 151643, 151643, 151643, 151643, 151643, 151643, 151643, 151643, 151643, 151643, 151643, 151643, 151643, 151643, 151643, 151643, 151643, 151643, 151643, 151643, 151643, 151643, 151643, 151643, 151643, 151643, 151643, 151643, 151643, 151643, 151643, 151643, 151643, 151643, 151643, 151643, 151643, 151643, 151643, 151643, 151643, 151643, 151643, 151643, 151643, 151643, 151643, 151643, 151643, 151643, 151643, 151643, 151643, 151643, 151643, 151643, 151643, 151643, 151643, 151643, 151643, 151643, 151643, 151643, 151643, 151643, 151643, 151643, 151643, 151643, 151643, 151643, 151643, 151643, 151643, 151643, 151643, 151643, 151643, 151643, 151643, 151643, 151643, 151643, 151643, 151643, 151643, 151643, 151643, 151643, 151643, 151643, 151643, 151643, 151643, 151643, 151643, 151643, 151643, 151643, 151643, 151643, 151643, 151643, 151643, 151643, 151643, 151643, 151643, 151643, 151643, 151643, 151643, 151643, 151643, 151643, 151643, 151643, 151643, 151643, 151643, 151643, 151643, 151643, 151643, 151643, 151643, 151643, 151643, 151643, 151643, 151643, 151643, 151643, 151643, 151643, 151643, 151643, 151643, 151643, 151643, 151643, 151643, 151643, 151643, 151643, 151643, 151643, 151643, 151643, 151643, 151643, 151643, 151643, 151643, 151643, 151643, 151643, 151643, 151643, 151643, 151643, 151643, 151643, 151643, 151643, 151643, 151643, 151643, 151643, 151643, 151643, 151643, 151643, 151643, 151643, 151643, 151643, 151643, 151643, 151643, 151643, 151643, 151643, 151643, 151643, 151643, 151643, 151643, 151643, 151643, 151643, 151643, 151643, 151643, 151643, 151643, 151643, 151643, 151643, 151643, 151643, 151643, 151643, 151643, 151643, 151643, 151643, 151643, 151643, 151643, 151643, 151643, 151643, 151643, 151643, 151643, 151643, 151643, 151643, 151643, 151643, 151643, 151643, 151643, 151643, 151643, 151643, 151643, 151643, 151643, 151643, 151643, 151643, 151643, 151643, 151643, 151643, 151643, 151643, 151643, 151643, 151643, 151643, 151643, 151643, 151643, 151643, 151643, 151643, 151643, 151643, 151643, 151643, 151643, 151643, 151643, 151643, 151643, 151643, 151643, 151643, 151643, 151643, 151643, 151643, 151643, 151643, 151643, 151643, 151643, 151643, 151643, 151643, 151643, 151643, 151643, 151643, 151643, 151643, 151643, 151643, 151643, 151643, 151643, 151643, 151643, 151643, 151643, 151643, 151643, 151643, 151643, 151643, 151643, 151643, 151643, 151643, 151643, 151643, 151643, 151643, 151643, 151643, 151643, 151643, 151643, 151643, 151643, 151643, 151643, 151643, 151643, 151643, 151643, 151643, 151643, 151643, 151643, 151643, 151643, 151643, 151643, 151643, 151643, 151643, 151643, 151643, 151643, 151643, 151643, 151643, 151643, 151643, 151643, 151643, 151643, 151643, 151643, 151643, 151643, 151643, 151643, 151643, 151643, 151643, 151643, 151643, 151643, 151643, 151643, 151643, 151643, 151643, 151643, 151643, 151643, 151643, 151643, 151643, 151643, 151643, 151643, 151643, 151643, 151643, 151643, 151643, 151643, 151643, 151643, 151643, 151643, 151643, 151643, 151643, 151643, 151643, 151643, 151643, 151643, 151643, 151643, 151643, 151643, 151643, 151643, 151643, 151643, 151643, 151643, 151643, 151643, 151643, 151643, 151643, 151643, 151643, 151643, 151643, 151643, 151643, 151643, 151643, 151643, 151643, 151643, 151643, 151643, 151643, 151643, 151643, 151643, 151643, 151643, 151643, 151643, 151643, 151643, 151643, 151643, 151643, 151643, 151643, 151643, 151643, 151643, 151643, 151643, 151643, 151643, 151643, 151643, 151643, 151643, 151643, 151643, 151643, 151643, 151643, 151643, 151643, 151643, 151643, 151643, 151643, 151643, 151643, 151643, 151643, 151643, 151643, 151643, 151643, 151643, 151643, 151643, 151643, 151643, 151643, 151643, 151643, 151643, 151643, 151643, 151643, 151643, 151643, 151643, 151643, 151643, 151643, 151643, 151643, 151643, 151643, 151643, 151643, 151643, 151643, 151643, 151643, 151643, 151643, 151643, 151643, 151643, 151643, 151643, 151643, 151643, 151643, 151643, 151643, 151643, 151643, 151643, 151643, 151643, 151643, 151643, 151643, 151643, 151643, 151643, 151643, 151643, 151643, 151643, 151643, 151643, 151643, 151643, 151643, 151643, 151643, 151643, 151643, 151643, 151643, 151643, 151643, 151643, 151643, 151643, 151643, 151643, 151643, 151643, 151643, 151643, 151643, 151643, 151643, 151643, 151643, 151643, 151643, 151644, 8948, 198, 2610, 525, 1207, 16948, 11, 3465, 553, 54364, 14817, 13, 1446, 525, 264, 10950, 17847, 13, 151645, 198, 151644, 872, 198, 16141, 279, 2701, 5248, 5754, 3405, 13, 576, 1537, 1555, 315, 697, 2033, 1265, 387, 315, 279, 2701, 3561, 25, 364, 16141, 25, 400, 20756, 4198, 6, 320, 28996, 17194, 8, 1380, 44428, 374, 825, 315, 19360, 35, 13, 21149, 3019, 553, 3019, 1573, 35764, 382, 23085, 315, 279, 2701, 7886, 4059, 4019, 1969, 387, 30287, 553, 678, 19624, 304, 279, 78767, 3994, 1939, 16, 13, 53233, 406, 89, 11375, 32242, 198, 17, 13, 393, 1961, 10506, 45120, 198, 18, 13, 15284, 45120, 198, 19, 13, 356, 2828, 45120, 271, 32, 8, 220, 16, 11, 18, 11, 19, 198, 33, 8, 220, 16, 11, 17, 198, 34, 8, 220, 18, 11, 19, 198, 35, 8, 220, 16, 11, 17, 11, 19, 151645, 198, 151644, 77091, 198]",,150,330,480,1.0,1.0
80f9257a-9ce9-4d5f-99ea-b9e991baea7c,7,76,"[151643, 151643, 151643, 151643, 151643, 151643, 151643, 151643, 151643, 151643, 151643, 151643, 151643, 151643, 151643, 151643, 151643, 151643, 151643, 151643, 151643, 151643, 151643, 151643, 151643, 151643, 151643, 151643, 151643, 151643, 151643, 151643, 151643, 151643, 151643, 151643, 151643, 151643, 151643, 151643, 151643, 151643, 151643, 151643, 151643, 151643, 151643, 151643, 151643, 151643, 151643, 151643, 151643, 151643, 151643, 151643, 151643, 151643, 151643, 151643, 151643, 151643, 151643, 151643, 151643, 151643, 151643, 151643, 151643, 151643, 151643, 151643, 151643, 151643, 151643, 151643, 151643, 151643, 151643, 151643, 151643, 151643, 151643, 151643, 151643, 151643, 151643, 151643, 151643, 151643, 151643, 151643, 151643, 151643, 151643, 151643, 151643, 151643, 151643, 151643, 151643, 151643, 151643, 151643, 151643, 151643, 151643, 151643, 151643, 151643, 151643, 151643, 151643, 151643, 151643, 151643, 151643, 151643, 151643, 151643, 151643, 151643, 151643, 151643, 151643, 151643, 151643, 151643, 151643, 151643, 151643, 151643, 151643, 151643, 151643, 151643, 151643, 151643, 151643, 151643, 151643, 151643, 151643, 151643, 151643, 151643, 151643, 151643, 151643, 151643, 151643, 151643, 151643, 151643, 151643, 151643, 151643, 151643, 151643, 151643, 151643, 151643, 151643, 151643, 151643, 151643, 151643, 151643, 151643, 151643, 151643, 151643, 151643, 151643, 151643, 151643, 151643, 151643, 151643, 151643, 151643, 151643, 151643, 151643, 151643, 151643, 151643, 151643, 151643, 151643, 151643, 151643, 151643, 151643, 151643, 151643, 151643, 151643, 151643, 151643, 151643, 151643, 151643, 151643, 151643, 151643, 151643, 151643, 151643, 151643, 151643, 151643, 151643, 151643, 151643, 151643, 151643, 151643, 151643, 151643, 151643, 151643, 151643, 151643, 151643, 151643, 151643, 151643, 151643, 151643, 151643, 151643, 151643, 151643, 151643, 151643, 151643, 151643, 151643, 151643, 151643, 151643, 151643, 151643, 151643, 151643, 151643, 151643, 151643, 151643, 151643, 151643, 151643, 151643, 151643, 151643, 151643, 151643, 151643, 151643, 151643, 151643, 151643, 151643, 151643, 151643, 151643, 151643, 151643, 151643, 151643, 151643, 151643, 151643, 151643, 151643, 151643, 151643, 151643, 151643, 151643, 151643, 151643, 151643, 151643, 151643, 151643, 151643, 151643, 151643, 151643, 151643, 151643, 151643, 151643, 151643, 151643, 151643, 151643, 151643, 151643, 151643, 151643, 151643, 151643, 151643, 151643, 151643, 151643, 151643, 151643, 151643, 151643, 151643, 151643, 151643, 151643, 151643, 151643, 151643, 151643, 151643, 151643, 151643, 151643, 151643, 151643, 151643, 151643, 151643, 151643, 151643, 151643, 151643, 151643, 151643, 151643, 151643, 151643, 151643, 151643, 151643, 151643, 151643, 151643, 151643, 151643, 151643, 151643, 151643, 151643, 151643, 151643, 151643, 151643, 151643, 151643, 151643, 151643, 151643, 151643, 151643, 151643, 151643, 151643, 151643, 151643, 151643, 151643, 151643, 151643, 151643, 151643, 151643, 151643, 151643, 151643, 151643, 151643, 151643, 151643, 151643, 151643, 151643, 151643, 151643, 151643, 151643, 151643, 151643, 151643, 151643, 151643, 151643, 151643, 151643, 151643, 151643, 151643, 151643, 151643, 151643, 151643, 151643, 151643, 151643, 151643, 151643, 151643, 151643, 151643, 151643, 151643, 151643, 151643, 151643, 151643, 151643, 151643, 151643, 151643, 151643, 151643, 151643, 151643, 151643, 151643, 151643, 151643, 151643, 151643, 151643, 151643, 151643, 151643, 151643, 151643, 151643, 151643, 151643, 151643, 151643, 151643, 151643, 151643, 151643, 151643, 151643, 151643, 151643, 151643, 151643, 151643, 151643, 151643, 151643, 151643, 151643, 151643, 151643, 151643, 151643, 151643, 151643, 151643, 151643, 151643, 151643, 151643, 151643, 151643, 151643, 151643, 151643, 151643, 151643, 151643, 151643, 151643, 151643, 151643, 151643, 151643, 151643, 151643, 151643, 151643, 151643, 151643, 151643, 151643, 151643, 151643, 151643, 151643, 151643, 151643, 151643, 151643, 151643, 151643, 151643, 151643, 151643, 151643, 151643, 151643, 151643, 151643, 151643, 151643, 151643, 151643, 151643, 151643, 151643, 151643, 151643, 151643, 151643, 151643, 151643, 151643, 151643, 151643, 151643, 151643, 151643, 151643, 151643, 151643, 151643, 151643, 151643, 151643, 151643, 151643, 151643, 151643, 151643, 151643, 151643, 151643, 151643, 151643, 151643, 151643, 151643, 151643, 151643, 151643, 151643, 151643, 151643, 151643, 151643, 151643, 151643, 151643, 151643, 151643, 151643, 151643, 151643, 151643, 151643, 151643, 151643, 151643, 151643, 151643, 151643, 151643, 151643, 151643, 151643, 151643, 151643, 151643, 151643, 151643, 151643, 151643, 151643, 151643, 151643, 151643, 151643, 151643, 151643, 151643, 151643, 151643, 151643, 151643, 151643, 151643, 151643, 151643, 151643, 151643, 151643, 151643, 151643, 151643, 151643, 151643, 151643, 151643, 151643, 151643, 151643, 151643, 151643, 151643, 151643, 151643, 151643, 151643, 151643, 151643, 151643, 151643, 151643, 151643, 151643, 151643, 151643, 151643, 151643, 151643, 151643, 151643, 151643, 151643, 151643, 151643, 151643, 151643, 151643, 151643, 151643, 151643, 151643, 151643, 151643, 151643, 151643, 151643, 151643, 151643, 151643, 151643, 151643, 151643, 151643, 151643, 151643, 151643, 151643, 151643, 151643, 151643, 151643, 151643, 151643, 151643, 151643, 151643, 151643, 151643, 151643, 151643, 151643, 151643, 151643, 151643, 151643, 151643, 151643, 151643, 151643, 151643, 151643, 151643, 151643, 151643, 151643, 151643, 151643, 151643, 151643, 151643, 151643, 151643, 151643, 151643, 151643, 151643, 151643, 151643, 151643, 151643, 151643, 151643, 151643, 151643, 151643, 151643, 151643, 151643, 151643, 151643, 151643, 151643, 151643, 151643, 151643, 151643, 151643, 151643, 151643, 151643, 151643, 151643, 151643, 151643, 151643, 151643, 151643, 151643, 151643, 151643, 151643, 151643, 151643, 151643, 151643, 151643, 151643, 151643, 151643, 151643, 151643, 151643, 151643, 151643, 151643, 151643, 151643, 151643, 151643, 151643, 151643, 151643, 151643, 151643, 151643, 151643, 151643, 151643, 151643, 151643, 151643, 151643, 151643, 151643, 151643, 151643, 151643, 151643, 151643, 151643, 151643, 151643, 151643, 151643, 151643, 151643, 151643, 151643, 151643, 151643, 151643, 151643, 151643, 151643, 151643, 151643, 151643, 151643, 151643, 151643, 151643, 151643, 151643, 151643, 151643, 151643, 151643, 151643, 151643, 151643, 151643, 151643, 151643, 151643, 151643, 151643, 151643, 151643, 151643, 151643, 151643, 151643, 151643, 151643, 151643, 151643, 151643, 151643, 151643, 151643, 151643, 151643, 151643, 151643, 151643, 151643, 151643, 151643, 151643, 151643, 151643, 151643, 151643, 151643, 151643, 151643, 151643, 151643, 151643, 151643, 151643, 151643, 151643, 151643, 151643, 151643, 151643, 151643, 151643, 151643, 151643, 151643, 151644, 8948, 198, 2610, 525, 1207, 16948, 11, 3465, 553, 54364, 14817, 13, 1446, 525, 264, 10950, 17847, 13, 151645, 198, 151644, 872, 198, 16141, 279, 2701, 5248, 5754, 3405, 13, 576, 1537, 1555, 315, 697, 2033, 1265, 387, 315, 279, 2701, 3561, 25, 364, 16141, 25, 400, 20756, 4198, 6, 320, 28996, 17194, 8, 1380, 44428, 374, 825, 315, 19360, 35, 13, 21149, 3019, 553, 3019, 1573, 35764, 382, 23085, 315, 279, 2701, 34615, 374, 14122, 979, 220, 20, 1455, 20237, 2261, 6721, 12, 17, 11, 21, 1737, 42568, 374, 31713, 1939, 32, 8, 220, 20, 12, 41872, 12, 19, 1448, 41872, 450, 924, 12, 17, 11, 21, 1737, 42568, 198, 33, 8, 220, 19, 12, 41872, 12, 18, 1448, 41872, 450, 924, 12, 16, 11, 20, 1737, 42568, 198, 34, 8, 220, 20, 12, 41872, 1241, 22794, 12, 17, 11, 21, 1737, 42568, 198, 35, 8, 220, 20, 12, 41872, 12, 19, 1448, 41872, 450, 924, 12, 17, 11, 21, 1737, 42568, 151645, 198, 151644, 77091, 198]",,169,419,588,0.0,0.0
42eca91c-4edd-4a65-8655-cafe960cac54,7,77,"[151643, 151643, 151643, 151643, 151643, 151643, 151643, 151643, 151643, 151643, 151643, 151643, 151643, 151643, 151643, 151643, 151643, 151643, 151643, 151643, 151643, 151643, 151643, 151643, 151643, 151643, 151643, 151643, 151643, 151643, 151643, 151643, 151643, 151643, 151643, 151643, 151643, 151643, 151643, 151643, 151643, 151643, 151643, 151643, 151643, 151643, 151643, 151643, 151643, 151643, 151643, 151643, 151643, 151643, 151643, 151643, 151643, 151643, 151643, 151643, 151643, 151643, 151643, 151643, 151643, 151643, 151643, 151643, 151643, 151643, 151643, 151643, 151643, 151643, 151643, 151643, 151643, 151643, 151643, 151643, 151643, 151643, 151643, 151643, 151643, 151643, 151643, 151643, 151643, 151643, 151643, 151643, 151643, 151643, 151643, 151643, 151643, 151643, 151643, 151643, 151643, 151643, 151643, 151643, 151643, 151643, 151643, 151643, 151643, 151643, 151643, 151643, 151643, 151643, 151643, 151643, 151643, 151643, 151643, 151643, 151643, 151643, 151643, 151643, 151643, 151643, 151643, 151643, 151643, 151643, 151643, 151643, 151643, 151643, 151643, 151643, 151643, 151643, 151643, 151643, 151643, 151643, 151643, 151643, 151643, 151643, 151643, 151643, 151643, 151643, 151643, 151643, 151643, 151643, 151643, 151643, 151643, 151643, 151643, 151643, 151643, 151643, 151643, 151643, 151643, 151643, 151643, 151643, 151643, 151643, 151643, 151643, 151643, 151643, 151643, 151643, 151643, 151643, 151643, 151643, 151643, 151643, 151643, 151643, 151643, 151643, 151643, 151643, 151643, 151643, 151643, 151643, 151643, 151643, 151643, 151643, 151643, 151643, 151643, 151643, 151643, 151643, 151643, 151643, 151643, 151643, 151643, 151643, 151643, 151643, 151643, 151643, 151643, 151643, 151643, 151643, 151643, 151643, 151643, 151643, 151643, 151643, 151643, 151643, 151643, 151643, 151643, 151643, 151643, 151643, 151643, 151643, 151643, 151643, 151643, 151643, 151643, 151643, 151643, 151643, 151643, 151643, 151643, 151643, 151643, 151643, 151643, 151643, 151643, 151643, 151643, 151643, 151643, 151643, 151643, 151643, 151643, 151643, 151643, 151643, 151643, 151643, 151643, 151643, 151643, 151643, 151643, 151643, 151643, 151643, 151643, 151643, 151643, 151643, 151643, 151643, 151643, 151643, 151643, 151643, 151643, 151643, 151643, 151643, 151643, 151643, 151643, 151643, 151643, 151643, 151643, 151643, 151643, 151643, 151643, 151643, 151643, 151643, 151643, 151643, 151643, 151643, 151643, 151643, 151643, 151643, 151643, 151643, 151643, 151643, 151643, 151643, 151643, 151643, 151643, 151643, 151643, 151643, 151643, 151643, 151643, 151643, 151643, 151643, 151643, 151643, 151643, 151643, 151643, 151643, 151643, 151643, 151643, 151643, 151643, 151643, 151643, 151643, 151643, 151643, 151643, 151643, 151643, 151643, 151643, 151643, 151643, 151643, 151643, 151643, 151643, 151643, 151643, 151643, 151643, 151643, 151643, 151643, 151643, 151643, 151643, 151643, 151643, 151643, 151643, 151643, 151643, 151643, 151643, 151643, 151643, 151643, 151643, 151643, 151643, 151643, 151643, 151643, 151643, 151643, 151643, 151643, 151643, 151643, 151643, 151643, 151643, 151643, 151643, 151643, 151643, 151643, 151643, 151643, 151643, 151643, 151643, 151643, 151643, 151643, 151643, 151643, 151643, 151643, 151643, 151643, 151643, 151643, 151643, 151643, 151643, 151643, 151643, 151643, 151643, 151643, 151643, 151643, 151643, 151643, 151643, 151643, 151643, 151643, 151643, 151643, 151643, 151643, 151643, 151643, 151643, 151643, 151643, 151643, 151643, 151643, 151643, 151643, 151643, 151643, 151643, 151643, 151643, 151643, 151643, 151643, 151643, 151643, 151643, 151643, 151643, 151643, 151643, 151643, 151643, 151643, 151643, 151643, 151643, 151643, 151643, 151643, 151643, 151643, 151643, 151643, 151643, 151643, 151643, 151643, 151643, 151643, 151643, 151643, 151643, 151643, 151643, 151643, 151643, 151643, 151643, 151643, 151643, 151643, 151643, 151643, 151643, 151643, 151643, 151643, 151643, 151643, 151643, 151643, 151643, 151643, 151643, 151643, 151643, 151643, 151643, 151643, 151643, 151643, 151643, 151643, 151643, 151643, 151643, 151643, 151643, 151643, 151643, 151643, 151643, 151643, 151643, 151643, 151643, 151643, 151643, 151643, 151643, 151643, 151643, 151643, 151643, 151643, 151643, 151643, 151643, 151643, 151643, 151643, 151643, 151643, 151643, 151643, 151643, 151643, 151643, 151643, 151643, 151643, 151643, 151643, 151643, 151643, 151643, 151643, 151643, 151643, 151643, 151643, 151643, 151643, 151643, 151643, 151643, 151643, 151643, 151643, 151643, 151643, 151643, 151643, 151643, 151643, 151643, 151643, 151643, 151643, 151643, 151643, 151643, 151643, 151643, 151643, 151643, 151643, 151643, 151643, 151643, 151643, 151643, 151643, 151643, 151643, 151643, 151643, 151643, 151643, 151643, 151643, 151643, 151643, 151643, 151643, 151643, 151643, 151643, 151643, 151643, 151643, 151643, 151643, 151643, 151643, 151643, 151643, 151643, 151643, 151643, 151643, 151643, 151643, 151643, 151643, 151643, 151643, 151643, 151643, 151643, 151643, 151643, 151643, 151643, 151643, 151643, 151643, 151643, 151643, 151643, 151643, 151643, 151643, 151643, 151643, 151643, 151643, 151643, 151643, 151643, 151643, 151643, 151643, 151643, 151643, 151643, 151643, 151643, 151643, 151643, 151643, 151643, 151643, 151643, 151643, 151643, 151643, 151643, 151643, 151643, 151643, 151643, 151643, 151643, 151643, 151643, 151643, 151643, 151643, 151643, 151643, 151643, 151643, 151643, 151643, 151643, 151643, 151643, 151643, 151643, 151643, 151643, 151643, 151643, 151643, 151643, 151643, 151643, 151643, 151643, 151643, 151643, 151643, 151643, 151643, 151643, 151643, 151643, 151643, 151643, 151643, 151643, 151643, 151643, 151643, 151643, 151643, 151643, 151643, 151643, 151643, 151643, 151643, 151643, 151643, 151643, 151643, 151643, 151643, 151643, 151643, 151643, 151643, 151643, 151643, 151643, 151643, 151643, 151643, 151643, 151643, 151643, 151643, 151643, 151643, 151643, 151643, 151643, 151643, 151643, 151643, 151643, 151644, 8948, 198, 2610, 525, 1207, 16948, 11, 3465, 553, 54364, 14817, 13, 1446, 525, 264, 10950, 17847, 13, 151645, 198, 151644, 872, 198, 16141, 279, 2701, 5248, 5754, 3405, 13, 576, 1537, 1555, 315, 697, 2033, 1265, 387, 315, 279, 2701, 3561, 25, 364, 16141, 25, 400, 20756, 4198, 6, 320, 28996, 17194, 8, 1380, 44428, 374, 825, 315, 19360, 35, 13, 21149, 3019, 553, 3019, 1573, 35764, 382, 28301, 1437, 279, 4396, 8500, 315, 312, 54875, 311, 6782, 26887, 220, 16, 8013, 66, 3337, 385, 17308, 3923, 3203, 67007, 4130, 46607, 41872, 46986, 3337, 385, 17308, 276, 757, 277, 13313, 85736, 504, 8372, 1872, 3923, 66, 3337, 385, 17308, 2145, 382, 32, 8, 220, 16, 13, 32178, 39, 17, 11, 78474, 81782, 198, 17, 13, 472, 17, 16341, 67, 198, 18, 13, 14322, 19238, 39, 8, 17, 198, 18, 13, 472, 17, 13880, 19, 11, 472, 70, 13880, 19, 11, 472, 17, 46, 198, 33, 8, 220, 16, 13, 32178, 39, 17, 11, 8372, 3923, 81782, 198, 17, 13, 14511, 88381, 80, 13, 34831, 18, 198, 18, 13, 506, 18, 14, 472, 17, 46, 198, 19, 13, 34831, 19, 46761, 198, 34, 8, 220, 16, 13, 32178, 39, 17, 11, 78474, 81782, 198, 17, 13, 472, 17, 16341, 67, 1786, 16927, 2356, 83343, 198, 18, 13, 506, 18, 14, 320, 2149, 18, 8, 17, 50, 198, 19, 13, 14322, 19238, 39, 8, 17, 198, 35, 8, 220, 16, 13, 32178, 39, 17, 11, 21068, 38610, 198, 17, 13, 14511, 88381, 80, 13, 34831, 18, 198, 18, 13, 506, 18, 14, 320, 2149, 18, 8, 17, 50, 198, 19, 13, 34831, 19, 46761, 151645, 198, 151644, 77091, 198]",,279,427,706,0.0,0.0
b497cae1-fffd-421a-b756-4641c056bb0e,7,78,"[151643, 151643, 151643, 151643, 151643, 151643, 151643, 151643, 151643, 151643, 151643, 151643, 151643, 151643, 151643, 151643, 151643, 151643, 151643, 151643, 151643, 151643, 151643, 151643, 151643, 151643, 151643, 151643, 151643, 151643, 151643, 151643, 151643, 151643, 151643, 151643, 151643, 151643, 151643, 151643, 151643, 151643, 151643, 151643, 151643, 151643, 151643, 151643, 151643, 151643, 151643, 151643, 151643, 151643, 151643, 151643, 151643, 151643, 151643, 151643, 151643, 151643, 151643, 151643, 151643, 151643, 151643, 151643, 151643, 151643, 151643, 151643, 151643, 151643, 151643, 151643, 151643, 151643, 151643, 151643, 151643, 151643, 151643, 151643, 151643, 151643, 151643, 151643, 151643, 151643, 151643, 151643, 151643, 151643, 151643, 151643, 151643, 151643, 151643, 151643, 151643, 151643, 151643, 151643, 151643, 151643, 151643, 151643, 151643, 151643, 151643, 151643, 151643, 151643, 151643, 151643, 151643, 151643, 151643, 151643, 151643, 151643, 151643, 151643, 151643, 151643, 151643, 151643, 151643, 151643, 151643, 151643, 151643, 151643, 151643, 151643, 151643, 151643, 151643, 151643, 151643, 151643, 151643, 151643, 151643, 151643, 151643, 151643, 151643, 151643, 151643, 151643, 151643, 151643, 151643, 151643, 151643, 151643, 151643, 151643, 151643, 151643, 151643, 151643, 151643, 151643, 151643, 151643, 151643, 151643, 151643, 151643, 151643, 151643, 151643, 151643, 151643, 151643, 151643, 151643, 151643, 151643, 151643, 151643, 151643, 151643, 151643, 151643, 151643, 151643, 151643, 151643, 151643, 151643, 151643, 151643, 151643, 151643, 151643, 151643, 151643, 151643, 151643, 151643, 151643, 151643, 151643, 151643, 151643, 151643, 151643, 151643, 151643, 151643, 151643, 151643, 151643, 151643, 151643, 151643, 151643, 151643, 151643, 151643, 151643, 151643, 151643, 151643, 151643, 151643, 151643, 151643, 151643, 151643, 151643, 151643, 151643, 151643, 151643, 151643, 151643, 151643, 151643, 151643, 151643, 151643, 151643, 151643, 151643, 151643, 151643, 151643, 151643, 151643, 151643, 151643, 151643, 151643, 151643, 151643, 151643, 151643, 151643, 151643, 151643, 151643, 151643, 151643, 151643, 151643, 151643, 151643, 151643, 151643, 151643, 151643, 151643, 151643, 151643, 151643, 151643, 151643, 151643, 151643, 151643, 151643, 151643, 151643, 151643, 151643, 151643, 151643, 151643, 151643, 151643, 151643, 151643, 151643, 151643, 151643, 151643, 151643, 151643, 151643, 151643, 151643, 151643, 151643, 151643, 151643, 151643, 151643, 151643, 151643, 151643, 151643, 151643, 151643, 151643, 151643, 151643, 151643, 151643, 151643, 151643, 151643, 151643, 151643, 151643, 151643, 151643, 151643, 151643, 151643, 151643, 151643, 151643, 151643, 151643, 151643, 151643, 151643, 151643, 151643, 151643, 151643, 151643, 151643, 151643, 151643, 151643, 151643, 151643, 151643, 151643, 151643, 151643, 151643, 151643, 151643, 151643, 151643, 151643, 151643, 151643, 151643, 151643, 151643, 151643, 151643, 151643, 151643, 151643, 151643, 151643, 151643, 151643, 151643, 151643, 151643, 151643, 151643, 151643, 151643, 151643, 151643, 151643, 151643, 151643, 151643, 151643, 151643, 151643, 151643, 151643, 151643, 151643, 151643, 151643, 151643, 151643, 151643, 151643, 151643, 151643, 151643, 151643, 151643, 151643, 151643, 151643, 151643, 151643, 151643, 151643, 151643, 151643, 151643, 151643, 151643, 151643, 151643, 151643, 151643, 151643, 151643, 151643, 151643, 151643, 151643, 151643, 151643, 151643, 151643, 151643, 151643, 151643, 151643, 151643, 151643, 151643, 151643, 151643, 151643, 151643, 151643, 151643, 151643, 151643, 151643, 151643, 151643, 151643, 151643, 151643, 151643, 151643, 151643, 151643, 151643, 151643, 151643, 151643, 151643, 151643, 151643, 151643, 151643, 151643, 151643, 151643, 151643, 151643, 151643, 151643, 151643, 151643, 151643, 151643, 151643, 151643, 151643, 151643, 151643, 151643, 151643, 151643, 151643, 151643, 151643, 151643, 151643, 151643, 151643, 151643, 151643, 151643, 151643, 151643, 151643, 151643, 151643, 151643, 151643, 151643, 151643, 151643, 151643, 151643, 151643, 151643, 151643, 151643, 151643, 151643, 151643, 151643, 151643, 151643, 151643, 151643, 151643, 151643, 151643, 151643, 151643, 151643, 151643, 151643, 151643, 151643, 151643, 151643, 151643, 151643, 151643, 151643, 151643, 151643, 151643, 151643, 151643, 151643, 151643, 151643, 151643, 151643, 151643, 151643, 151643, 151643, 151643, 151643, 151643, 151643, 151643, 151643, 151643, 151643, 151643, 151643, 151643, 151643, 151643, 151643, 151643, 151643, 151643, 151643, 151643, 151643, 151643, 151643, 151643, 151643, 151643, 151643, 151643, 151643, 151643, 151643, 151643, 151643, 151643, 151643, 151643, 151643, 151643, 151643, 151643, 151643, 151643, 151643, 151643, 151643, 151643, 151643, 151643, 151643, 151643, 151643, 151643, 151643, 151643, 151643, 151643, 151643, 151643, 151643, 151643, 151643, 151643, 151643, 151643, 151643, 151643, 151643, 151643, 151643, 151643, 151643, 151643, 151643, 151643, 151643, 151643, 151643, 151643, 151643, 151643, 151643, 151643, 151643, 151643, 151643, 151643, 151643, 151643, 151643, 151643, 151643, 151643, 151643, 151643, 151643, 151643, 151643, 151643, 151643, 151643, 151643, 151643, 151643, 151643, 151644, 8948, 198, 2610, 525, 1207, 16948, 11, 3465, 553, 54364, 14817, 13, 1446, 525, 264, 10950, 17847, 13, 151645, 198, 151644, 872, 198, 16141, 279, 2701, 5248, 5754, 3405, 13, 576, 1537, 1555, 315, 697, 2033, 1265, 387, 315, 279, 2701, 3561, 25, 364, 16141, 25, 400, 20756, 4198, 6, 320, 28996, 17194, 8, 1380, 44428, 374, 825, 315, 19360, 35, 13, 21149, 3019, 553, 3019, 1573, 35764, 382, 12548, 279, 2701, 24473, 323, 3293, 279, 3598, 3871, 553, 12831, 279, 357, 11632, 47319, 34106, 11, 323, 279, 19753, 315, 279, 3871, 624, 17, 12, 41872, 12, 17, 11, 21, 1737, 318, 41872, 66, 3337, 385, 17308, 276, 12, 16, 18589, 488, 8372, 3923, 1613, 884, 5075, 320, 83, 7671, 84, 3925, 8, 69726, 362, 198, 16, 5279, 275, 299, 776, 25325, 488, 320, 42, 46761, 11, 320, 36, 7287, 8088, 12, 17, 20767, 268, 21561, 457, 11, 472, 17, 46, 8, 69726, 425, 271, 32, 8, 362, 284, 8372, 3923, 220, 18, 8013, 18, 12, 41872, 12, 18, 11, 20, 1737, 318, 41872, 12, 19, 12, 5131, 509, 3337, 385, 17308, 3923, 8, 776, 848, 78, 349, 11, 425, 284, 220, 17, 11, 18, 1737, 318, 41872, 12, 19, 5279, 275, 299, 8088, 276, 268, 21561, 457, 198, 33, 8, 362, 284, 8372, 3923, 220, 18, 8013, 18, 12, 41872, 12, 16, 11, 18, 1737, 318, 41872, 12, 17, 12, 5131, 509, 3337, 385, 17308, 3923, 8, 776, 848, 78, 349, 11, 425, 284, 220, 18, 1448, 41872, 12, 19, 5279, 275, 299, 17308, 276, 268, 21561, 457, 198, 34, 8, 362, 284, 8372, 3923, 220, 18, 8013, 18, 12, 41872, 12, 18, 11, 20, 1737, 318, 41872, 12, 19, 12, 5131, 509, 3337, 385, 17308, 3923, 8, 776, 848, 78, 349, 11, 425, 284, 220, 18, 1448, 41872, 12, 19, 5279, 275, 299, 17308, 276, 268, 21561, 457, 198, 35, 8, 362, 284, 8372, 3923, 220, 18, 8013, 18, 12, 41872, 12, 16, 11, 18, 1737, 318, 41872, 12, 17, 12, 5131, 509, 3337, 385, 17308, 3923, 8, 776, 848, 78, 349, 11, 425, 284, 220, 17, 11, 18, 1737, 318, 41872, 12, 19, 5279, 275, 299, 8088, 276, 268, 21561, 457, 151645, 198, 151644, 77091, 198]",,370,477,847,0.0,0.0
6a997876-8d81-493d-8849-8dbfa202fd97,7,79,"[151643, 151643, 151643, 151643, 151643, 151643, 151643, 151643, 151643, 151643, 151643, 151643, 151643, 151643, 151643, 151643, 151643, 151643, 151643, 151643, 151643, 151643, 151643, 151643, 151643, 151643, 151643, 151643, 151643, 151643, 151643, 151643, 151643, 151643, 151643, 151643, 151643, 151643, 151643, 151643, 151643, 151643, 151643, 151643, 151643, 151643, 151643, 151643, 151643, 151643, 151643, 151643, 151643, 151643, 151643, 151643, 151643, 151643, 151643, 151643, 151643, 151643, 151643, 151643, 151643, 151643, 151643, 151643, 151643, 151643, 151643, 151643, 151643, 151643, 151643, 151643, 151643, 151643, 151643, 151643, 151643, 151643, 151643, 151643, 151643, 151643, 151643, 151643, 151643, 151643, 151643, 151643, 151643, 151643, 151643, 151643, 151643, 151643, 151643, 151643, 151643, 151643, 151643, 151643, 151643, 151643, 151643, 151643, 151643, 151643, 151643, 151643, 151643, 151643, 151643, 151643, 151643, 151643, 151643, 151643, 151643, 151643, 151643, 151643, 151643, 151643, 151643, 151643, 151643, 151643, 151643, 151643, 151643, 151643, 151643, 151643, 151643, 151643, 151643, 151643, 151643, 151643, 151643, 151643, 151643, 151643, 151643, 151643, 151643, 151643, 151643, 151643, 151643, 151643, 151643, 151643, 151643, 151643, 151643, 151643, 151643, 151643, 151643, 151643, 151643, 151643, 151643, 151643, 151643, 151643, 151643, 151643, 151643, 151643, 151643, 151643, 151643, 151643, 151643, 151643, 151643, 151643, 151643, 151643, 151643, 151643, 151643, 151643, 151643, 151643, 151643, 151643, 151643, 151643, 151643, 151643, 151643, 151643, 151643, 151643, 151643, 151643, 151643, 151643, 151643, 151643, 151643, 151643, 151643, 151643, 151643, 151643, 151643, 151643, 151643, 151643, 151643, 151643, 151643, 151643, 151643, 151643, 151643, 151643, 151643, 151643, 151643, 151643, 151643, 151643, 151643, 151643, 151643, 151643, 151643, 151643, 151643, 151643, 151643, 151643, 151643, 151643, 151643, 151643, 151643, 151643, 151643, 151643, 151643, 151643, 151643, 151643, 151643, 151643, 151643, 151643, 151643, 151643, 151643, 151643, 151643, 151643, 151643, 151643, 151643, 151643, 151643, 151643, 151643, 151643, 151643, 151643, 151643, 151643, 151643, 151643, 151643, 151643, 151643, 151643, 151643, 151643, 151643, 151643, 151643, 151643, 151643, 151643, 151643, 151643, 151643, 151643, 151643, 151643, 151643, 151643, 151643, 151643, 151643, 151643, 151643, 151643, 151643, 151643, 151643, 151643, 151643, 151643, 151643, 151643, 151643, 151643, 151643, 151643, 151643, 151643, 151643, 151643, 151643, 151643, 151643, 151643, 151643, 151643, 151643, 151643, 151643, 151643, 151643, 151643, 151643, 151643, 151643, 151643, 151643, 151643, 151643, 151643, 151643, 151643, 151643, 151643, 151643, 151643, 151643, 151643, 151643, 151643, 151643, 151643, 151643, 151643, 151643, 151643, 151643, 151643, 151643, 151643, 151643, 151643, 151643, 151643, 151643, 151643, 151643, 151643, 151643, 151643, 151643, 151643, 151643, 151643, 151643, 151643, 151643, 151643, 151643, 151643, 151643, 151643, 151643, 151643, 151643, 151643, 151643, 151643, 151643, 151643, 151643, 151643, 151643, 151643, 151643, 151643, 151643, 151643, 151643, 151643, 151643, 151643, 151643, 151643, 151643, 151643, 151643, 151643, 151643, 151643, 151643, 151643, 151643, 151643, 151643, 151643, 151643, 151643, 151643, 151643, 151643, 151643, 151643, 151643, 151643, 151643, 151643, 151643, 151643, 151643, 151643, 151643, 151643, 151643, 151643, 151643, 151643, 151643, 151643, 151643, 151643, 151643, 151643, 151643, 151643, 151643, 151643, 151643, 151643, 151643, 151643, 151643, 151643, 151643, 151643, 151643, 151643, 151643, 151643, 151643, 151643, 151643, 151643, 151643, 151643, 151643, 151643, 151643, 151643, 151643, 151643, 151643, 151643, 151643, 151643, 151643, 151643, 151643, 151643, 151643, 151643, 151643, 151643, 151643, 151643, 151643, 151643, 151643, 151643, 151643, 151643, 151643, 151643, 151643, 151643, 151643, 151643, 151643, 151643, 151643, 151643, 151643, 151643, 151643, 151643, 151643, 151643, 151643, 151643, 151643, 151643, 151643, 151643, 151643, 151643, 151643, 151643, 151643, 151643, 151643, 151643, 151643, 151643, 151643, 151643, 151643, 151643, 151643, 151643, 151643, 151643, 151643, 151643, 151643, 151643, 151643, 151643, 151643, 151643, 151643, 151643, 151643, 151643, 151643, 151643, 151643, 151643, 151643, 151643, 151643, 151643, 151643, 151643, 151643, 151643, 151643, 151643, 151643, 151643, 151643, 151643, 151643, 151643, 151643, 151643, 151643, 151643, 151643, 151643, 151643, 151643, 151643, 151643, 151643, 151643, 151643, 151643, 151643, 151643, 151643, 151643, 151643, 151643, 151643, 151643, 151643, 151643, 151643, 151643, 151643, 151643, 151643, 151643, 151643, 151643, 151643, 151643, 151643, 151643, 151643, 151643, 151643, 151643, 151643, 151643, 151643, 151643, 151643, 151643, 151643, 151643, 151643, 151643, 151643, 151643, 151643, 151643, 151643, 151643, 151643, 151643, 151643, 151643, 151643, 151643, 151643, 151643, 151643, 151643, 151643, 151643, 151643, 151643, 151643, 151643, 151643, 151643, 151643, 151643, 151643, 151643, 151643, 151643, 151643, 151643, 151643, 151643, 151643, 151643, 151643, 151643, 151643, 151643, 151643, 151643, 151643, 151643, 151643, 151643, 151643, 151644, 8948, 198, 2610, 525, 1207, 16948, 11, 3465, 553, 54364, 14817, 13, 1446, 525, 264, 10950, 17847, 13, 151645, 198, 151644, 872, 198, 16141, 279, 2701, 5248, 5754, 3405, 13, 576, 1537, 1555, 315, 697, 2033, 1265, 387, 315, 279, 2701, 3561, 25, 364, 16141, 25, 400, 20756, 4198, 6, 320, 28996, 17194, 8, 1380, 44428, 374, 825, 315, 19360, 35, 13, 21149, 3019, 553, 3019, 1573, 35764, 382, 32, 21068, 38610, 6291, 315, 320, 49, 7287, 40938, 7287, 43, 25417, 1952, 374, 74840, 448, 393, 67, 11295, 1212, 264, 39502, 4370, 16566, 13, 4636, 220, 16, 13578, 315, 34684, 374, 25983, 11, 1985, 220, 16, 374, 24203, 438, 279, 3598, 1985, 382, 16, 374, 11758, 448, 220, 18, 11582, 9566, 3296, 7964, 12738, 292, 13621, 11, 29064, 1985, 220, 17, 382, 4816, 220, 17, 374, 11758, 448, 38595, 21068, 54089, 11, 29064, 1985, 220, 18, 382, 4816, 220, 18, 374, 11758, 448, 462, 848, 78, 292, 13621, 11, 294, 2842, 32578, 17308, 3923, 6918, 65, 30459, 318, 577, 13, 323, 264, 33354, 69404, 3311, 315, 220, 220, 19, 1737, 318, 41872, 8608, 1266, 1869, 482, 11, 29064, 1985, 220, 19, 382, 12555, 374, 264, 2697, 5944, 315, 1985, 220, 19, 30, 320, 3031, 220, 19, 6724, 438, 264, 20980, 315, 374, 68538, 13, 279, 4396, 4226, 374, 825, 315, 1105, 3593, 32, 8, 320, 16, 50, 11, 17, 50, 11, 19, 49, 7287, 19, 30430, 453, 887, 3923, 12, 17, 1448, 769, 60163, 12, 16, 1448, 41872, 66, 3337, 385, 17308, 3923, 2004, 84899, 198, 33, 8, 320, 16, 50, 11, 17, 50, 11, 20, 49, 7287, 20, 30430, 453, 887, 3923, 12, 17, 1448, 769, 60163, 12, 17, 1448, 41872, 66, 3337, 385, 17308, 3923, 2004, 84899, 198, 34, 8, 220, 16, 1448, 769, 60163, 12, 17, 12, 1188, 50, 7287, 19, 1448, 41872, 66, 3337, 385, 17308, 12, 18, 20767, 12, 16, 12, 3923, 8, 776, 848, 12, 17, 12, 3923, 2004, 84899, 198, 35, 8, 320, 16, 50, 11, 17, 49, 11, 19, 49, 7287, 19, 30430, 453, 887, 3923, 12, 17, 1448, 769, 60163, 12, 16, 1448, 41872, 66, 3337, 385, 17308, 3923, 2004, 84899, 151645, 198, 151644, 77091, 198]",,366,551,917,0.0,0.0
59211c44-7659-48c5-adc9-27594773deec,7,80,"[151643, 151643, 151643, 151643, 151643, 151643, 151643, 151643, 151643, 151643, 151643, 151643, 151643, 151643, 151643, 151643, 151643, 151643, 151643, 151643, 151643, 151643, 151643, 151643, 151643, 151643, 151643, 151643, 151643, 151643, 151643, 151643, 151643, 151643, 151643, 151643, 151643, 151643, 151643, 151643, 151643, 151643, 151643, 151643, 151643, 151643, 151643, 151643, 151643, 151643, 151643, 151643, 151643, 151643, 151643, 151643, 151643, 151643, 151643, 151643, 151643, 151643, 151643, 151643, 151643, 151643, 151643, 151643, 151643, 151643, 151643, 151643, 151643, 151643, 151643, 151643, 151643, 151643, 151643, 151643, 151643, 151643, 151643, 151643, 151643, 151643, 151643, 151643, 151643, 151643, 151643, 151643, 151643, 151643, 151643, 151643, 151643, 151643, 151643, 151643, 151643, 151643, 151643, 151643, 151643, 151643, 151643, 151643, 151643, 151643, 151643, 151643, 151643, 151643, 151643, 151643, 151643, 151643, 151643, 151643, 151643, 151643, 151643, 151643, 151643, 151643, 151643, 151643, 151643, 151643, 151643, 151643, 151643, 151643, 151643, 151643, 151643, 151643, 151643, 151643, 151643, 151643, 151643, 151643, 151643, 151643, 151643, 151643, 151643, 151643, 151643, 151643, 151643, 151643, 151643, 151643, 151643, 151643, 151643, 151643, 151643, 151643, 151643, 151643, 151643, 151643, 151643, 151643, 151643, 151643, 151643, 151643, 151643, 151643, 151643, 151643, 151643, 151643, 151643, 151643, 151643, 151643, 151643, 151643, 151643, 151643, 151643, 151643, 151643, 151643, 151643, 151643, 151643, 151643, 151643, 151643, 151643, 151643, 151643, 151643, 151643, 151643, 151643, 151643, 151643, 151643, 151643, 151643, 151643, 151643, 151643, 151643, 151643, 151643, 151643, 151643, 151643, 151643, 151643, 151643, 151643, 151643, 151643, 151643, 151643, 151643, 151643, 151643, 151643, 151643, 151643, 151643, 151643, 151643, 151643, 151643, 151643, 151643, 151643, 151643, 151643, 151643, 151643, 151643, 151643, 151643, 151643, 151643, 151643, 151643, 151643, 151643, 151643, 151643, 151643, 151643, 151643, 151643, 151643, 151643, 151643, 151643, 151643, 151643, 151643, 151643, 151643, 151643, 151643, 151643, 151643, 151643, 151643, 151643, 151643, 151643, 151643, 151643, 151643, 151643, 151643, 151643, 151643, 151643, 151643, 151643, 151643, 151643, 151643, 151643, 151643, 151643, 151643, 151643, 151643, 151643, 151643, 151643, 151643, 151643, 151643, 151643, 151643, 151643, 151643, 151643, 151643, 151643, 151643, 151643, 151643, 151643, 151643, 151643, 151643, 151643, 151643, 151643, 151643, 151643, 151643, 151643, 151643, 151643, 151643, 151643, 151643, 151643, 151643, 151643, 151643, 151643, 151643, 151643, 151643, 151643, 151643, 151643, 151643, 151643, 151643, 151643, 151643, 151643, 151643, 151643, 151643, 151643, 151643, 151643, 151643, 151643, 151643, 151643, 151643, 151643, 151643, 151643, 151643, 151643, 151643, 151643, 151643, 151643, 151643, 151643, 151643, 151643, 151643, 151643, 151643, 151643, 151643, 151643, 151643, 151643, 151643, 151643, 151643, 151643, 151643, 151643, 151643, 151643, 151643, 151643, 151643, 151643, 151643, 151643, 151643, 151643, 151643, 151643, 151643, 151643, 151643, 151643, 151643, 151643, 151643, 151643, 151643, 151643, 151643, 151643, 151643, 151643, 151643, 151643, 151643, 151643, 151643, 151643, 151643, 151643, 151643, 151643, 151643, 151643, 151643, 151643, 151643, 151643, 151643, 151643, 151643, 151643, 151643, 151643, 151643, 151643, 151643, 151643, 151643, 151643, 151643, 151643, 151643, 151643, 151643, 151643, 151643, 151643, 151643, 151643, 151643, 151643, 151643, 151643, 151643, 151643, 151643, 151643, 151643, 151643, 151643, 151643, 151643, 151643, 151643, 151643, 151643, 151643, 151643, 151643, 151643, 151643, 151643, 151643, 151643, 151643, 151643, 151643, 151643, 151643, 151643, 151643, 151643, 151643, 151643, 151643, 151643, 151643, 151643, 151643, 151643, 151643, 151643, 151643, 151643, 151643, 151643, 151643, 151643, 151643, 151643, 151643, 151643, 151643, 151643, 151643, 151643, 151643, 151643, 151643, 151643, 151643, 151643, 151643, 151643, 151643, 151643, 151643, 151643, 151643, 151643, 151643, 151643, 151643, 151643, 151643, 151643, 151643, 151643, 151643, 151643, 151643, 151643, 151643, 151643, 151643, 151643, 151643, 151643, 151643, 151643, 151643, 151643, 151643, 151643, 151643, 151643, 151643, 151643, 151643, 151643, 151643, 151643, 151643, 151643, 151643, 151643, 151643, 151643, 151643, 151643, 151643, 151643, 151643, 151643, 151643, 151643, 151643, 151643, 151643, 151643, 151643, 151643, 151643, 151643, 151643, 151643, 151643, 151643, 151643, 151643, 151643, 151643, 151643, 151643, 151643, 151643, 151643, 151643, 151643, 151643, 151643, 151643, 151643, 151643, 151643, 151643, 151643, 151643, 151643, 151643, 151643, 151643, 151643, 151643, 151643, 151643, 151643, 151643, 151643, 151643, 151643, 151643, 151643, 151643, 151643, 151643, 151643, 151643, 151643, 151643, 151643, 151643, 151643, 151643, 151643, 151643, 151643, 151643, 151643, 151643, 151643, 151643, 151643, 151643, 151643, 151643, 151643, 151643, 151643, 151643, 151643, 151643, 151643, 151643, 151643, 151643, 151643, 151643, 151643, 151643, 151643, 151643, 151643, 151643, 151643, 151643, 151643, 151643, 151643, 151643, 151643, 151643, 151643, 151643, 151643, 151643, 151643, 151643, 151643, 151643, 151643, 151643, 151643, 151643, 151643, 151643, 151643, 151643, 151643, 151643, 151643, 151643, 151643, 151643, 151643, 151643, 151643, 151643, 151643, 151643, 151643, 151643, 151643, 151643, 151643, 151643, 151643, 151643, 151643, 151643, 151643, 151643, 151643, 151643, 151643, 151643, 151643, 151643, 151643, 151643, 151643, 151643, 151643, 151643, 151643, 151643, 151643, 151643, 151643, 151643, 151643, 151643, 151643, 151643, 151643, 151643, 151643, 151643, 151643, 151643, 151643, 151643, 151643, 151643, 151643, 151643, 151643, 151643, 151643, 151643, 151643, 151643, 151643, 151643, 151643, 151643, 151643, 151643, 151643, 151643, 151643, 151643, 151643, 151643, 151643, 151643, 151643, 151643, 151643, 151643, 151643, 151643, 151643, 151643, 151643, 151643, 151643, 151643, 151643, 151643, 151643, 151643, 151643, 151643, 151643, 151643, 151643, 151643, 151643, 151643, 151643, 151643, 151643, 151643, 151643, 151643, 151643, 151643, 151643, 151643, 151643, 151643, 151643, 151643, 151643, 151643, 151643, 151643, 151643, 151643, 151643, 151643, 151643, 151643, 151643, 151643, 151643, 151643, 151644, 8948, 198, 2610, 525, 1207, 16948, 11, 3465, 553, 54364, 14817, 13, 1446, 525, 264, 10950, 17847, 13, 151645, 198, 151644, 872, 198, 16141, 279, 2701, 5248, 5754, 3405, 13, 576, 1537, 1555, 315, 697, 2033, 1265, 387, 315, 279, 2701, 3561, 25, 364, 16141, 25, 400, 20756, 4198, 6, 320, 28996, 17194, 8, 1380, 44428, 374, 825, 315, 19360, 35, 13, 21149, 3019, 553, 3019, 1573, 35764, 382, 1654, 18840, 1070, 220, 17, 15, 13, 15, 15, 9961, 18, 220, 15, 13, 15, 20, 386, 1613, 5298, 13621, 448, 220, 17, 15, 13, 15, 15, 9961, 18, 3015, 11, 1221, 8142, 7698, 279, 12942, 6291, 448, 220, 15, 13, 16, 44, 12812, 46761, 320, 17, 20, 36286, 34, 568, 3555, 686, 387, 279, 897, 315, 36043, 518, 220, 17, 20, 4, 8142, 2165, 323, 518, 279, 84162, 1459, 30, 576, 22309, 315, 1613, 5298, 13621, 374, 220, 16, 13, 23, 20, 87, 16, 15, 49309, 20, 382, 32, 8, 220, 19, 13, 20, 22, 26, 220, 21, 13, 24, 17, 198, 33, 8, 220, 19, 13, 17, 21, 26, 220, 23, 13, 20, 17, 198, 34, 8, 220, 18, 13, 16, 22, 26, 220, 21, 13, 22, 18, 198, 35, 8, 220, 19, 13, 22, 18, 26, 220, 22, 13, 15, 15, 151645, 198, 151644, 77091, 198]",,219,1135,1354,1.0,1.0
6d9a206c-5722-40c7-a97e-50ff32094be1,7,81,"[151643, 151643, 151643, 151643, 151643, 151643, 151643, 151643, 151643, 151643, 151643, 151643, 151643, 151643, 151643, 151643, 151643, 151643, 151643, 151643, 151643, 151643, 151643, 151643, 151643, 151643, 151643, 151643, 151643, 151643, 151643, 151643, 151643, 151643, 151643, 151643, 151643, 151643, 151643, 151643, 151643, 151643, 151643, 151643, 151643, 151643, 151643, 151643, 151643, 151643, 151643, 151643, 151643, 151643, 151643, 151643, 151643, 151643, 151643, 151643, 151643, 151643, 151643, 151643, 151643, 151643, 151643, 151643, 151643, 151643, 151643, 151643, 151643, 151643, 151643, 151643, 151643, 151643, 151643, 151643, 151643, 151643, 151643, 151643, 151643, 151643, 151643, 151643, 151643, 151643, 151643, 151643, 151643, 151643, 151643, 151643, 151643, 151643, 151643, 151643, 151643, 151643, 151643, 151643, 151643, 151643, 151643, 151643, 151643, 151643, 151643, 151643, 151643, 151643, 151643, 151643, 151643, 151643, 151643, 151643, 151643, 151643, 151643, 151643, 151643, 151643, 151643, 151643, 151643, 151643, 151643, 151643, 151643, 151643, 151643, 151643, 151643, 151643, 151643, 151643, 151643, 151643, 151643, 151643, 151643, 151643, 151643, 151643, 151643, 151643, 151643, 151643, 151643, 151643, 151643, 151643, 151643, 151643, 151643, 151643, 151643, 151643, 151643, 151643, 151643, 151643, 151643, 151643, 151643, 151643, 151643, 151643, 151643, 151643, 151643, 151643, 151643, 151643, 151643, 151643, 151643, 151643, 151643, 151643, 151643, 151643, 151643, 151643, 151643, 151643, 151643, 151643, 151643, 151643, 151643, 151643, 151643, 151643, 151643, 151643, 151643, 151643, 151643, 151643, 151643, 151643, 151643, 151643, 151643, 151643, 151643, 151643, 151643, 151643, 151643, 151643, 151643, 151643, 151643, 151643, 151643, 151643, 151643, 151643, 151643, 151643, 151643, 151643, 151643, 151643, 151643, 151643, 151643, 151643, 151643, 151643, 151643, 151643, 151643, 151643, 151643, 151643, 151643, 151643, 151643, 151643, 151643, 151643, 151643, 151643, 151643, 151643, 151643, 151643, 151643, 151643, 151643, 151643, 151643, 151643, 151643, 151643, 151643, 151643, 151643, 151643, 151643, 151643, 151643, 151643, 151643, 151643, 151643, 151643, 151643, 151643, 151643, 151643, 151643, 151643, 151643, 151643, 151643, 151643, 151643, 151643, 151643, 151643, 151643, 151643, 151643, 151643, 151643, 151643, 151643, 151643, 151643, 151643, 151643, 151643, 151643, 151643, 151643, 151643, 151643, 151643, 151643, 151643, 151643, 151643, 151643, 151643, 151643, 151643, 151643, 151643, 151643, 151643, 151643, 151643, 151643, 151643, 151643, 151643, 151643, 151643, 151643, 151643, 151643, 151643, 151643, 151643, 151643, 151643, 151643, 151643, 151643, 151643, 151643, 151643, 151643, 151643, 151643, 151643, 151643, 151643, 151643, 151643, 151643, 151643, 151643, 151643, 151643, 151643, 151643, 151643, 151643, 151643, 151643, 151643, 151643, 151643, 151643, 151643, 151643, 151643, 151643, 151643, 151643, 151643, 151643, 151643, 151643, 151643, 151643, 151643, 151643, 151643, 151643, 151643, 151643, 151643, 151643, 151643, 151643, 151643, 151643, 151643, 151643, 151643, 151643, 151643, 151643, 151643, 151643, 151643, 151643, 151643, 151643, 151643, 151643, 151643, 151643, 151643, 151643, 151643, 151643, 151643, 151643, 151643, 151643, 151643, 151643, 151643, 151643, 151643, 151643, 151643, 151643, 151643, 151643, 151643, 151643, 151643, 151643, 151643, 151643, 151643, 151643, 151643, 151643, 151643, 151643, 151643, 151643, 151643, 151643, 151643, 151643, 151643, 151643, 151643, 151643, 151643, 151643, 151643, 151643, 151643, 151643, 151643, 151643, 151643, 151643, 151643, 151643, 151643, 151643, 151643, 151643, 151643, 151643, 151643, 151643, 151643, 151643, 151643, 151643, 151643, 151643, 151643, 151643, 151643, 151643, 151643, 151643, 151643, 151643, 151643, 151643, 151643, 151643, 151643, 151643, 151643, 151643, 151643, 151643, 151643, 151643, 151643, 151643, 151643, 151643, 151643, 151643, 151643, 151643, 151643, 151643, 151643, 151643, 151643, 151643, 151643, 151643, 151643, 151643, 151643, 151643, 151643, 151643, 151643, 151643, 151643, 151643, 151643, 151643, 151643, 151643, 151643, 151643, 151643, 151643, 151643, 151643, 151643, 151643, 151643, 151643, 151643, 151643, 151643, 151643, 151643, 151643, 151643, 151643, 151643, 151643, 151643, 151643, 151643, 151643, 151643, 151643, 151643, 151643, 151643, 151643, 151643, 151643, 151643, 151643, 151643, 151643, 151643, 151643, 151643, 151643, 151643, 151643, 151643, 151643, 151643, 151643, 151643, 151643, 151643, 151643, 151643, 151643, 151643, 151643, 151643, 151643, 151643, 151643, 151643, 151643, 151643, 151643, 151643, 151643, 151643, 151643, 151643, 151643, 151643, 151643, 151643, 151643, 151643, 151643, 151643, 151643, 151643, 151643, 151643, 151643, 151643, 151643, 151643, 151643, 151643, 151643, 151643, 151643, 151643, 151643, 151643, 151643, 151643, 151643, 151643, 151643, 151643, 151643, 151643, 151643, 151643, 151643, 151643, 151643, 151643, 151643, 151643, 151643, 151643, 151643, 151643, 151643, 151643, 151643, 151643, 151643, 151643, 151643, 151643, 151643, 151643, 151643, 151643, 151643, 151643, 151643, 151643, 151643, 151643, 151643, 151643, 151643, 151643, 151643, 151643, 151643, 151643, 151643, 151643, 151643, 151643, 151643, 151643, 151643, 151643, 151643, 151643, 151643, 151643, 151643, 151643, 151643, 151643, 151643, 151643, 151643, 151643, 151643, 151643, 151643, 151643, 151643, 151643, 151643, 151643, 151643, 151643, 151643, 151643, 151643, 151643, 151643, 151643, 151643, 151643, 151643, 151643, 151643, 151643, 151643, 151643, 151643, 151643, 151643, 151643, 151643, 151643, 151643, 151643, 151643, 151643, 151643, 151643, 151643, 151643, 151643, 151643, 151643, 151643, 151643, 151643, 151643, 151643, 151643, 151643, 151643, 151643, 151643, 151643, 151643, 151643, 151643, 151643, 151643, 151643, 151643, 151643, 151643, 151643, 151643, 151643, 151643, 151643, 151643, 151643, 151643, 151643, 151643, 151643, 151643, 151643, 151643, 151643, 151643, 151643, 151643, 151643, 151643, 151643, 151643, 151643, 151643, 151643, 151643, 151644, 8948, 198, 2610, 525, 1207, 16948, 11, 3465, 553, 54364, 14817, 13, 1446, 525, 264, 10950, 17847, 13, 151645, 198, 151644, 872, 198, 16141, 279, 2701, 5248, 5754, 3405, 13, 576, 1537, 1555, 315, 697, 2033, 1265, 387, 315, 279, 2701, 3561, 25, 364, 16141, 25, 400, 20756, 4198, 6, 320, 28996, 17194, 8, 1380, 44428, 374, 825, 315, 19360, 35, 13, 21149, 3019, 553, 3019, 1573, 35764, 382, 32, 495, 14274, 388, 525, 20956, 264, 1849, 315, 2326, 505, 93460, 1415, 320, 59634, 16, 11, 28835, 17, 11, 323, 28835, 18, 8, 448, 26931, 85128, 11105, 1526, 279, 350, 15653, 1714, 13, 2379, 614, 1730, 429, 279, 11341, 315, 279, 55311, 19879, 1948, 28835, 16, 323, 28835, 17, 374, 13187, 220, 16, 13, 19, 11, 323, 1948, 28835, 17, 323, 28835, 18, 11, 432, 374, 911, 220, 17, 13, 18, 13, 2379, 614, 1083, 1730, 429, 279, 11341, 315, 279, 31638, 1948, 28835, 16, 323, 28835, 17, 374, 13187, 220, 16, 13, 16, 20, 11, 323, 1948, 28835, 17, 323, 28835, 18, 11, 432, 374, 911, 220, 16, 13, 18, 20, 13, 3216, 1128, 8168, 374, 279, 64591, 4168, 315, 28835, 18, 8131, 1091, 429, 315, 28835, 16, 11, 421, 279, 452, 88987, 369, 678, 2326, 32875, 374, 6144, 311, 220, 15, 13, 18, 320, 64287, 311, 429, 315, 9237, 73530, 32, 8, 3968, 220, 16, 15, 13, 19, 198, 33, 8, 3968, 220, 18, 13, 17, 198, 34, 8, 3968, 220, 19, 13, 19, 198, 35, 8, 3968, 220, 18, 18, 13, 19, 151645, 198, 151644, 77091, 198]",,261,782,1043,0.0,0.0
2bc6386e-09fc-4bb2-9361-a7601078af9b,7,82,"[151643, 151643, 151643, 151643, 151643, 151643, 151643, 151643, 151643, 151643, 151643, 151643, 151643, 151643, 151643, 151643, 151643, 151643, 151643, 151643, 151643, 151643, 151643, 151643, 151643, 151643, 151643, 151643, 151643, 151643, 151643, 151643, 151643, 151643, 151643, 151643, 151643, 151643, 151643, 151643, 151643, 151643, 151643, 151643, 151643, 151643, 151643, 151643, 151643, 151643, 151643, 151643, 151643, 151643, 151643, 151643, 151643, 151643, 151643, 151643, 151643, 151643, 151643, 151643, 151643, 151643, 151643, 151643, 151643, 151643, 151643, 151643, 151643, 151643, 151643, 151643, 151643, 151643, 151643, 151643, 151643, 151643, 151643, 151643, 151643, 151643, 151643, 151643, 151643, 151643, 151643, 151643, 151643, 151643, 151643, 151643, 151643, 151643, 151643, 151643, 151643, 151643, 151643, 151643, 151643, 151643, 151643, 151643, 151643, 151643, 151643, 151643, 151643, 151643, 151643, 151643, 151643, 151643, 151643, 151643, 151643, 151643, 151643, 151643, 151643, 151643, 151643, 151643, 151643, 151643, 151643, 151643, 151643, 151643, 151643, 151643, 151643, 151643, 151643, 151643, 151643, 151643, 151643, 151643, 151643, 151643, 151643, 151643, 151643, 151643, 151643, 151643, 151643, 151643, 151643, 151643, 151643, 151643, 151643, 151643, 151643, 151643, 151643, 151643, 151643, 151643, 151643, 151643, 151643, 151643, 151643, 151643, 151643, 151643, 151643, 151643, 151643, 151643, 151643, 151643, 151643, 151643, 151643, 151643, 151643, 151643, 151643, 151643, 151643, 151643, 151643, 151643, 151643, 151643, 151643, 151643, 151643, 151643, 151643, 151643, 151643, 151643, 151643, 151643, 151643, 151643, 151643, 151643, 151643, 151643, 151643, 151643, 151643, 151643, 151643, 151643, 151643, 151643, 151643, 151643, 151643, 151643, 151643, 151643, 151643, 151643, 151643, 151643, 151643, 151643, 151643, 151643, 151643, 151643, 151643, 151643, 151643, 151643, 151643, 151643, 151643, 151643, 151643, 151643, 151643, 151643, 151643, 151643, 151643, 151643, 151643, 151643, 151643, 151643, 151643, 151643, 151643, 151643, 151643, 151643, 151643, 151643, 151643, 151643, 151643, 151643, 151643, 151643, 151643, 151643, 151643, 151643, 151643, 151643, 151643, 151643, 151643, 151643, 151643, 151643, 151643, 151643, 151643, 151643, 151643, 151643, 151643, 151643, 151643, 151643, 151643, 151643, 151643, 151643, 151643, 151643, 151643, 151643, 151643, 151643, 151643, 151643, 151643, 151643, 151643, 151643, 151643, 151643, 151643, 151643, 151643, 151643, 151643, 151643, 151643, 151643, 151643, 151643, 151643, 151643, 151643, 151643, 151643, 151643, 151643, 151643, 151643, 151643, 151643, 151643, 151643, 151643, 151643, 151643, 151643, 151643, 151643, 151643, 151643, 151643, 151643, 151643, 151643, 151643, 151643, 151643, 151643, 151643, 151643, 151643, 151643, 151643, 151643, 151643, 151643, 151643, 151643, 151643, 151643, 151643, 151643, 151643, 151643, 151643, 151643, 151643, 151643, 151643, 151643, 151643, 151643, 151643, 151643, 151643, 151643, 151643, 151643, 151643, 151643, 151643, 151643, 151643, 151643, 151643, 151643, 151643, 151643, 151643, 151643, 151643, 151643, 151643, 151643, 151643, 151643, 151643, 151643, 151643, 151643, 151643, 151643, 151643, 151643, 151643, 151643, 151643, 151643, 151643, 151643, 151643, 151643, 151643, 151643, 151643, 151643, 151643, 151643, 151643, 151643, 151643, 151643, 151643, 151643, 151643, 151643, 151643, 151643, 151643, 151643, 151643, 151643, 151643, 151643, 151643, 151643, 151643, 151643, 151643, 151643, 151643, 151643, 151643, 151643, 151643, 151643, 151643, 151643, 151643, 151643, 151643, 151643, 151643, 151643, 151643, 151643, 151643, 151643, 151643, 151643, 151643, 151643, 151643, 151643, 151643, 151643, 151643, 151643, 151643, 151643, 151643, 151643, 151643, 151643, 151643, 151643, 151643, 151643, 151643, 151643, 151643, 151643, 151643, 151643, 151643, 151643, 151643, 151643, 151643, 151643, 151643, 151643, 151643, 151643, 151643, 151643, 151643, 151643, 151643, 151643, 151643, 151643, 151643, 151643, 151643, 151643, 151643, 151643, 151643, 151643, 151643, 151643, 151643, 151643, 151643, 151643, 151643, 151643, 151643, 151643, 151643, 151643, 151643, 151643, 151643, 151643, 151643, 151643, 151643, 151643, 151643, 151643, 151643, 151643, 151643, 151643, 151643, 151643, 151643, 151643, 151643, 151643, 151643, 151643, 151643, 151643, 151643, 151643, 151643, 151643, 151643, 151643, 151643, 151643, 151643, 151643, 151643, 151643, 151643, 151643, 151643, 151643, 151643, 151643, 151643, 151643, 151643, 151643, 151643, 151643, 151643, 151643, 151643, 151643, 151643, 151643, 151643, 151643, 151643, 151643, 151643, 151643, 151643, 151643, 151643, 151643, 151643, 151643, 151643, 151643, 151643, 151643, 151643, 151643, 151643, 151643, 151643, 151643, 151643, 151643, 151643, 151643, 151643, 151643, 151643, 151643, 151643, 151643, 151643, 151643, 151643, 151643, 151643, 151643, 151643, 151643, 151643, 151643, 151643, 151643, 151643, 151643, 151643, 151643, 151643, 151643, 151643, 151643, 151643, 151643, 151643, 151643, 151643, 151643, 151643, 151643, 151643, 151643, 151643, 151643, 151643, 151643, 151643, 151643, 151643, 151643, 151643, 151643, 151643, 151643, 151643, 151643, 151643, 151643, 151643, 151643, 151643, 151643, 151643, 151643, 151643, 151643, 151643, 151643, 151643, 151643, 151643, 151643, 151643, 151643, 151643, 151643, 151643, 151643, 151643, 151643, 151643, 151643, 151643, 151643, 151643, 151643, 151643, 151643, 151643, 151643, 151643, 151643, 151643, 151643, 151643, 151643, 151643, 151643, 151643, 151643, 151643, 151643, 151643, 151643, 151643, 151643, 151643, 151643, 151643, 151643, 151643, 151643, 151643, 151643, 151643, 151643, 151643, 151643, 151643, 151643, 151643, 151643, 151643, 151643, 151643, 151643, 151643, 151643, 151643, 151643, 151643, 151643, 151643, 151643, 151643, 151643, 151643, 151643, 151643, 151643, 151643, 151643, 151643, 151643, 151643, 151643, 151643, 151643, 151643, 151643, 151643, 151643, 151643, 151643, 151643, 151643, 151643, 151643, 151643, 151643, 151643, 151643, 151643, 151643, 151643, 151643, 151643, 151643, 151643, 151643, 151643, 151643, 151643, 151643, 151643, 151643, 151643, 151643, 151643, 151643, 151643, 151643, 151643, 151643, 151643, 151643, 151643, 151643, 151643, 151643, 151643, 151643, 151643, 151643, 151643, 151643, 151643, 151643, 151643, 151643, 151644, 8948, 198, 2610, 525, 1207, 16948, 11, 3465, 553, 54364, 14817, 13, 1446, 525, 264, 10950, 17847, 13, 151645, 198, 151644, 872, 198, 16141, 279, 2701, 5248, 5754, 3405, 13, 576, 1537, 1555, 315, 697, 2033, 1265, 387, 315, 279, 2701, 3561, 25, 364, 16141, 25, 400, 20756, 4198, 6, 320, 28996, 17194, 8, 1380, 44428, 374, 825, 315, 19360, 35, 13, 21149, 3019, 553, 3019, 1573, 35764, 382, 2610, 614, 10030, 458, 9788, 17356, 23628, 13, 576, 2701, 220, 16, 39, 451, 18446, 821, 572, 12180, 510, 16, 39, 451, 18446, 25, 11483, 5785, 320, 602, 76, 1648, 220, 22, 13, 15, 320, 16, 39, 11, 294, 11, 619, 284, 220, 16, 21, 13, 15, 36092, 701, 220, 20, 13, 20, 320, 16, 39, 11, 71613, 701, 220, 17, 13, 16, 320, 18, 39, 11, 274, 701, 220, 16, 13, 21, 320, 18, 39, 11, 294, 340, 28301, 1437, 279, 9788, 23628, 438, 2987, 356, 285, 76571, 268, 3923, 64702, 349, 11, 4058, 76571, 268, 3923, 64702, 349, 11, 356, 285, 1455, 13160, 3923, 64702, 349, 11, 476, 4058, 1455, 13160, 3923, 64702, 349, 382, 32, 8, 4058, 1455, 13160, 3923, 64702, 349, 198, 33, 8, 356, 285, 1455, 13160, 3923, 64702, 349, 198, 34, 8, 356, 285, 76571, 268, 3923, 64702, 349, 198, 35, 8, 4058, 76571, 268, 3923, 64702, 349, 151645, 198, 151644, 77091, 198]",,229,555,784,0.0,0.0
ad5b21c6-ac54-43fb-ac69-974024903240,7,83,"[151643, 151643, 151643, 151643, 151643, 151643, 151643, 151643, 151643, 151643, 151643, 151643, 151643, 151643, 151643, 151643, 151643, 151643, 151643, 151643, 151643, 151643, 151643, 151643, 151643, 151643, 151643, 151643, 151643, 151643, 151643, 151643, 151643, 151643, 151643, 151643, 151643, 151643, 151643, 151643, 151643, 151643, 151643, 151643, 151643, 151643, 151643, 151643, 151643, 151643, 151643, 151643, 151643, 151643, 151643, 151643, 151643, 151643, 151643, 151643, 151643, 151643, 151643, 151643, 151643, 151643, 151643, 151643, 151643, 151643, 151643, 151643, 151643, 151643, 151643, 151643, 151643, 151643, 151643, 151643, 151643, 151643, 151643, 151643, 151643, 151643, 151643, 151643, 151643, 151643, 151643, 151643, 151643, 151643, 151643, 151643, 151643, 151643, 151643, 151643, 151643, 151643, 151643, 151643, 151643, 151643, 151643, 151643, 151643, 151643, 151643, 151643, 151643, 151643, 151643, 151643, 151643, 151643, 151643, 151643, 151643, 151643, 151643, 151643, 151643, 151643, 151643, 151643, 151643, 151643, 151643, 151643, 151643, 151643, 151643, 151643, 151643, 151643, 151643, 151643, 151643, 151643, 151643, 151643, 151643, 151643, 151643, 151643, 151643, 151643, 151643, 151643, 151643, 151643, 151643, 151643, 151643, 151643, 151643, 151643, 151643, 151643, 151643, 151643, 151643, 151643, 151643, 151643, 151643, 151643, 151643, 151643, 151643, 151643, 151643, 151643, 151643, 151643, 151643, 151643, 151643, 151643, 151643, 151643, 151643, 151643, 151643, 151643, 151643, 151643, 151643, 151643, 151643, 151643, 151643, 151643, 151643, 151643, 151643, 151643, 151643, 151643, 151643, 151643, 151643, 151643, 151643, 151643, 151643, 151643, 151643, 151643, 151643, 151643, 151643, 151643, 151643, 151643, 151643, 151643, 151643, 151643, 151643, 151643, 151643, 151643, 151643, 151643, 151643, 151643, 151643, 151643, 151643, 151643, 151643, 151643, 151643, 151643, 151643, 151643, 151643, 151643, 151643, 151643, 151643, 151643, 151643, 151643, 151643, 151643, 151643, 151643, 151643, 151643, 151643, 151643, 151643, 151643, 151643, 151643, 151643, 151643, 151643, 151643, 151643, 151643, 151643, 151643, 151643, 151643, 151643, 151643, 151643, 151643, 151643, 151643, 151643, 151643, 151643, 151643, 151643, 151643, 151643, 151643, 151643, 151643, 151643, 151643, 151643, 151643, 151643, 151643, 151643, 151643, 151643, 151643, 151643, 151643, 151643, 151643, 151643, 151643, 151643, 151643, 151643, 151643, 151643, 151643, 151643, 151643, 151643, 151643, 151643, 151643, 151643, 151643, 151643, 151643, 151643, 151643, 151643, 151643, 151643, 151643, 151643, 151643, 151643, 151643, 151643, 151643, 151643, 151643, 151643, 151643, 151643, 151643, 151643, 151643, 151643, 151643, 151643, 151643, 151643, 151643, 151643, 151643, 151643, 151643, 151643, 151643, 151643, 151643, 151643, 151643, 151643, 151643, 151643, 151643, 151643, 151643, 151643, 151643, 151643, 151643, 151643, 151643, 151643, 151643, 151643, 151643, 151643, 151643, 151643, 151643, 151643, 151643, 151643, 151643, 151643, 151643, 151643, 151643, 151643, 151643, 151643, 151643, 151643, 151643, 151643, 151643, 151643, 151643, 151643, 151643, 151643, 151643, 151643, 151643, 151643, 151643, 151643, 151643, 151643, 151643, 151643, 151643, 151643, 151643, 151643, 151643, 151643, 151643, 151643, 151643, 151643, 151643, 151643, 151643, 151643, 151643, 151643, 151643, 151643, 151643, 151643, 151643, 151643, 151643, 151643, 151643, 151643, 151643, 151643, 151643, 151643, 151643, 151643, 151643, 151643, 151643, 151643, 151643, 151643, 151643, 151643, 151643, 151643, 151643, 151643, 151643, 151643, 151643, 151643, 151643, 151643, 151643, 151643, 151643, 151643, 151643, 151643, 151643, 151643, 151643, 151643, 151643, 151643, 151643, 151643, 151643, 151643, 151643, 151643, 151643, 151643, 151643, 151643, 151643, 151643, 151643, 151643, 151643, 151643, 151643, 151643, 151643, 151643, 151643, 151643, 151643, 151643, 151643, 151643, 151643, 151643, 151643, 151643, 151643, 151643, 151643, 151643, 151643, 151643, 151643, 151643, 151643, 151643, 151643, 151643, 151643, 151643, 151643, 151643, 151643, 151643, 151643, 151643, 151643, 151643, 151643, 151643, 151643, 151643, 151643, 151643, 151643, 151643, 151643, 151643, 151643, 151643, 151643, 151643, 151643, 151643, 151643, 151643, 151643, 151643, 151643, 151643, 151643, 151643, 151643, 151643, 151643, 151643, 151643, 151643, 151643, 151643, 151643, 151643, 151643, 151643, 151643, 151643, 151643, 151643, 151643, 151643, 151643, 151643, 151643, 151643, 151643, 151643, 151643, 151643, 151643, 151643, 151643, 151643, 151643, 151643, 151643, 151643, 151643, 151643, 151643, 151643, 151643, 151643, 151643, 151643, 151643, 151643, 151643, 151643, 151643, 151643, 151643, 151643, 151643, 151643, 151643, 151643, 151643, 151643, 151643, 151643, 151643, 151643, 151643, 151643, 151643, 151643, 151643, 151643, 151643, 151643, 151643, 151643, 151643, 151643, 151643, 151643, 151643, 151643, 151643, 151643, 151643, 151643, 151643, 151643, 151643, 151643, 151643, 151643, 151643, 151643, 151643, 151643, 151643, 151643, 151643, 151643, 151643, 151643, 151643, 151643, 151643, 151643, 151643, 151643, 151643, 151643, 151643, 151643, 151643, 151643, 151643, 151643, 151643, 151643, 151643, 151643, 151643, 151643, 151643, 151643, 151643, 151643, 151643, 151643, 151643, 151643, 151643, 151643, 151643, 151643, 151643, 151643, 151643, 151643, 151643, 151643, 151643, 151643, 151643, 151643, 151643, 151643, 151643, 151643, 151643, 151643, 151643, 151643, 151643, 151643, 151643, 151643, 151643, 151643, 151643, 151643, 151643, 151643, 151643, 151643, 151643, 151643, 151643, 151643, 151643, 151643, 151643, 151643, 151643, 151643, 151643, 151643, 151643, 151643, 151643, 151643, 151643, 151643, 151643, 151643, 151643, 151643, 151643, 151643, 151643, 151643, 151643, 151643, 151643, 151643, 151643, 151643, 151643, 151643, 151643, 151643, 151643, 151643, 151643, 151643, 151643, 151643, 151643, 151643, 151643, 151643, 151643, 151643, 151643, 151643, 151643, 151643, 151643, 151643, 151643, 151643, 151643, 151643, 151643, 151643, 151643, 151643, 151643, 151643, 151643, 151643, 151643, 151643, 151643, 151643, 151643, 151643, 151643, 151643, 151643, 151643, 151643, 151643, 151643, 151643, 151643, 151643, 151643, 151643, 151643, 151643, 151643, 151643, 151643, 151643, 151643, 151643, 151643, 151643, 151643, 151643, 151643, 151643, 151643, 151643, 151643, 151643, 151643, 151643, 151643, 151643, 151644, 8948, 198, 2610, 525, 1207, 16948, 11, 3465, 553, 54364, 14817, 13, 1446, 525, 264, 10950, 17847, 13, 151645, 198, 151644, 872, 198, 16141, 279, 2701, 5248, 5754, 3405, 13, 576, 1537, 1555, 315, 697, 2033, 1265, 387, 315, 279, 2701, 3561, 25, 364, 16141, 25, 400, 20756, 4198, 6, 320, 28996, 17194, 8, 1380, 44428, 374, 825, 315, 19360, 35, 13, 21149, 3019, 553, 3019, 1573, 35764, 382, 1654, 1035, 1075, 311, 72639, 320, 266, 220, 17, 20, 11616, 19311, 8, 220, 15, 13, 16, 342, 3841, 19238, 39, 8, 18, 304, 220, 16, 15, 15, 9961, 18, 2790, 8123, 13, 3555, 374, 279, 8028, 8123, 320, 6226, 18, 8, 315, 264, 220, 15, 13, 16, 386, 1615, 674, 5971, 3746, 13621, 429, 374, 4362, 311, 10549, 279, 6291, 323, 1128, 374, 279, 36043, 315, 279, 12942, 6291, 1939, 32, 8, 36043, 220, 19, 13, 24, 19, 26, 220, 17, 15, 13, 19, 15, 9961, 18, 198, 33, 8, 36043, 220, 18, 13, 16, 21, 26, 220, 18, 17, 13, 16, 19, 9961, 18, 198, 34, 8, 36043, 220, 17, 13, 15, 19, 26, 220, 17, 23, 13, 15, 20, 9961, 18, 198, 35, 8, 36043, 220, 17, 13, 21, 24, 26, 220, 18, 15, 13, 15, 24, 9961, 18, 151645, 198, 151644, 77091, 198]",,217,692,909,0.0,0.0
70c1a56a-7084-46b7-9c70-49a06b974010,7,84,"[151643, 151643, 151643, 151643, 151643, 151643, 151643, 151643, 151643, 151643, 151643, 151643, 151643, 151643, 151643, 151643, 151643, 151643, 151643, 151643, 151643, 151643, 151643, 151643, 151643, 151643, 151643, 151643, 151643, 151643, 151643, 151643, 151643, 151643, 151643, 151643, 151643, 151643, 151643, 151643, 151643, 151643, 151643, 151643, 151643, 151643, 151643, 151643, 151643, 151643, 151643, 151643, 151643, 151643, 151643, 151643, 151643, 151643, 151643, 151643, 151643, 151643, 151643, 151643, 151643, 151643, 151643, 151643, 151643, 151643, 151643, 151643, 151643, 151643, 151643, 151643, 151643, 151643, 151643, 151643, 151643, 151643, 151643, 151643, 151643, 151643, 151643, 151643, 151643, 151643, 151643, 151643, 151643, 151643, 151643, 151643, 151643, 151643, 151643, 151643, 151643, 151643, 151643, 151643, 151643, 151643, 151643, 151643, 151643, 151643, 151643, 151643, 151643, 151643, 151643, 151643, 151643, 151643, 151643, 151643, 151643, 151643, 151643, 151643, 151643, 151643, 151643, 151643, 151643, 151643, 151643, 151643, 151643, 151643, 151643, 151643, 151643, 151643, 151643, 151643, 151643, 151643, 151643, 151643, 151643, 151643, 151643, 151643, 151643, 151643, 151643, 151643, 151643, 151643, 151643, 151643, 151643, 151643, 151643, 151643, 151643, 151643, 151643, 151643, 151643, 151643, 151643, 151643, 151643, 151643, 151643, 151643, 151643, 151643, 151643, 151643, 151643, 151643, 151643, 151643, 151643, 151643, 151643, 151643, 151643, 151643, 151643, 151643, 151643, 151643, 151643, 151643, 151643, 151643, 151643, 151643, 151643, 151643, 151643, 151643, 151643, 151643, 151643, 151643, 151643, 151643, 151643, 151643, 151643, 151643, 151643, 151643, 151643, 151643, 151643, 151643, 151643, 151643, 151643, 151643, 151643, 151643, 151643, 151643, 151643, 151643, 151643, 151643, 151643, 151643, 151643, 151643, 151643, 151643, 151643, 151643, 151643, 151643, 151643, 151643, 151643, 151643, 151643, 151643, 151643, 151643, 151643, 151643, 151643, 151643, 151643, 151643, 151643, 151643, 151643, 151643, 151643, 151643, 151643, 151643, 151643, 151643, 151643, 151643, 151643, 151643, 151643, 151643, 151643, 151643, 151643, 151643, 151643, 151643, 151643, 151643, 151643, 151643, 151643, 151643, 151643, 151643, 151643, 151643, 151643, 151643, 151643, 151643, 151643, 151643, 151643, 151643, 151643, 151643, 151643, 151643, 151643, 151643, 151643, 151643, 151643, 151643, 151643, 151643, 151643, 151643, 151643, 151643, 151643, 151643, 151643, 151643, 151643, 151643, 151643, 151643, 151643, 151643, 151643, 151643, 151643, 151643, 151643, 151643, 151643, 151643, 151643, 151643, 151643, 151643, 151643, 151643, 151643, 151643, 151643, 151643, 151643, 151643, 151643, 151643, 151643, 151643, 151643, 151643, 151643, 151643, 151643, 151643, 151643, 151643, 151643, 151643, 151643, 151643, 151643, 151643, 151643, 151643, 151643, 151643, 151643, 151643, 151643, 151643, 151643, 151643, 151643, 151643, 151643, 151643, 151643, 151643, 151643, 151643, 151643, 151643, 151643, 151643, 151643, 151643, 151643, 151643, 151643, 151643, 151643, 151643, 151643, 151643, 151643, 151643, 151643, 151643, 151643, 151643, 151643, 151643, 151643, 151643, 151643, 151643, 151643, 151643, 151643, 151643, 151643, 151643, 151643, 151643, 151643, 151643, 151643, 151643, 151643, 151643, 151643, 151643, 151643, 151643, 151643, 151643, 151643, 151643, 151643, 151643, 151643, 151643, 151643, 151643, 151643, 151643, 151643, 151643, 151643, 151643, 151643, 151643, 151643, 151643, 151643, 151643, 151643, 151643, 151643, 151643, 151643, 151643, 151643, 151643, 151643, 151643, 151643, 151643, 151643, 151643, 151643, 151643, 151643, 151643, 151643, 151643, 151643, 151643, 151643, 151643, 151643, 151643, 151643, 151643, 151643, 151643, 151643, 151643, 151643, 151643, 151643, 151643, 151643, 151643, 151643, 151643, 151643, 151643, 151643, 151643, 151643, 151643, 151643, 151643, 151643, 151643, 151643, 151643, 151643, 151643, 151643, 151643, 151643, 151643, 151643, 151643, 151643, 151643, 151643, 151643, 151643, 151643, 151643, 151643, 151643, 151643, 151643, 151643, 151643, 151643, 151643, 151643, 151643, 151643, 151643, 151643, 151643, 151643, 151643, 151643, 151643, 151643, 151643, 151643, 151643, 151643, 151643, 151643, 151643, 151643, 151643, 151643, 151643, 151643, 151643, 151643, 151643, 151643, 151643, 151643, 151643, 151643, 151643, 151643, 151643, 151643, 151643, 151643, 151643, 151643, 151643, 151643, 151643, 151643, 151643, 151643, 151643, 151643, 151643, 151643, 151643, 151643, 151643, 151643, 151643, 151643, 151643, 151643, 151643, 151643, 151643, 151643, 151643, 151643, 151643, 151643, 151643, 151643, 151643, 151643, 151643, 151643, 151643, 151643, 151643, 151643, 151643, 151643, 151643, 151643, 151643, 151643, 151643, 151643, 151643, 151643, 151643, 151643, 151643, 151643, 151643, 151643, 151643, 151643, 151643, 151643, 151643, 151643, 151643, 151643, 151643, 151643, 151643, 151643, 151643, 151643, 151643, 151643, 151643, 151643, 151643, 151643, 151643, 151643, 151643, 151643, 151643, 151643, 151643, 151643, 151643, 151643, 151643, 151643, 151643, 151643, 151643, 151643, 151643, 151643, 151643, 151643, 151643, 151643, 151643, 151643, 151643, 151643, 151643, 151643, 151643, 151643, 151643, 151643, 151643, 151643, 151643, 151643, 151643, 151643, 151643, 151643, 151643, 151643, 151643, 151643, 151643, 151643, 151643, 151643, 151643, 151644, 8948, 198, 2610, 525, 1207, 16948, 11, 3465, 553, 54364, 14817, 13, 1446, 525, 264, 10950, 17847, 13, 151645, 198, 151644, 872, 198, 16141, 279, 2701, 5248, 5754, 3405, 13, 576, 1537, 1555, 315, 697, 2033, 1265, 387, 315, 279, 2701, 3561, 25, 364, 16141, 25, 400, 20756, 4198, 6, 320, 28996, 17194, 8, 1380, 44428, 374, 825, 315, 19360, 35, 13, 21149, 3019, 553, 3019, 1573, 35764, 382, 28301, 1437, 279, 4063, 46, 1985, 315, 279, 2701, 508, 19, 10, 17, 60, 43348, 385, 718, 680, 12720, 624, 17, 11, 20, 1737, 318, 41872, 339, 72, 5127, 1952, 488, 434, 26014, 12, 17, 11, 20, 1737, 6339, 488, 26070, 69726, 23754, 32, 8, 320, 18, 64, 49, 11, 19, 49, 11, 22, 50, 11, 22, 64, 50, 7287, 19, 11, 22, 1737, 318, 41872, 12, 18, 64, 11, 19, 11, 22, 11, 22, 64, 2385, 295, 956, 66129, 12, 19, 11, 22, 12, 747, 410, 815, 285, 674, 16597, 1055, 26014, 12, 16, 11, 18, 1737, 6339, 198, 33, 8, 320, 18, 64, 49, 11, 19, 50, 11, 22, 49, 11, 22, 64, 50, 7287, 19, 11, 22, 1737, 318, 41872, 12, 18, 64, 11, 19, 11, 22, 11, 22, 64, 2385, 295, 956, 66129, 12, 19, 11, 22, 12, 747, 60163, 7964, 12738, 12447, 60, 339, 72, 5127, 1952, 12, 16, 11, 18, 1737, 6339, 198, 34, 8, 320, 18, 64, 49, 11, 19, 49, 11, 22, 50, 11, 22, 64, 50, 7287, 19, 11, 22, 1737, 318, 41872, 12, 18, 64, 11, 19, 11, 22, 11, 22, 64, 2385, 295, 956, 66129, 12, 19, 11, 22, 12, 747, 60163, 7964, 12738, 12447, 60, 339, 72, 5127, 1952, 12, 16, 11, 18, 1737, 6339, 198, 35, 8, 320, 18, 64, 49, 11, 19, 50, 11, 22, 49, 11, 22, 64, 50, 7287, 19, 11, 22, 1737, 318, 41872, 12, 18, 64, 11, 19, 11, 22, 11, 22, 64, 2385, 295, 956, 66129, 12, 19, 11, 22, 12, 747, 410, 815, 285, 674, 16597, 1055, 26014, 12, 16, 11, 18, 1737, 6339, 151645, 198, 151644, 77091, 198]",,349,612,961,0.0,0.0
aab9a2b5-569e-4f8f-b3a2-bb36ff1c7a5b,7,85,"[151643, 151643, 151643, 151643, 151643, 151643, 151643, 151643, 151643, 151643, 151643, 151643, 151643, 151643, 151643, 151643, 151643, 151643, 151643, 151643, 151643, 151643, 151643, 151643, 151643, 151643, 151643, 151643, 151643, 151643, 151643, 151643, 151643, 151643, 151643, 151643, 151643, 151643, 151643, 151643, 151643, 151643, 151643, 151643, 151643, 151643, 151643, 151643, 151643, 151643, 151643, 151643, 151643, 151643, 151643, 151643, 151643, 151643, 151643, 151643, 151643, 151643, 151643, 151643, 151643, 151643, 151643, 151643, 151643, 151643, 151643, 151643, 151643, 151643, 151643, 151643, 151643, 151643, 151643, 151643, 151643, 151643, 151643, 151643, 151643, 151643, 151643, 151643, 151643, 151643, 151643, 151643, 151643, 151643, 151643, 151643, 151643, 151643, 151643, 151643, 151643, 151643, 151643, 151643, 151643, 151643, 151643, 151643, 151643, 151643, 151643, 151643, 151643, 151643, 151643, 151643, 151643, 151643, 151643, 151643, 151643, 151643, 151643, 151643, 151643, 151643, 151643, 151643, 151643, 151643, 151643, 151643, 151643, 151643, 151643, 151643, 151643, 151643, 151643, 151643, 151643, 151643, 151643, 151643, 151643, 151643, 151643, 151643, 151643, 151643, 151643, 151643, 151643, 151643, 151643, 151643, 151643, 151643, 151643, 151643, 151643, 151643, 151643, 151643, 151643, 151643, 151643, 151643, 151643, 151643, 151643, 151643, 151643, 151643, 151643, 151643, 151643, 151643, 151643, 151643, 151643, 151643, 151643, 151643, 151643, 151643, 151643, 151643, 151643, 151643, 151643, 151643, 151643, 151643, 151643, 151643, 151643, 151643, 151643, 151643, 151643, 151643, 151643, 151643, 151643, 151643, 151643, 151643, 151643, 151643, 151643, 151643, 151643, 151643, 151643, 151643, 151643, 151643, 151643, 151643, 151643, 151643, 151643, 151643, 151643, 151643, 151643, 151643, 151643, 151643, 151643, 151643, 151643, 151643, 151643, 151643, 151643, 151643, 151643, 151643, 151643, 151643, 151643, 151643, 151643, 151643, 151643, 151643, 151643, 151643, 151643, 151643, 151643, 151643, 151643, 151643, 151643, 151643, 151643, 151643, 151643, 151643, 151643, 151643, 151643, 151643, 151643, 151643, 151643, 151643, 151643, 151643, 151643, 151643, 151643, 151643, 151643, 151643, 151643, 151643, 151643, 151643, 151643, 151643, 151643, 151643, 151643, 151643, 151643, 151643, 151643, 151643, 151643, 151643, 151643, 151643, 151643, 151643, 151643, 151643, 151643, 151643, 151643, 151643, 151643, 151643, 151643, 151643, 151643, 151643, 151643, 151643, 151643, 151643, 151643, 151643, 151643, 151643, 151643, 151643, 151643, 151643, 151643, 151643, 151643, 151643, 151643, 151643, 151643, 151643, 151643, 151643, 151643, 151643, 151643, 151643, 151643, 151643, 151643, 151643, 151643, 151643, 151643, 151643, 151643, 151643, 151643, 151643, 151643, 151643, 151643, 151643, 151643, 151643, 151643, 151643, 151643, 151643, 151643, 151643, 151643, 151643, 151643, 151643, 151643, 151643, 151643, 151643, 151643, 151643, 151643, 151643, 151643, 151643, 151643, 151643, 151643, 151643, 151643, 151643, 151643, 151643, 151643, 151643, 151643, 151643, 151643, 151643, 151643, 151643, 151643, 151643, 151643, 151643, 151643, 151643, 151643, 151643, 151643, 151643, 151643, 151643, 151643, 151643, 151643, 151643, 151643, 151643, 151643, 151643, 151643, 151643, 151643, 151643, 151643, 151643, 151643, 151643, 151643, 151643, 151643, 151643, 151643, 151643, 151643, 151643, 151643, 151643, 151643, 151643, 151643, 151643, 151643, 151643, 151643, 151643, 151643, 151643, 151643, 151643, 151643, 151643, 151643, 151643, 151643, 151643, 151643, 151643, 151643, 151643, 151643, 151643, 151643, 151643, 151643, 151643, 151643, 151643, 151643, 151643, 151643, 151643, 151643, 151643, 151643, 151643, 151643, 151643, 151643, 151643, 151643, 151643, 151643, 151643, 151643, 151643, 151643, 151643, 151643, 151643, 151643, 151643, 151643, 151643, 151643, 151643, 151643, 151643, 151643, 151643, 151643, 151643, 151643, 151643, 151643, 151643, 151643, 151643, 151643, 151643, 151643, 151643, 151643, 151643, 151643, 151643, 151643, 151643, 151643, 151643, 151643, 151643, 151643, 151643, 151643, 151643, 151643, 151643, 151643, 151643, 151643, 151643, 151643, 151643, 151643, 151643, 151643, 151643, 151643, 151643, 151643, 151643, 151643, 151643, 151643, 151643, 151643, 151643, 151643, 151643, 151643, 151643, 151643, 151643, 151643, 151643, 151643, 151643, 151643, 151643, 151643, 151643, 151643, 151643, 151643, 151643, 151643, 151643, 151643, 151643, 151643, 151643, 151643, 151643, 151643, 151643, 151643, 151643, 151643, 151643, 151643, 151643, 151643, 151643, 151643, 151643, 151643, 151643, 151643, 151643, 151643, 151643, 151643, 151643, 151643, 151643, 151643, 151643, 151643, 151643, 151643, 151643, 151643, 151643, 151643, 151643, 151643, 151643, 151643, 151643, 151643, 151643, 151643, 151643, 151643, 151643, 151643, 151643, 151643, 151643, 151643, 151643, 151643, 151643, 151643, 151643, 151643, 151643, 151643, 151643, 151643, 151643, 151643, 151643, 151643, 151643, 151643, 151643, 151643, 151643, 151643, 151643, 151643, 151643, 151643, 151643, 151643, 151643, 151643, 151643, 151643, 151643, 151643, 151643, 151643, 151643, 151643, 151643, 151643, 151643, 151643, 151643, 151643, 151643, 151643, 151643, 151643, 151643, 151643, 151643, 151643, 151643, 151643, 151643, 151643, 151643, 151643, 151643, 151643, 151643, 151643, 151643, 151643, 151643, 151643, 151643, 151643, 151643, 151643, 151643, 151643, 151643, 151643, 151643, 151643, 151643, 151643, 151643, 151643, 151643, 151643, 151643, 151643, 151643, 151643, 151643, 151643, 151643, 151643, 151643, 151643, 151643, 151643, 151643, 151643, 151643, 151643, 151643, 151643, 151643, 151643, 151643, 151643, 151643, 151643, 151643, 151643, 151643, 151643, 151643, 151643, 151643, 151643, 151643, 151643, 151643, 151643, 151643, 151643, 151643, 151643, 151643, 151643, 151643, 151643, 151643, 151643, 151643, 151643, 151643, 151643, 151643, 151643, 151643, 151643, 151643, 151643, 151643, 151643, 151643, 151643, 151643, 151643, 151643, 151643, 151643, 151643, 151643, 151643, 151643, 151643, 151643, 151643, 151643, 151643, 151643, 151643, 151643, 151643, 151643, 151643, 151643, 151643, 151643, 151643, 151643, 151643, 151643, 151643, 151643, 151643, 151643, 151643, 151643, 151643, 151643, 151643, 151643, 151643, 151643, 151643, 151643, 151643, 151643, 151643, 151643, 151643, 151643, 151643, 151643, 151643, 151643, 151643, 151643, 151643, 151643, 151643, 151643, 151643, 151643, 151643, 151643, 151643, 151643, 151643, 151643, 151643, 151643, 151643, 151643, 151643, 151643, 151643, 151643, 151643, 151643, 151643, 151643, 151643, 151643, 151643, 151643, 151643, 151643, 151643, 151643, 151643, 151643, 151643, 151643, 151643, 151643, 151643, 151643, 151643, 151643, 151643, 151643, 151643, 151643, 151643, 151643, 151643, 151643, 151643, 151643, 151643, 151643, 151644, 8948, 198, 2610, 525, 1207, 16948, 11, 3465, 553, 54364, 14817, 13, 1446, 525, 264, 10950, 17847, 13, 151645, 198, 151644, 872, 198, 16141, 279, 2701, 5248, 5754, 3405, 13, 576, 1537, 1555, 315, 697, 2033, 1265, 387, 315, 279, 2701, 3561, 25, 364, 16141, 25, 400, 20756, 4198, 6, 320, 28996, 17194, 8, 1380, 44428, 374, 825, 315, 19360, 35, 13, 21149, 3019, 553, 3019, 1573, 35764, 382, 37175, 419, 2935, 91241, 1882, 271, 40241, 41715, 2257, 90, 79, 11035, 19491, 17, 32, 47822, 10, 92, 10, 17, 32, 87210, 31716, 271, 785, 3196, 48789, 777, 374, 13970, 7218, 323, 400, 76, 15159, 32, 92, 66, 47822, 17, 51185, 18, 15, 15, 7823, 53, 3, 382, 3838, 374, 279, 15435, 315, 18790, 362, 1939, 32, 8, 220, 15, 13, 24, 16, 66, 198, 33, 8, 220, 15, 13, 23, 21, 66, 198, 34, 8, 220, 15, 13, 22, 22, 66, 198, 35, 8, 220, 15, 13, 24, 21, 66, 151645, 198, 151644, 77091, 198]",,166,1054,1220,0.0,0.0
5acdcd0c-ac4d-4289-8588-94a297831826,7,86,"[151643, 151643, 151643, 151643, 151643, 151643, 151643, 151643, 151643, 151643, 151643, 151643, 151643, 151643, 151643, 151643, 151643, 151643, 151643, 151643, 151643, 151643, 151643, 151643, 151643, 151643, 151643, 151643, 151643, 151643, 151643, 151643, 151643, 151643, 151643, 151643, 151643, 151643, 151643, 151643, 151643, 151643, 151643, 151643, 151643, 151643, 151643, 151643, 151643, 151643, 151643, 151643, 151643, 151643, 151643, 151643, 151643, 151643, 151643, 151643, 151643, 151643, 151643, 151643, 151643, 151643, 151643, 151643, 151643, 151643, 151643, 151643, 151643, 151643, 151643, 151643, 151643, 151643, 151643, 151643, 151643, 151643, 151643, 151643, 151643, 151643, 151643, 151643, 151643, 151643, 151643, 151643, 151643, 151643, 151643, 151643, 151643, 151643, 151643, 151643, 151643, 151643, 151643, 151643, 151643, 151643, 151643, 151643, 151643, 151643, 151643, 151643, 151643, 151643, 151643, 151643, 151643, 151643, 151643, 151643, 151643, 151643, 151643, 151643, 151643, 151643, 151643, 151643, 151643, 151643, 151643, 151643, 151643, 151643, 151643, 151643, 151643, 151643, 151643, 151643, 151643, 151643, 151643, 151643, 151643, 151643, 151643, 151643, 151643, 151643, 151643, 151643, 151643, 151643, 151643, 151643, 151643, 151643, 151643, 151643, 151643, 151643, 151643, 151643, 151643, 151643, 151643, 151643, 151643, 151643, 151643, 151643, 151643, 151643, 151643, 151643, 151643, 151643, 151643, 151643, 151643, 151643, 151643, 151643, 151643, 151643, 151643, 151643, 151643, 151643, 151643, 151643, 151643, 151643, 151643, 151643, 151643, 151643, 151643, 151643, 151643, 151643, 151643, 151643, 151643, 151643, 151643, 151643, 151643, 151643, 151643, 151643, 151643, 151643, 151643, 151643, 151643, 151643, 151643, 151643, 151643, 151643, 151643, 151643, 151643, 151643, 151643, 151643, 151643, 151643, 151643, 151643, 151643, 151643, 151643, 151643, 151643, 151643, 151643, 151643, 151643, 151643, 151643, 151643, 151643, 151643, 151643, 151643, 151643, 151643, 151643, 151643, 151643, 151643, 151643, 151643, 151643, 151643, 151643, 151643, 151643, 151643, 151643, 151643, 151643, 151643, 151643, 151643, 151643, 151643, 151643, 151643, 151643, 151643, 151643, 151643, 151643, 151643, 151643, 151643, 151643, 151643, 151643, 151643, 151643, 151643, 151643, 151643, 151643, 151643, 151643, 151643, 151643, 151643, 151643, 151643, 151643, 151643, 151643, 151643, 151643, 151643, 151643, 151643, 151643, 151643, 151643, 151643, 151643, 151643, 151643, 151643, 151643, 151643, 151643, 151643, 151643, 151643, 151643, 151643, 151643, 151643, 151643, 151643, 151643, 151643, 151643, 151643, 151643, 151643, 151643, 151643, 151643, 151643, 151643, 151643, 151643, 151643, 151643, 151643, 151643, 151643, 151643, 151643, 151643, 151643, 151643, 151643, 151643, 151643, 151643, 151643, 151643, 151643, 151643, 151643, 151643, 151643, 151643, 151643, 151643, 151643, 151643, 151643, 151643, 151643, 151643, 151643, 151643, 151643, 151643, 151643, 151643, 151643, 151643, 151643, 151643, 151643, 151643, 151643, 151643, 151643, 151643, 151643, 151643, 151643, 151643, 151643, 151643, 151643, 151643, 151643, 151643, 151643, 151643, 151643, 151643, 151643, 151643, 151643, 151643, 151643, 151643, 151643, 151643, 151643, 151643, 151643, 151643, 151643, 151643, 151643, 151643, 151643, 151643, 151643, 151643, 151643, 151643, 151643, 151643, 151643, 151643, 151643, 151643, 151643, 151643, 151643, 151643, 151643, 151643, 151643, 151643, 151643, 151643, 151643, 151643, 151643, 151643, 151643, 151643, 151643, 151643, 151643, 151643, 151643, 151643, 151643, 151643, 151643, 151643, 151643, 151643, 151643, 151643, 151643, 151643, 151643, 151643, 151643, 151643, 151643, 151643, 151643, 151643, 151643, 151643, 151643, 151643, 151643, 151643, 151643, 151643, 151643, 151643, 151643, 151643, 151643, 151643, 151643, 151643, 151643, 151643, 151643, 151643, 151643, 151643, 151643, 151643, 151643, 151643, 151643, 151643, 151643, 151643, 151643, 151643, 151643, 151643, 151643, 151643, 151643, 151643, 151643, 151643, 151643, 151643, 151643, 151643, 151643, 151643, 151643, 151643, 151643, 151643, 151643, 151643, 151643, 151643, 151643, 151643, 151643, 151643, 151643, 151643, 151643, 151643, 151643, 151643, 151643, 151643, 151643, 151643, 151643, 151643, 151643, 151643, 151643, 151643, 151643, 151643, 151643, 151643, 151643, 151643, 151643, 151643, 151643, 151643, 151643, 151643, 151643, 151643, 151643, 151643, 151643, 151643, 151643, 151643, 151643, 151643, 151643, 151643, 151643, 151643, 151643, 151643, 151643, 151643, 151643, 151643, 151643, 151643, 151643, 151643, 151643, 151643, 151643, 151643, 151643, 151643, 151643, 151643, 151643, 151643, 151643, 151643, 151643, 151643, 151643, 151643, 151643, 151643, 151643, 151643, 151643, 151643, 151643, 151643, 151643, 151643, 151643, 151643, 151643, 151643, 151643, 151643, 151643, 151643, 151643, 151643, 151643, 151643, 151643, 151643, 151643, 151643, 151643, 151643, 151643, 151643, 151643, 151643, 151643, 151643, 151643, 151643, 151643, 151643, 151643, 151643, 151643, 151643, 151643, 151643, 151643, 151643, 151643, 151643, 151643, 151643, 151643, 151643, 151643, 151643, 151643, 151643, 151643, 151643, 151643, 151643, 151643, 151643, 151643, 151643, 151643, 151643, 151643, 151643, 151643, 151643, 151643, 151643, 151643, 151643, 151643, 151643, 151643, 151643, 151643, 151643, 151643, 151643, 151643, 151643, 151643, 151643, 151643, 151643, 151643, 151643, 151643, 151643, 151643, 151643, 151643, 151643, 151643, 151643, 151643, 151643, 151643, 151643, 151643, 151643, 151643, 151643, 151643, 151643, 151643, 151643, 151643, 151643, 151643, 151643, 151643, 151643, 151643, 151643, 151643, 151643, 151643, 151643, 151643, 151643, 151643, 151643, 151643, 151643, 151643, 151643, 151643, 151643, 151643, 151643, 151643, 151643, 151643, 151643, 151643, 151643, 151643, 151643, 151643, 151643, 151643, 151643, 151643, 151643, 151643, 151643, 151643, 151643, 151643, 151643, 151643, 151643, 151643, 151643, 151643, 151643, 151643, 151643, 151643, 151643, 151643, 151643, 151643, 151643, 151643, 151643, 151643, 151643, 151643, 151643, 151643, 151643, 151643, 151643, 151643, 151643, 151644, 8948, 198, 2610, 525, 1207, 16948, 11, 3465, 553, 54364, 14817, 13, 1446, 525, 264, 10950, 17847, 13, 151645, 198, 151644, 872, 198, 16141, 279, 2701, 5248, 5754, 3405, 13, 576, 1537, 1555, 315, 697, 2033, 1265, 387, 315, 279, 2701, 3561, 25, 364, 16141, 25, 400, 20756, 4198, 6, 320, 28996, 17194, 8, 1380, 44428, 374, 825, 315, 19360, 35, 13, 21149, 3019, 553, 3019, 1573, 35764, 382, 43134, 362, 320, 34, 18, 39, 21, 8, 36671, 288, 93471, 2554, 304, 279, 9362, 315, 12499, 259, 17366, 610, 9566, 577, 311, 1352, 23628, 425, 13, 3197, 23628, 425, 68845, 448, 55361, 37512, 39, 11, 432, 7586, 23628, 356, 13, 76292, 23628, 356, 1526, 264, 2518, 59447, 11001, 13705, 18644, 23628, 422, 13, 61572, 422, 68845, 448, 264, 20980, 315, 1378, 3746, 32869, 311, 1352, 23628, 468, 13, 61572, 468, 11, 304, 279, 9362, 315, 11001, 20843, 323, 16643, 71867, 292, 13621, 11, 7586, 23628, 434, 13, 61572, 434, 68845, 448, 24691, 26522, 13621, 311, 1352, 479, 13, 3197, 479, 68845, 448, 38595, 16643, 87, 577, 11, 432, 7586, 472, 13, 64547, 279, 15114, 5114, 911, 279, 3871, 12180, 304, 419, 12720, 8500, 382, 32, 8, 356, 374, 264, 1320, 99110, 6819, 624, 33, 8, 472, 6696, 264, 13753, 1894, 448, 279, 5256, 315, 57039, 292, 81782, 6291, 624, 34, 8, 422, 6696, 1378, 7780, 9942, 304, 279, 220, 16, 39, 451, 18446, 62597, 624, 35, 8, 434, 374, 1483, 369, 279, 38875, 315, 294, 9693, 13, 151645, 198, 151644, 77091, 198]",,253,571,824,1.0,1.0
c0f308b9-4913-4dd6-8dd6-aecf4cdb0727,7,87,"[151643, 151643, 151643, 151643, 151643, 151643, 151643, 151643, 151643, 151643, 151643, 151643, 151643, 151643, 151643, 151643, 151643, 151643, 151643, 151643, 151643, 151643, 151643, 151643, 151643, 151643, 151643, 151643, 151643, 151643, 151643, 151643, 151643, 151643, 151643, 151643, 151643, 151643, 151643, 151643, 151643, 151643, 151643, 151643, 151643, 151643, 151643, 151643, 151643, 151643, 151643, 151643, 151643, 151643, 151643, 151643, 151643, 151643, 151643, 151643, 151643, 151643, 151643, 151643, 151643, 151643, 151643, 151643, 151643, 151643, 151643, 151643, 151643, 151643, 151643, 151643, 151643, 151643, 151643, 151643, 151643, 151643, 151643, 151643, 151643, 151643, 151643, 151643, 151643, 151643, 151643, 151643, 151643, 151643, 151643, 151643, 151643, 151643, 151643, 151643, 151643, 151643, 151643, 151643, 151643, 151643, 151643, 151643, 151643, 151643, 151643, 151643, 151643, 151643, 151643, 151643, 151643, 151643, 151643, 151643, 151643, 151643, 151643, 151643, 151643, 151643, 151643, 151643, 151643, 151643, 151643, 151643, 151643, 151643, 151643, 151643, 151643, 151643, 151643, 151643, 151643, 151643, 151643, 151643, 151643, 151643, 151643, 151643, 151643, 151643, 151643, 151643, 151643, 151643, 151643, 151643, 151643, 151643, 151643, 151643, 151643, 151643, 151643, 151643, 151643, 151643, 151643, 151643, 151643, 151643, 151643, 151643, 151643, 151643, 151643, 151643, 151643, 151643, 151643, 151643, 151643, 151643, 151643, 151643, 151643, 151643, 151643, 151643, 151643, 151643, 151643, 151643, 151643, 151643, 151643, 151643, 151643, 151643, 151643, 151643, 151643, 151643, 151643, 151643, 151643, 151643, 151643, 151643, 151643, 151643, 151643, 151643, 151643, 151643, 151643, 151643, 151643, 151643, 151643, 151643, 151643, 151643, 151643, 151643, 151643, 151643, 151643, 151643, 151643, 151643, 151643, 151643, 151643, 151643, 151643, 151643, 151643, 151643, 151643, 151643, 151643, 151643, 151643, 151643, 151643, 151643, 151643, 151643, 151643, 151643, 151643, 151643, 151643, 151643, 151643, 151643, 151643, 151643, 151643, 151643, 151643, 151643, 151643, 151643, 151643, 151643, 151643, 151643, 151643, 151643, 151643, 151643, 151643, 151643, 151643, 151643, 151643, 151643, 151643, 151643, 151643, 151643, 151643, 151643, 151643, 151643, 151643, 151643, 151643, 151643, 151643, 151643, 151643, 151643, 151643, 151643, 151643, 151643, 151643, 151643, 151643, 151643, 151643, 151643, 151643, 151643, 151643, 151643, 151643, 151643, 151643, 151643, 151643, 151643, 151643, 151643, 151643, 151643, 151643, 151643, 151643, 151643, 151643, 151643, 151643, 151643, 151643, 151643, 151643, 151643, 151643, 151643, 151643, 151643, 151643, 151643, 151643, 151643, 151643, 151643, 151643, 151643, 151643, 151643, 151643, 151643, 151643, 151643, 151643, 151643, 151643, 151643, 151643, 151643, 151643, 151643, 151643, 151643, 151643, 151643, 151643, 151643, 151643, 151643, 151643, 151643, 151643, 151643, 151643, 151643, 151643, 151643, 151643, 151643, 151643, 151643, 151643, 151643, 151643, 151643, 151643, 151643, 151643, 151643, 151643, 151643, 151643, 151643, 151643, 151643, 151643, 151643, 151643, 151643, 151643, 151643, 151643, 151643, 151643, 151643, 151643, 151643, 151643, 151643, 151643, 151643, 151643, 151643, 151643, 151643, 151643, 151643, 151643, 151643, 151643, 151643, 151643, 151643, 151643, 151643, 151643, 151643, 151643, 151643, 151643, 151643, 151643, 151643, 151643, 151643, 151643, 151643, 151643, 151643, 151643, 151643, 151643, 151643, 151643, 151643, 151643, 151643, 151643, 151643, 151643, 151643, 151643, 151643, 151643, 151643, 151643, 151643, 151643, 151643, 151643, 151643, 151643, 151643, 151643, 151643, 151643, 151643, 151643, 151643, 151643, 151643, 151643, 151643, 151643, 151643, 151643, 151643, 151643, 151643, 151643, 151643, 151643, 151643, 151643, 151643, 151643, 151643, 151643, 151643, 151643, 151643, 151643, 151643, 151643, 151643, 151643, 151643, 151643, 151643, 151643, 151643, 151643, 151643, 151643, 151643, 151643, 151643, 151643, 151643, 151643, 151643, 151643, 151643, 151643, 151643, 151643, 151643, 151643, 151643, 151643, 151643, 151643, 151643, 151643, 151643, 151643, 151643, 151643, 151643, 151643, 151643, 151643, 151643, 151643, 151643, 151643, 151643, 151643, 151643, 151643, 151643, 151643, 151643, 151643, 151643, 151643, 151643, 151643, 151643, 151643, 151643, 151643, 151643, 151643, 151643, 151643, 151643, 151643, 151643, 151643, 151643, 151643, 151643, 151643, 151643, 151643, 151643, 151643, 151643, 151643, 151643, 151643, 151643, 151643, 151643, 151643, 151643, 151643, 151643, 151643, 151643, 151643, 151643, 151643, 151643, 151643, 151643, 151643, 151643, 151643, 151643, 151643, 151643, 151643, 151643, 151643, 151643, 151643, 151643, 151643, 151643, 151643, 151643, 151643, 151643, 151643, 151643, 151643, 151643, 151643, 151643, 151643, 151643, 151643, 151643, 151643, 151643, 151643, 151643, 151643, 151643, 151643, 151643, 151643, 151643, 151643, 151643, 151643, 151643, 151643, 151643, 151643, 151643, 151643, 151643, 151643, 151643, 151643, 151643, 151643, 151643, 151643, 151643, 151643, 151643, 151643, 151643, 151643, 151643, 151643, 151643, 151643, 151643, 151643, 151643, 151643, 151643, 151643, 151643, 151643, 151643, 151643, 151643, 151643, 151643, 151643, 151643, 151643, 151643, 151643, 151643, 151643, 151643, 151643, 151643, 151643, 151643, 151643, 151643, 151643, 151643, 151643, 151643, 151643, 151643, 151643, 151643, 151643, 151643, 151643, 151643, 151643, 151643, 151643, 151643, 151643, 151643, 151643, 151643, 151643, 151643, 151643, 151643, 151643, 151643, 151643, 151643, 151643, 151643, 151643, 151643, 151643, 151643, 151643, 151643, 151643, 151643, 151643, 151643, 151643, 151643, 151643, 151643, 151643, 151643, 151643, 151643, 151643, 151643, 151643, 151643, 151643, 151643, 151643, 151643, 151643, 151643, 151643, 151643, 151643, 151643, 151643, 151643, 151643, 151643, 151643, 151643, 151643, 151643, 151643, 151643, 151643, 151643, 151643, 151643, 151643, 151643, 151643, 151643, 151643, 151643, 151643, 151643, 151643, 151643, 151643, 151643, 151643, 151643, 151643, 151643, 151643, 151643, 151643, 151643, 151643, 151643, 151643, 151643, 151643, 151643, 151643, 151643, 151643, 151643, 151643, 151643, 151643, 151643, 151643, 151643, 151643, 151643, 151643, 151643, 151643, 151643, 151643, 151643, 151643, 151643, 151643, 151643, 151643, 151643, 151643, 151643, 151643, 151643, 151643, 151643, 151643, 151643, 151643, 151643, 151643, 151643, 151643, 151643, 151643, 151643, 151643, 151643, 151643, 151643, 151643, 151643, 151643, 151643, 151643, 151643, 151643, 151643, 151643, 151643, 151643, 151643, 151643, 151643, 151643, 151643, 151643, 151643, 151643, 151643, 151643, 151643, 151644, 8948, 198, 2610, 525, 1207, 16948, 11, 3465, 553, 54364, 14817, 13, 1446, 525, 264, 10950, 17847, 13, 151645, 198, 151644, 872, 198, 16141, 279, 2701, 5248, 5754, 3405, 13, 576, 1537, 1555, 315, 697, 2033, 1265, 387, 315, 279, 2701, 3561, 25, 364, 16141, 25, 400, 20756, 4198, 6, 320, 28996, 17194, 8, 1380, 44428, 374, 825, 315, 19360, 35, 13, 21149, 3019, 553, 3019, 1573, 35764, 382, 3838, 374, 279, 4802, 315, 279, 6512, 19488, 4532, 28101, 44805, 73821, 320, 66973, 1317, 8, 773, 429, 279, 4628, 315, 279, 61507, 1599, 374, 6144, 311, 220, 15, 13, 24, 21, 66, 1939, 95521, 429, 1599, 374, 4512, 438, 14511, 448, 220, 18, 25793, 25610, 382, 5012, 25, 279, 16052, 315, 279, 4802, 374, 518, 220, 16, 68, 12, 19, 382, 32, 8, 220, 17, 18, 13, 15, 21, 24, 4229, 53, 198, 33, 8, 220, 16, 23, 13, 19, 22, 20, 4229, 53, 198, 34, 8, 220, 17, 16, 13, 19, 16, 24, 198, 35, 8, 220, 17, 15, 13, 16, 18, 17, 4229, 53, 151645, 198, 151644, 77091, 198]",,182,904,1086,0.0,0.0
23ba5742-fd0e-4ddc-b3d7-f862f120d694,7,88,"[151643, 151643, 151643, 151643, 151643, 151643, 151643, 151643, 151643, 151643, 151643, 151643, 151643, 151643, 151643, 151643, 151643, 151643, 151643, 151643, 151643, 151643, 151643, 151643, 151643, 151643, 151643, 151643, 151643, 151643, 151643, 151643, 151643, 151643, 151643, 151643, 151643, 151643, 151643, 151643, 151643, 151643, 151643, 151643, 151643, 151643, 151643, 151643, 151643, 151643, 151643, 151643, 151643, 151643, 151643, 151643, 151643, 151643, 151643, 151643, 151643, 151643, 151643, 151643, 151643, 151643, 151643, 151643, 151643, 151643, 151643, 151643, 151643, 151643, 151643, 151643, 151643, 151643, 151643, 151643, 151643, 151643, 151643, 151643, 151643, 151643, 151643, 151643, 151643, 151643, 151643, 151643, 151643, 151643, 151643, 151643, 151643, 151643, 151643, 151643, 151643, 151643, 151643, 151643, 151643, 151643, 151643, 151643, 151643, 151643, 151643, 151643, 151643, 151643, 151643, 151643, 151643, 151643, 151643, 151643, 151643, 151643, 151643, 151643, 151643, 151643, 151643, 151643, 151643, 151643, 151643, 151643, 151643, 151643, 151643, 151643, 151643, 151643, 151643, 151643, 151643, 151643, 151643, 151643, 151643, 151643, 151643, 151643, 151643, 151643, 151643, 151643, 151643, 151643, 151643, 151643, 151643, 151643, 151643, 151643, 151643, 151643, 151643, 151643, 151643, 151643, 151643, 151643, 151643, 151643, 151643, 151643, 151643, 151643, 151643, 151643, 151643, 151643, 151643, 151643, 151643, 151643, 151643, 151643, 151643, 151643, 151643, 151643, 151643, 151643, 151643, 151643, 151643, 151643, 151643, 151643, 151643, 151643, 151643, 151643, 151643, 151643, 151643, 151643, 151643, 151643, 151643, 151643, 151643, 151643, 151643, 151643, 151643, 151643, 151643, 151643, 151643, 151643, 151643, 151643, 151643, 151643, 151643, 151643, 151643, 151643, 151643, 151643, 151643, 151643, 151643, 151643, 151643, 151643, 151643, 151643, 151643, 151643, 151643, 151643, 151643, 151643, 151643, 151643, 151643, 151643, 151643, 151643, 151643, 151643, 151643, 151643, 151643, 151643, 151643, 151643, 151643, 151643, 151643, 151643, 151643, 151643, 151643, 151643, 151643, 151643, 151643, 151643, 151643, 151643, 151643, 151643, 151643, 151643, 151643, 151643, 151643, 151643, 151643, 151643, 151643, 151643, 151643, 151643, 151643, 151643, 151643, 151643, 151643, 151643, 151643, 151643, 151643, 151643, 151643, 151643, 151643, 151643, 151643, 151643, 151643, 151643, 151643, 151643, 151643, 151643, 151643, 151643, 151643, 151643, 151643, 151643, 151643, 151643, 151643, 151643, 151643, 151643, 151643, 151643, 151643, 151643, 151643, 151643, 151643, 151643, 151643, 151643, 151643, 151643, 151643, 151643, 151643, 151643, 151643, 151643, 151643, 151643, 151643, 151643, 151643, 151643, 151643, 151643, 151643, 151643, 151643, 151643, 151643, 151643, 151643, 151643, 151643, 151643, 151643, 151643, 151643, 151643, 151643, 151643, 151643, 151643, 151643, 151643, 151643, 151643, 151643, 151643, 151643, 151643, 151643, 151643, 151643, 151643, 151643, 151643, 151643, 151643, 151643, 151643, 151643, 151643, 151643, 151643, 151643, 151643, 151643, 151643, 151643, 151643, 151643, 151643, 151643, 151643, 151643, 151643, 151643, 151643, 151643, 151643, 151643, 151643, 151643, 151643, 151643, 151643, 151643, 151643, 151643, 151643, 151643, 151643, 151643, 151643, 151643, 151643, 151643, 151643, 151643, 151643, 151643, 151643, 151643, 151643, 151643, 151643, 151643, 151643, 151643, 151643, 151643, 151643, 151643, 151643, 151643, 151643, 151643, 151643, 151643, 151643, 151643, 151643, 151643, 151643, 151643, 151643, 151643, 151643, 151643, 151643, 151643, 151643, 151643, 151643, 151643, 151643, 151643, 151643, 151643, 151643, 151643, 151643, 151643, 151643, 151643, 151643, 151643, 151643, 151643, 151643, 151643, 151643, 151643, 151643, 151643, 151643, 151643, 151643, 151643, 151643, 151643, 151643, 151643, 151643, 151643, 151643, 151643, 151643, 151643, 151643, 151643, 151643, 151643, 151643, 151643, 151643, 151643, 151643, 151643, 151643, 151643, 151643, 151643, 151643, 151643, 151643, 151643, 151643, 151643, 151643, 151643, 151643, 151643, 151643, 151643, 151643, 151643, 151643, 151643, 151643, 151643, 151643, 151643, 151643, 151643, 151643, 151643, 151643, 151643, 151643, 151643, 151643, 151643, 151643, 151643, 151643, 151643, 151643, 151643, 151643, 151643, 151643, 151643, 151643, 151643, 151643, 151643, 151643, 151643, 151643, 151643, 151643, 151643, 151643, 151643, 151643, 151643, 151643, 151643, 151643, 151643, 151643, 151643, 151643, 151643, 151643, 151643, 151643, 151643, 151643, 151643, 151643, 151643, 151643, 151643, 151643, 151643, 151643, 151643, 151643, 151643, 151643, 151643, 151643, 151643, 151643, 151643, 151643, 151643, 151643, 151643, 151643, 151643, 151643, 151643, 151643, 151643, 151643, 151643, 151643, 151643, 151643, 151643, 151643, 151643, 151643, 151643, 151643, 151643, 151643, 151643, 151643, 151643, 151643, 151643, 151643, 151643, 151643, 151643, 151643, 151643, 151643, 151643, 151643, 151643, 151643, 151643, 151643, 151643, 151643, 151643, 151643, 151643, 151643, 151643, 151643, 151643, 151643, 151644, 8948, 198, 2610, 525, 1207, 16948, 11, 3465, 553, 54364, 14817, 13, 1446, 525, 264, 10950, 17847, 13, 151645, 198, 151644, 872, 198, 16141, 279, 2701, 5248, 5754, 3405, 13, 576, 1537, 1555, 315, 697, 2033, 1265, 387, 315, 279, 2701, 3561, 25, 364, 16141, 25, 400, 20756, 4198, 6, 320, 28996, 17194, 8, 1380, 44428, 374, 825, 315, 19360, 35, 13, 21149, 3019, 553, 3019, 1573, 35764, 382, 2610, 614, 10030, 458, 9788, 23628, 13, 2014, 10542, 279, 1985, 11, 498, 614, 1483, 279, 2701, 3668, 7923, 12538, 25, 23301, 2801, 323, 220, 16, 39, 451, 18446, 13, 576, 23301, 2801, 19745, 4933, 264, 1602, 7205, 43125, 16162, 518, 220, 18, 15, 15, 15, 289, 5276, 372, 1902, 13, 362, 3746, 43125, 16162, 374, 1083, 13166, 518, 220, 16, 22, 15, 15, 289, 5276, 372, 1902, 13, 25694, 38935, 1033, 13166, 304, 279, 220, 16, 39, 451, 18446, 19745, 11, 6857, 315, 892, 525, 7866, 311, 33449, 2832, 67007, 58305, 13, 3776, 315, 279, 17289, 304, 279, 220, 16, 39, 451, 18446, 374, 264, 1990, 83, 315, 23725, 2576, 315, 40276, 1415, 23856, 264, 2155, 8286, 374, 264, 1990, 83, 315, 23725, 2576, 315, 23725, 2576, 13, 64547, 279, 23628, 438, 2987, 11, 6826, 18, 2149, 17, 34, 10896, 2376, 2149, 18, 8, 34, 10896, 2376, 2149, 18, 8, 8281, 46761, 11, 6826, 18, 2149, 17, 34, 10896, 2376, 34, 17, 39, 20, 8, 34, 10896, 2376, 34, 17, 39, 20, 8, 8281, 46761, 11, 6826, 18, 34, 10896, 2376, 2149, 18, 8, 34, 10896, 2376, 2149, 18, 8, 2149, 17, 8281, 46761, 11, 476, 6826, 18, 34, 10896, 2376, 34, 17, 39, 20, 8, 34, 10896, 2376, 34, 17, 39, 20, 8, 2149, 17, 8281, 46761, 271, 32, 8, 6826, 18, 34, 10896, 2376, 34, 17, 39, 20, 8, 34, 10896, 2376, 34, 17, 39, 20, 8, 2149, 17, 8281, 46761, 198, 33, 8, 6826, 18, 34, 10896, 2376, 2149, 18, 8, 34, 10896, 2376, 2149, 18, 8, 2149, 17, 8281, 46761, 198, 34, 8, 6826, 18, 2149, 17, 34, 10896, 2376, 34, 17, 39, 20, 8, 34, 10896, 2376, 34, 17, 39, 20, 8, 8281, 46761, 198, 35, 8, 6826, 18, 2149, 17, 34, 10896, 2376, 2149, 18, 8, 34, 10896, 2376, 2149, 18, 8, 8281, 46761, 151645, 198, 151644, 77091, 198]",,386,541,927,0.0,0.0
7ed66b8c-589e-4351-bd8e-90a1c0d3a759,7,89,"[151643, 151643, 151643, 151643, 151643, 151643, 151643, 151643, 151643, 151643, 151643, 151643, 151643, 151643, 151643, 151643, 151643, 151643, 151643, 151643, 151643, 151643, 151643, 151643, 151643, 151643, 151643, 151643, 151643, 151643, 151643, 151643, 151643, 151643, 151643, 151643, 151643, 151643, 151643, 151643, 151643, 151643, 151643, 151643, 151643, 151643, 151643, 151643, 151643, 151643, 151643, 151643, 151643, 151643, 151643, 151643, 151643, 151643, 151643, 151643, 151643, 151643, 151643, 151643, 151643, 151643, 151643, 151643, 151643, 151643, 151643, 151643, 151643, 151643, 151643, 151643, 151643, 151643, 151643, 151643, 151643, 151643, 151643, 151643, 151643, 151643, 151643, 151643, 151643, 151643, 151643, 151643, 151643, 151643, 151643, 151643, 151643, 151643, 151643, 151643, 151643, 151643, 151643, 151643, 151643, 151643, 151643, 151643, 151643, 151643, 151643, 151643, 151643, 151643, 151643, 151643, 151643, 151643, 151643, 151643, 151643, 151643, 151643, 151643, 151643, 151643, 151643, 151643, 151643, 151643, 151643, 151643, 151643, 151643, 151643, 151643, 151643, 151643, 151643, 151643, 151643, 151643, 151643, 151643, 151643, 151643, 151643, 151643, 151643, 151643, 151643, 151643, 151643, 151643, 151643, 151643, 151643, 151643, 151643, 151643, 151643, 151643, 151643, 151643, 151643, 151643, 151643, 151643, 151643, 151643, 151643, 151643, 151643, 151643, 151643, 151643, 151643, 151643, 151643, 151643, 151643, 151643, 151643, 151643, 151643, 151643, 151643, 151643, 151643, 151643, 151643, 151643, 151643, 151643, 151643, 151643, 151643, 151643, 151643, 151643, 151643, 151643, 151643, 151643, 151643, 151643, 151643, 151643, 151643, 151643, 151643, 151643, 151643, 151643, 151643, 151643, 151643, 151643, 151643, 151643, 151643, 151643, 151643, 151643, 151643, 151643, 151643, 151643, 151643, 151643, 151643, 151643, 151643, 151643, 151643, 151643, 151643, 151643, 151643, 151643, 151643, 151643, 151643, 151643, 151643, 151643, 151643, 151643, 151643, 151643, 151643, 151643, 151643, 151643, 151643, 151643, 151643, 151643, 151643, 151643, 151643, 151643, 151643, 151643, 151643, 151643, 151643, 151643, 151643, 151643, 151643, 151643, 151643, 151643, 151643, 151643, 151643, 151643, 151643, 151643, 151643, 151643, 151643, 151643, 151643, 151643, 151643, 151643, 151643, 151643, 151643, 151643, 151643, 151643, 151643, 151643, 151643, 151643, 151643, 151643, 151643, 151643, 151643, 151643, 151643, 151643, 151643, 151643, 151643, 151643, 151643, 151643, 151643, 151643, 151643, 151643, 151643, 151643, 151643, 151643, 151643, 151643, 151643, 151643, 151643, 151643, 151643, 151643, 151643, 151643, 151643, 151643, 151643, 151643, 151643, 151643, 151643, 151643, 151643, 151643, 151643, 151643, 151643, 151643, 151643, 151643, 151643, 151643, 151643, 151643, 151643, 151643, 151643, 151643, 151643, 151643, 151643, 151643, 151643, 151643, 151643, 151643, 151643, 151643, 151643, 151643, 151643, 151643, 151643, 151643, 151643, 151643, 151643, 151643, 151643, 151643, 151643, 151643, 151643, 151643, 151643, 151643, 151643, 151643, 151643, 151643, 151643, 151643, 151643, 151643, 151643, 151643, 151643, 151643, 151643, 151643, 151643, 151643, 151643, 151643, 151643, 151643, 151643, 151643, 151643, 151643, 151643, 151643, 151643, 151643, 151643, 151643, 151643, 151643, 151643, 151643, 151643, 151643, 151643, 151643, 151643, 151643, 151643, 151643, 151643, 151643, 151643, 151643, 151643, 151643, 151643, 151643, 151643, 151643, 151643, 151643, 151643, 151643, 151643, 151643, 151643, 151643, 151643, 151643, 151643, 151643, 151643, 151643, 151643, 151643, 151643, 151643, 151643, 151643, 151643, 151643, 151643, 151643, 151643, 151643, 151643, 151643, 151643, 151643, 151643, 151643, 151643, 151643, 151643, 151643, 151643, 151643, 151643, 151643, 151643, 151643, 151643, 151643, 151643, 151643, 151643, 151643, 151643, 151643, 151643, 151643, 151643, 151643, 151643, 151643, 151643, 151643, 151643, 151643, 151643, 151643, 151643, 151643, 151643, 151643, 151643, 151643, 151643, 151643, 151643, 151643, 151643, 151643, 151643, 151643, 151643, 151643, 151643, 151643, 151643, 151643, 151643, 151643, 151643, 151643, 151643, 151643, 151643, 151643, 151643, 151643, 151643, 151643, 151643, 151643, 151643, 151643, 151643, 151643, 151643, 151643, 151643, 151643, 151643, 151643, 151643, 151643, 151643, 151643, 151643, 151643, 151643, 151643, 151643, 151643, 151643, 151643, 151643, 151643, 151643, 151643, 151643, 151643, 151643, 151643, 151643, 151643, 151643, 151643, 151643, 151643, 151643, 151643, 151643, 151643, 151643, 151643, 151643, 151643, 151643, 151643, 151643, 151643, 151643, 151643, 151643, 151643, 151643, 151643, 151643, 151643, 151643, 151643, 151643, 151643, 151643, 151643, 151643, 151643, 151643, 151643, 151643, 151643, 151643, 151643, 151643, 151643, 151643, 151643, 151643, 151643, 151643, 151643, 151643, 151643, 151643, 151643, 151643, 151643, 151643, 151643, 151643, 151643, 151643, 151643, 151643, 151643, 151643, 151643, 151643, 151643, 151643, 151643, 151643, 151643, 151643, 151643, 151643, 151643, 151643, 151643, 151643, 151643, 151643, 151643, 151643, 151643, 151643, 151643, 151643, 151643, 151643, 151643, 151643, 151643, 151643, 151643, 151643, 151643, 151643, 151643, 151643, 151643, 151643, 151643, 151643, 151643, 151643, 151643, 151643, 151643, 151643, 151643, 151643, 151643, 151643, 151643, 151643, 151643, 151643, 151643, 151643, 151643, 151643, 151643, 151643, 151643, 151643, 151643, 151643, 151643, 151643, 151643, 151643, 151643, 151643, 151643, 151643, 151643, 151643, 151643, 151643, 151643, 151643, 151643, 151643, 151643, 151643, 151643, 151643, 151643, 151643, 151643, 151643, 151643, 151643, 151643, 151643, 151643, 151643, 151643, 151643, 151643, 151643, 151643, 151643, 151643, 151643, 151643, 151643, 151643, 151643, 151643, 151643, 151643, 151643, 151643, 151643, 151643, 151643, 151643, 151643, 151643, 151643, 151643, 151643, 151643, 151643, 151643, 151643, 151643, 151643, 151643, 151643, 151643, 151643, 151643, 151643, 151643, 151643, 151643, 151643, 151643, 151643, 151643, 151643, 151643, 151643, 151643, 151643, 151643, 151643, 151643, 151643, 151643, 151643, 151643, 151643, 151643, 151643, 151643, 151643, 151643, 151643, 151643, 151643, 151643, 151643, 151643, 151643, 151643, 151643, 151643, 151643, 151643, 151643, 151643, 151643, 151643, 151643, 151643, 151643, 151643, 151643, 151643, 151643, 151643, 151643, 151643, 151643, 151643, 151643, 151643, 151643, 151643, 151643, 151643, 151643, 151643, 151643, 151643, 151643, 151643, 151643, 151643, 151643, 151643, 151643, 151643, 151643, 151643, 151643, 151643, 151643, 151643, 151643, 151643, 151643, 151643, 151643, 151643, 151643, 151643, 151643, 151643, 151643, 151643, 151643, 151643, 151643, 151643, 151644, 8948, 198, 2610, 525, 1207, 16948, 11, 3465, 553, 54364, 14817, 13, 1446, 525, 264, 10950, 17847, 13, 151645, 198, 151644, 872, 198, 16141, 279, 2701, 5248, 5754, 3405, 13, 576, 1537, 1555, 315, 697, 2033, 1265, 387, 315, 279, 2701, 3561, 25, 364, 16141, 25, 400, 20756, 4198, 6, 320, 28996, 17194, 8, 1380, 44428, 374, 825, 315, 19360, 35, 13, 21149, 3019, 553, 3019, 1573, 35764, 382, 785, 20314, 1379, 315, 279, 1538, 34074, 315, 264, 2256, 26331, 533, 3691, 14178, 304, 279, 12261, 315, 264, 33161, 518, 264, 6010, 315, 294, 28, 16, 15, 61, 16, 15, 4715, 4837, 374, 16878, 311, 387, 7851, 116, 28, 16, 15, 49309, 16, 22, 12348, 13, 7379, 279, 1973, 315, 25621, 315, 279, 47502, 315, 279, 3691, 30420, 382, 32, 8, 220, 16, 15, 61, 21, 21, 619, 32854, 198, 33, 8, 220, 16, 15, 61, 20, 24, 619, 32854, 198, 34, 8, 220, 16, 15, 61, 21, 17, 619, 32854, 198, 35, 8, 220, 16, 15, 61, 21, 20, 619, 32854, 151645, 198, 151644, 77091, 198]",,178,810,988,0.0,0.0
87f442e5-e138-4818-9e5c-bb402c093112,7,90,"[151643, 151643, 151643, 151643, 151643, 151643, 151643, 151643, 151643, 151643, 151643, 151643, 151643, 151643, 151643, 151643, 151643, 151643, 151643, 151643, 151643, 151643, 151643, 151643, 151643, 151643, 151643, 151643, 151643, 151643, 151643, 151643, 151643, 151643, 151643, 151643, 151643, 151643, 151643, 151643, 151643, 151643, 151643, 151643, 151643, 151643, 151643, 151643, 151643, 151643, 151643, 151643, 151643, 151643, 151643, 151643, 151643, 151643, 151643, 151643, 151643, 151643, 151643, 151643, 151643, 151643, 151643, 151643, 151643, 151643, 151643, 151643, 151643, 151643, 151643, 151643, 151643, 151643, 151643, 151643, 151643, 151643, 151643, 151643, 151643, 151643, 151643, 151643, 151643, 151643, 151643, 151643, 151643, 151643, 151643, 151643, 151643, 151643, 151643, 151643, 151643, 151643, 151643, 151643, 151643, 151643, 151643, 151643, 151643, 151643, 151643, 151643, 151643, 151643, 151643, 151643, 151643, 151643, 151643, 151643, 151643, 151643, 151643, 151643, 151643, 151643, 151643, 151643, 151643, 151643, 151643, 151643, 151643, 151643, 151643, 151643, 151643, 151643, 151643, 151643, 151643, 151643, 151643, 151643, 151643, 151643, 151643, 151643, 151643, 151643, 151643, 151643, 151643, 151643, 151643, 151643, 151643, 151643, 151643, 151643, 151643, 151643, 151643, 151643, 151643, 151643, 151643, 151643, 151643, 151643, 151643, 151643, 151643, 151643, 151643, 151643, 151643, 151643, 151643, 151643, 151643, 151643, 151643, 151643, 151643, 151643, 151643, 151643, 151643, 151643, 151643, 151643, 151643, 151643, 151643, 151643, 151643, 151643, 151643, 151643, 151643, 151643, 151643, 151643, 151643, 151643, 151643, 151643, 151643, 151643, 151643, 151643, 151643, 151643, 151643, 151643, 151643, 151643, 151643, 151643, 151643, 151643, 151643, 151643, 151643, 151643, 151643, 151643, 151643, 151643, 151643, 151643, 151643, 151643, 151643, 151643, 151643, 151643, 151643, 151643, 151643, 151643, 151643, 151643, 151643, 151643, 151643, 151643, 151643, 151643, 151643, 151643, 151643, 151643, 151643, 151643, 151643, 151643, 151643, 151643, 151643, 151643, 151643, 151643, 151643, 151643, 151643, 151643, 151643, 151643, 151643, 151643, 151643, 151643, 151643, 151643, 151643, 151643, 151643, 151643, 151643, 151643, 151643, 151643, 151643, 151643, 151643, 151643, 151643, 151643, 151643, 151643, 151643, 151643, 151643, 151643, 151643, 151643, 151643, 151643, 151643, 151643, 151643, 151643, 151643, 151643, 151643, 151643, 151643, 151643, 151643, 151643, 151643, 151643, 151643, 151643, 151643, 151643, 151643, 151643, 151643, 151643, 151643, 151643, 151643, 151643, 151643, 151643, 151643, 151643, 151643, 151643, 151643, 151643, 151643, 151643, 151643, 151643, 151643, 151643, 151643, 151643, 151643, 151643, 151643, 151643, 151643, 151643, 151643, 151643, 151643, 151643, 151643, 151643, 151643, 151643, 151643, 151643, 151643, 151643, 151643, 151643, 151643, 151643, 151643, 151643, 151643, 151643, 151643, 151643, 151643, 151643, 151643, 151643, 151643, 151643, 151643, 151643, 151643, 151643, 151643, 151643, 151643, 151643, 151643, 151643, 151643, 151643, 151643, 151643, 151643, 151643, 151643, 151643, 151643, 151643, 151643, 151643, 151643, 151643, 151643, 151643, 151643, 151643, 151643, 151643, 151643, 151643, 151643, 151643, 151643, 151643, 151643, 151643, 151643, 151643, 151643, 151643, 151643, 151643, 151643, 151643, 151643, 151643, 151643, 151643, 151643, 151643, 151643, 151643, 151643, 151643, 151643, 151643, 151643, 151643, 151643, 151643, 151643, 151643, 151643, 151643, 151643, 151643, 151643, 151643, 151643, 151643, 151643, 151643, 151643, 151643, 151643, 151643, 151643, 151643, 151643, 151643, 151643, 151643, 151643, 151643, 151643, 151643, 151643, 151643, 151643, 151643, 151643, 151643, 151643, 151643, 151643, 151643, 151643, 151643, 151643, 151643, 151643, 151643, 151643, 151643, 151643, 151643, 151643, 151643, 151643, 151643, 151643, 151643, 151643, 151643, 151643, 151643, 151643, 151643, 151643, 151643, 151643, 151643, 151643, 151643, 151643, 151643, 151643, 151643, 151643, 151643, 151643, 151643, 151643, 151643, 151643, 151643, 151643, 151643, 151643, 151643, 151643, 151643, 151643, 151643, 151643, 151643, 151643, 151643, 151643, 151643, 151643, 151643, 151643, 151643, 151643, 151643, 151643, 151643, 151643, 151643, 151643, 151643, 151643, 151643, 151643, 151643, 151643, 151643, 151643, 151643, 151643, 151643, 151643, 151643, 151643, 151643, 151643, 151643, 151643, 151643, 151643, 151643, 151643, 151643, 151643, 151643, 151643, 151643, 151643, 151643, 151643, 151643, 151643, 151643, 151643, 151643, 151643, 151643, 151643, 151643, 151643, 151643, 151643, 151643, 151643, 151643, 151643, 151643, 151643, 151643, 151643, 151643, 151643, 151643, 151643, 151643, 151643, 151643, 151643, 151643, 151643, 151643, 151643, 151643, 151643, 151643, 151643, 151643, 151643, 151643, 151643, 151643, 151643, 151643, 151643, 151643, 151643, 151643, 151643, 151643, 151643, 151643, 151643, 151643, 151643, 151643, 151643, 151643, 151643, 151643, 151643, 151643, 151643, 151643, 151643, 151643, 151643, 151643, 151643, 151643, 151643, 151643, 151643, 151643, 151643, 151643, 151643, 151643, 151643, 151643, 151643, 151643, 151643, 151643, 151643, 151643, 151643, 151643, 151643, 151643, 151643, 151643, 151643, 151643, 151643, 151643, 151643, 151643, 151643, 151643, 151643, 151643, 151643, 151643, 151643, 151643, 151643, 151643, 151643, 151643, 151643, 151643, 151643, 151643, 151643, 151643, 151643, 151643, 151643, 151643, 151643, 151643, 151643, 151643, 151643, 151643, 151643, 151643, 151643, 151643, 151643, 151643, 151643, 151643, 151643, 151643, 151644, 8948, 198, 2610, 525, 1207, 16948, 11, 3465, 553, 54364, 14817, 13, 1446, 525, 264, 10950, 17847, 13, 151645, 198, 151644, 872, 198, 16141, 279, 2701, 5248, 5754, 3405, 13, 576, 1537, 1555, 315, 697, 2033, 1265, 387, 315, 279, 2701, 3561, 25, 364, 16141, 25, 400, 20756, 4198, 6, 320, 28996, 17194, 8, 1380, 44428, 374, 825, 315, 19360, 35, 13, 21149, 3019, 553, 3019, 1573, 35764, 382, 11613, 31146, 362, 323, 425, 525, 11758, 25156, 448, 16643, 71867, 292, 13621, 11, 38595, 24691, 1247, 11, 323, 3015, 13, 16904, 279, 9733, 6380, 1378, 2155, 46199, 295, 3154, 525, 8947, 13, 8427, 279, 6169, 5916, 7236, 362, 323, 425, 369, 279, 24473, 624, 32, 488, 320, 16193, 8996, 17, 11, 472, 5066, 11, 472, 17, 46, 8, 69726, 220, 19, 30430, 453, 887, 3923, 66, 3337, 385, 17308, 2145, 12, 16, 11, 17, 1737, 6339, 198, 33, 488, 320, 16193, 8996, 17, 11, 472, 5066, 11, 472, 17, 46, 8, 69726, 220, 20, 1448, 41872, 17308, 2145, 12, 17, 11, 18, 1737, 6339, 271, 32, 8, 362, 284, 220, 19, 30430, 453, 887, 3923, 66, 3337, 385, 17308, 276, 12, 16, 18589, 11, 425, 284, 220, 20, 1448, 41872, 17308, 2145, 12, 17, 11, 18, 1737, 24903, 198, 33, 8, 362, 284, 220, 19, 30430, 453, 887, 3923, 12, 17, 1448, 769, 5131, 3337, 3337, 385, 17308, 276, 12, 16, 12, 337, 11, 425, 284, 220, 20, 1448, 41872, 17308, 276, 12, 17, 18589, 198, 34, 8, 362, 284, 220, 19, 30430, 453, 887, 3923, 66, 3337, 385, 17308, 276, 12, 16, 18589, 11, 425, 284, 220, 20, 1448, 41872, 17308, 276, 12, 17, 18589, 198, 35, 8, 362, 284, 220, 19, 30430, 453, 887, 3923, 12, 17, 1448, 769, 5131, 3337, 3337, 385, 17308, 276, 12, 16, 12, 337, 11, 220, 20, 1448, 41872, 17308, 2145, 12, 17, 11, 18, 1737, 24903, 151645, 198, 151644, 77091, 198]",,320,698,1018,1.0,1.0
990a1e9e-87f9-4d3a-a67c-4d7dce162ae0,7,91,"[151643, 151643, 151643, 151643, 151643, 151643, 151643, 151643, 151643, 151643, 151643, 151643, 151643, 151643, 151643, 151643, 151643, 151643, 151643, 151643, 151643, 151643, 151643, 151643, 151643, 151643, 151643, 151643, 151643, 151643, 151643, 151643, 151643, 151643, 151643, 151643, 151643, 151643, 151643, 151643, 151643, 151643, 151643, 151643, 151643, 151643, 151643, 151643, 151643, 151643, 151643, 151643, 151643, 151643, 151643, 151643, 151643, 151643, 151643, 151643, 151643, 151643, 151643, 151643, 151643, 151643, 151643, 151643, 151643, 151643, 151643, 151643, 151643, 151643, 151643, 151643, 151643, 151643, 151643, 151643, 151643, 151643, 151643, 151643, 151643, 151643, 151643, 151643, 151643, 151643, 151643, 151643, 151643, 151643, 151643, 151643, 151643, 151643, 151643, 151643, 151643, 151643, 151643, 151643, 151643, 151643, 151643, 151643, 151643, 151643, 151643, 151643, 151643, 151643, 151643, 151643, 151643, 151643, 151643, 151643, 151643, 151643, 151643, 151643, 151643, 151643, 151643, 151643, 151643, 151643, 151643, 151643, 151643, 151643, 151643, 151643, 151643, 151643, 151643, 151643, 151643, 151643, 151643, 151643, 151643, 151643, 151643, 151643, 151643, 151643, 151643, 151643, 151643, 151643, 151643, 151643, 151643, 151643, 151643, 151643, 151643, 151643, 151643, 151643, 151643, 151643, 151643, 151643, 151643, 151643, 151643, 151643, 151643, 151643, 151643, 151643, 151643, 151643, 151643, 151643, 151643, 151643, 151643, 151643, 151643, 151643, 151643, 151643, 151643, 151643, 151643, 151643, 151643, 151643, 151643, 151643, 151643, 151643, 151643, 151643, 151643, 151643, 151643, 151643, 151643, 151643, 151643, 151643, 151643, 151643, 151643, 151643, 151643, 151643, 151643, 151643, 151643, 151643, 151643, 151643, 151643, 151643, 151643, 151643, 151643, 151643, 151643, 151643, 151643, 151643, 151643, 151643, 151643, 151643, 151643, 151643, 151643, 151643, 151643, 151643, 151643, 151643, 151643, 151643, 151643, 151643, 151643, 151643, 151643, 151643, 151643, 151643, 151643, 151643, 151643, 151643, 151643, 151643, 151643, 151643, 151643, 151643, 151643, 151643, 151643, 151643, 151643, 151643, 151643, 151643, 151643, 151643, 151643, 151643, 151643, 151643, 151643, 151643, 151643, 151643, 151643, 151643, 151643, 151643, 151643, 151643, 151643, 151643, 151643, 151643, 151643, 151643, 151643, 151643, 151643, 151643, 151643, 151643, 151643, 151643, 151643, 151643, 151643, 151643, 151643, 151643, 151643, 151643, 151643, 151643, 151643, 151643, 151643, 151643, 151643, 151643, 151643, 151643, 151643, 151643, 151643, 151643, 151643, 151643, 151643, 151643, 151643, 151643, 151643, 151643, 151643, 151643, 151643, 151643, 151643, 151643, 151643, 151643, 151643, 151643, 151643, 151643, 151643, 151643, 151643, 151643, 151643, 151643, 151643, 151643, 151643, 151643, 151643, 151643, 151643, 151643, 151643, 151643, 151643, 151643, 151643, 151643, 151643, 151643, 151643, 151643, 151643, 151643, 151643, 151643, 151643, 151643, 151643, 151643, 151643, 151643, 151643, 151643, 151643, 151643, 151643, 151643, 151643, 151643, 151643, 151643, 151643, 151643, 151643, 151643, 151643, 151643, 151643, 151643, 151643, 151643, 151643, 151643, 151643, 151643, 151643, 151643, 151643, 151643, 151643, 151643, 151643, 151643, 151643, 151643, 151643, 151643, 151643, 151643, 151643, 151643, 151643, 151643, 151643, 151643, 151643, 151643, 151643, 151643, 151643, 151643, 151643, 151643, 151643, 151643, 151643, 151643, 151643, 151643, 151643, 151643, 151643, 151643, 151643, 151643, 151643, 151643, 151643, 151643, 151643, 151643, 151643, 151643, 151643, 151643, 151643, 151643, 151643, 151643, 151643, 151643, 151643, 151643, 151643, 151643, 151643, 151643, 151643, 151643, 151643, 151643, 151643, 151643, 151643, 151643, 151643, 151643, 151643, 151643, 151643, 151643, 151643, 151643, 151643, 151643, 151643, 151643, 151643, 151643, 151643, 151643, 151643, 151643, 151643, 151643, 151643, 151643, 151643, 151643, 151643, 151643, 151643, 151643, 151643, 151643, 151643, 151643, 151643, 151643, 151643, 151643, 151643, 151643, 151643, 151643, 151643, 151643, 151643, 151643, 151643, 151643, 151643, 151643, 151643, 151643, 151643, 151643, 151643, 151643, 151643, 151643, 151643, 151643, 151643, 151643, 151643, 151643, 151643, 151643, 151643, 151643, 151643, 151643, 151643, 151643, 151643, 151643, 151643, 151643, 151643, 151643, 151643, 151643, 151643, 151643, 151643, 151643, 151643, 151643, 151643, 151643, 151643, 151643, 151643, 151643, 151643, 151643, 151643, 151643, 151643, 151643, 151643, 151643, 151643, 151643, 151643, 151643, 151643, 151643, 151643, 151643, 151643, 151643, 151643, 151643, 151643, 151643, 151643, 151643, 151643, 151643, 151643, 151643, 151643, 151643, 151643, 151643, 151643, 151643, 151643, 151643, 151643, 151643, 151643, 151643, 151643, 151643, 151643, 151643, 151643, 151643, 151643, 151643, 151643, 151643, 151643, 151643, 151643, 151643, 151643, 151643, 151643, 151643, 151643, 151643, 151643, 151643, 151643, 151643, 151643, 151643, 151643, 151643, 151643, 151643, 151643, 151643, 151643, 151643, 151643, 151643, 151643, 151643, 151643, 151643, 151643, 151643, 151643, 151643, 151643, 151643, 151643, 151643, 151643, 151643, 151643, 151643, 151643, 151643, 151643, 151643, 151643, 151643, 151643, 151643, 151643, 151643, 151643, 151643, 151643, 151643, 151643, 151643, 151643, 151643, 151643, 151643, 151643, 151643, 151643, 151643, 151643, 151643, 151643, 151643, 151643, 151643, 151643, 151643, 151643, 151643, 151643, 151643, 151643, 151643, 151643, 151643, 151643, 151643, 151643, 151643, 151643, 151643, 151643, 151643, 151643, 151643, 151643, 151643, 151643, 151643, 151643, 151643, 151643, 151643, 151643, 151643, 151643, 151643, 151643, 151643, 151643, 151643, 151643, 151643, 151643, 151643, 151643, 151643, 151643, 151643, 151643, 151643, 151643, 151643, 151643, 151643, 151643, 151643, 151643, 151643, 151643, 151643, 151643, 151643, 151643, 151643, 151643, 151643, 151643, 151643, 151643, 151643, 151643, 151643, 151643, 151643, 151643, 151643, 151643, 151643, 151643, 151643, 151643, 151643, 151643, 151643, 151644, 8948, 198, 2610, 525, 1207, 16948, 11, 3465, 553, 54364, 14817, 13, 1446, 525, 264, 10950, 17847, 13, 151645, 198, 151644, 872, 198, 16141, 279, 2701, 5248, 5754, 3405, 13, 576, 1537, 1555, 315, 697, 2033, 1265, 387, 315, 279, 2701, 3561, 25, 364, 16141, 25, 400, 20756, 4198, 6, 320, 28996, 17194, 8, 1380, 44428, 374, 825, 315, 19360, 35, 13, 21149, 3019, 553, 3019, 1573, 35764, 382, 66, 3337, 385, 17308, 276, 603, 374, 11758, 448, 444, 6352, 518, 3347, 9315, 11, 8110, 553, 70946, 278, 85736, 13, 279, 12720, 20980, 374, 1221, 13621, 1870, 11, 29064, 1985, 220, 16, 382, 16, 374, 1221, 11758, 448, 458, 13623, 315, 1853, 41872, 8608, 436, 14308, 324, 89103, 9835, 269, 577, 11, 29064, 1985, 220, 17, 13, 1128, 374, 279, 5944, 315, 462, 7628, 332, 220, 17, 1939, 32, 8, 1781, 50, 7287, 1188, 49, 7287, 17, 11, 17, 1737, 333, 9835, 269, 509, 3337, 385, 17308, 3923, 8, 26164, 269, 316, 41872, 8, 7964, 89, 1952, 198, 33, 8, 320, 17, 49, 7287, 16, 12276, 84, 18307, 12, 17, 12, 1188, 50, 7287, 26164, 18307, 7, 14769, 3923, 46607, 41872, 46986, 3337, 385, 17308, 276, 12, 16, 12, 337, 198, 34, 8, 1781, 49, 7287, 1188, 49, 7287, 17, 11, 17, 1737, 333, 9835, 269, 509, 3337, 385, 17308, 3923, 8, 26164, 269, 316, 41872, 8, 7964, 89, 1952, 198, 35, 8, 320, 50, 7287, 17, 12, 1188, 49, 7287, 26164, 18307, 7, 14769, 3923, 46607, 41872, 46986, 3337, 385, 17308, 276, 12, 16, 18589, 151645, 198, 151644, 77091, 198]",,262,355,617,0.0,0.0
f3684f90-7db9-4ea3-8fc1-b08f87f25467,7,92,"[151643, 151643, 151643, 151643, 151643, 151643, 151643, 151643, 151643, 151643, 151643, 151643, 151643, 151643, 151643, 151643, 151643, 151643, 151643, 151643, 151643, 151643, 151643, 151643, 151643, 151643, 151643, 151643, 151643, 151643, 151643, 151643, 151643, 151643, 151643, 151643, 151643, 151643, 151643, 151643, 151643, 151643, 151643, 151643, 151643, 151643, 151643, 151643, 151643, 151643, 151643, 151643, 151643, 151643, 151643, 151643, 151643, 151643, 151643, 151643, 151643, 151643, 151643, 151643, 151643, 151643, 151643, 151643, 151643, 151643, 151643, 151643, 151643, 151643, 151643, 151643, 151643, 151643, 151643, 151643, 151643, 151643, 151643, 151643, 151643, 151643, 151643, 151643, 151643, 151643, 151643, 151643, 151643, 151643, 151643, 151643, 151643, 151643, 151643, 151643, 151643, 151643, 151643, 151643, 151643, 151643, 151643, 151643, 151643, 151643, 151643, 151643, 151643, 151643, 151643, 151643, 151643, 151643, 151643, 151643, 151643, 151643, 151643, 151643, 151643, 151643, 151643, 151643, 151643, 151643, 151643, 151643, 151643, 151643, 151643, 151643, 151643, 151643, 151643, 151643, 151643, 151643, 151643, 151643, 151643, 151643, 151643, 151643, 151643, 151643, 151643, 151643, 151643, 151643, 151643, 151643, 151643, 151643, 151643, 151643, 151643, 151643, 151643, 151643, 151643, 151643, 151643, 151643, 151643, 151643, 151643, 151643, 151643, 151643, 151643, 151643, 151643, 151643, 151643, 151643, 151643, 151643, 151643, 151643, 151643, 151643, 151643, 151643, 151643, 151643, 151643, 151643, 151643, 151643, 151643, 151643, 151643, 151643, 151643, 151643, 151643, 151643, 151643, 151643, 151643, 151643, 151643, 151643, 151643, 151643, 151643, 151643, 151643, 151643, 151643, 151643, 151643, 151643, 151643, 151643, 151643, 151643, 151643, 151643, 151643, 151643, 151643, 151643, 151643, 151643, 151643, 151643, 151643, 151643, 151643, 151643, 151643, 151643, 151643, 151643, 151643, 151643, 151643, 151643, 151643, 151643, 151643, 151643, 151643, 151643, 151643, 151643, 151643, 151643, 151643, 151643, 151643, 151643, 151643, 151643, 151643, 151643, 151643, 151643, 151643, 151643, 151643, 151643, 151643, 151643, 151643, 151643, 151643, 151643, 151643, 151643, 151643, 151643, 151643, 151643, 151643, 151643, 151643, 151643, 151643, 151643, 151643, 151643, 151643, 151643, 151643, 151643, 151643, 151643, 151643, 151643, 151643, 151643, 151643, 151643, 151643, 151643, 151643, 151643, 151643, 151643, 151643, 151643, 151643, 151643, 151643, 151643, 151643, 151643, 151643, 151643, 151643, 151643, 151643, 151643, 151643, 151643, 151643, 151643, 151643, 151643, 151643, 151643, 151643, 151643, 151643, 151643, 151643, 151643, 151643, 151643, 151643, 151643, 151643, 151643, 151643, 151643, 151643, 151643, 151643, 151643, 151643, 151643, 151643, 151643, 151643, 151643, 151643, 151643, 151643, 151643, 151643, 151643, 151643, 151643, 151643, 151643, 151643, 151643, 151643, 151643, 151643, 151643, 151643, 151643, 151643, 151643, 151643, 151643, 151643, 151643, 151643, 151643, 151643, 151643, 151643, 151643, 151643, 151643, 151643, 151643, 151643, 151643, 151643, 151643, 151643, 151643, 151643, 151643, 151643, 151643, 151643, 151643, 151643, 151643, 151643, 151643, 151643, 151643, 151643, 151643, 151643, 151643, 151643, 151643, 151643, 151643, 151643, 151643, 151643, 151643, 151643, 151643, 151643, 151643, 151643, 151643, 151643, 151643, 151643, 151643, 151643, 151643, 151643, 151643, 151643, 151643, 151643, 151643, 151643, 151643, 151643, 151643, 151643, 151643, 151643, 151643, 151643, 151643, 151643, 151643, 151643, 151643, 151643, 151643, 151643, 151643, 151643, 151643, 151643, 151643, 151643, 151643, 151643, 151643, 151643, 151643, 151643, 151643, 151643, 151643, 151643, 151643, 151643, 151643, 151643, 151643, 151643, 151643, 151643, 151643, 151643, 151643, 151643, 151643, 151643, 151643, 151643, 151643, 151643, 151643, 151643, 151643, 151643, 151643, 151643, 151643, 151643, 151643, 151643, 151643, 151643, 151643, 151643, 151643, 151643, 151643, 151643, 151643, 151643, 151643, 151643, 151643, 151643, 151643, 151643, 151643, 151643, 151643, 151643, 151643, 151643, 151643, 151643, 151643, 151643, 151643, 151643, 151643, 151643, 151643, 151643, 151643, 151643, 151643, 151643, 151643, 151643, 151643, 151643, 151643, 151643, 151643, 151643, 151643, 151643, 151643, 151643, 151643, 151643, 151643, 151643, 151643, 151643, 151643, 151643, 151643, 151643, 151643, 151643, 151643, 151643, 151643, 151643, 151643, 151643, 151643, 151643, 151643, 151643, 151643, 151643, 151643, 151643, 151643, 151643, 151643, 151643, 151643, 151643, 151643, 151643, 151643, 151643, 151643, 151643, 151643, 151643, 151643, 151643, 151643, 151643, 151643, 151643, 151643, 151643, 151643, 151643, 151643, 151643, 151643, 151643, 151643, 151643, 151643, 151643, 151643, 151643, 151643, 151643, 151643, 151643, 151643, 151643, 151643, 151643, 151643, 151643, 151643, 151643, 151643, 151643, 151643, 151643, 151643, 151643, 151643, 151643, 151643, 151643, 151643, 151643, 151643, 151643, 151643, 151643, 151643, 151643, 151643, 151643, 151643, 151643, 151643, 151643, 151643, 151643, 151643, 151643, 151643, 151643, 151643, 151643, 151643, 151643, 151643, 151643, 151643, 151643, 151643, 151643, 151643, 151643, 151643, 151643, 151643, 151643, 151643, 151643, 151643, 151643, 151643, 151643, 151643, 151643, 151643, 151643, 151643, 151643, 151643, 151643, 151643, 151643, 151643, 151643, 151643, 151643, 151643, 151643, 151643, 151643, 151643, 151643, 151643, 151643, 151643, 151643, 151643, 151643, 151643, 151643, 151643, 151643, 151643, 151643, 151643, 151643, 151643, 151643, 151643, 151643, 151643, 151643, 151643, 151643, 151643, 151643, 151643, 151643, 151643, 151643, 151643, 151643, 151643, 151643, 151643, 151643, 151643, 151643, 151643, 151643, 151643, 151643, 151643, 151643, 151643, 151643, 151643, 151643, 151643, 151643, 151643, 151643, 151643, 151643, 151643, 151643, 151643, 151643, 151643, 151643, 151643, 151643, 151643, 151643, 151643, 151643, 151643, 151643, 151643, 151643, 151643, 151643, 151643, 151643, 151643, 151643, 151643, 151643, 151643, 151643, 151643, 151643, 151643, 151643, 151643, 151643, 151643, 151643, 151643, 151643, 151643, 151643, 151643, 151643, 151643, 151643, 151643, 151643, 151643, 151643, 151643, 151643, 151643, 151643, 151643, 151643, 151643, 151643, 151643, 151643, 151643, 151643, 151643, 151643, 151643, 151643, 151643, 151643, 151643, 151643, 151643, 151643, 151643, 151643, 151643, 151643, 151643, 151643, 151643, 151643, 151643, 151643, 151643, 151643, 151643, 151643, 151643, 151643, 151643, 151643, 151643, 151643, 151643, 151643, 151643, 151643, 151643, 151643, 151643, 151643, 151643, 151643, 151643, 151643, 151643, 151643, 151643, 151643, 151643, 151643, 151643, 151643, 151643, 151643, 151643, 151643, 151643, 151643, 151643, 151643, 151643, 151643, 151643, 151643, 151643, 151643, 151644, 8948, 198, 2610, 525, 1207, 16948, 11, 3465, 553, 54364, 14817, 13, 1446, 525, 264, 10950, 17847, 13, 151645, 198, 151644, 872, 198, 16141, 279, 2701, 5248, 5754, 3405, 13, 576, 1537, 1555, 315, 697, 2033, 1265, 387, 315, 279, 2701, 3561, 25, 364, 16141, 25, 400, 20756, 4198, 6, 320, 28996, 17194, 8, 1380, 44428, 374, 825, 315, 19360, 35, 13, 21149, 3019, 553, 3019, 1573, 35764, 382, 35, 24308, 279, 36043, 315, 279, 6291, 315, 220, 20, 15, 15, 64070, 315, 220, 15, 13, 16, 386, 6826, 18, 8281, 46761, 11, 220, 19, 15, 15, 64070, 315, 220, 15, 13, 17, 386, 472, 5066, 11, 323, 220, 18, 15, 15, 64070, 315, 220, 15, 13, 18, 386, 14322, 19238, 39, 8, 17, 382, 32, 8, 220, 16, 13, 18, 23, 198, 33, 8, 220, 23, 13, 24, 17, 198, 34, 8, 220, 16, 17, 13, 21, 17, 198, 35, 8, 220, 23, 13, 21, 23, 151645, 198, 151644, 77091, 198]",,163,620,783,1.0,1.0
e1f1ace5-534a-48c9-8473-3bdff3e8ff68,7,93,"[151643, 151643, 151643, 151643, 151643, 151643, 151643, 151643, 151643, 151643, 151643, 151643, 151643, 151643, 151643, 151643, 151643, 151643, 151643, 151643, 151643, 151643, 151643, 151643, 151643, 151643, 151643, 151643, 151643, 151643, 151643, 151643, 151643, 151643, 151643, 151643, 151643, 151643, 151643, 151643, 151643, 151643, 151643, 151643, 151643, 151643, 151643, 151643, 151643, 151643, 151643, 151643, 151643, 151643, 151643, 151643, 151643, 151643, 151643, 151643, 151643, 151643, 151643, 151643, 151643, 151643, 151643, 151643, 151643, 151643, 151643, 151643, 151643, 151643, 151643, 151643, 151643, 151643, 151643, 151643, 151643, 151643, 151643, 151643, 151643, 151643, 151643, 151643, 151643, 151643, 151643, 151643, 151643, 151643, 151643, 151643, 151643, 151643, 151643, 151643, 151643, 151643, 151643, 151643, 151643, 151643, 151643, 151643, 151643, 151643, 151643, 151643, 151643, 151643, 151643, 151643, 151643, 151643, 151643, 151643, 151643, 151643, 151643, 151643, 151643, 151643, 151643, 151643, 151643, 151643, 151643, 151643, 151643, 151643, 151643, 151643, 151643, 151643, 151643, 151643, 151643, 151643, 151643, 151643, 151643, 151643, 151643, 151643, 151643, 151643, 151643, 151643, 151643, 151643, 151643, 151643, 151643, 151643, 151643, 151643, 151643, 151643, 151643, 151643, 151643, 151643, 151643, 151643, 151643, 151643, 151643, 151643, 151643, 151643, 151643, 151643, 151643, 151643, 151643, 151643, 151643, 151643, 151643, 151643, 151643, 151643, 151643, 151643, 151643, 151643, 151643, 151643, 151643, 151643, 151643, 151643, 151643, 151643, 151643, 151643, 151643, 151643, 151643, 151643, 151643, 151643, 151643, 151643, 151643, 151643, 151643, 151643, 151643, 151643, 151643, 151643, 151643, 151643, 151643, 151643, 151643, 151643, 151643, 151643, 151643, 151643, 151643, 151643, 151643, 151643, 151643, 151643, 151643, 151643, 151643, 151643, 151643, 151643, 151643, 151643, 151643, 151643, 151643, 151643, 151643, 151643, 151643, 151643, 151643, 151643, 151643, 151643, 151643, 151643, 151643, 151643, 151643, 151643, 151643, 151643, 151643, 151643, 151643, 151643, 151643, 151643, 151643, 151643, 151643, 151643, 151643, 151643, 151643, 151643, 151643, 151643, 151643, 151643, 151643, 151643, 151643, 151643, 151643, 151643, 151643, 151643, 151643, 151643, 151643, 151643, 151643, 151643, 151643, 151643, 151643, 151643, 151643, 151643, 151643, 151643, 151643, 151643, 151643, 151643, 151643, 151643, 151643, 151643, 151643, 151643, 151643, 151643, 151643, 151643, 151643, 151643, 151643, 151643, 151643, 151643, 151643, 151643, 151643, 151643, 151643, 151643, 151643, 151643, 151643, 151643, 151643, 151643, 151643, 151643, 151643, 151643, 151643, 151643, 151643, 151643, 151643, 151643, 151643, 151643, 151643, 151643, 151643, 151643, 151643, 151643, 151643, 151643, 151643, 151643, 151643, 151643, 151643, 151643, 151643, 151643, 151643, 151643, 151643, 151643, 151643, 151643, 151643, 151643, 151643, 151643, 151643, 151643, 151643, 151643, 151643, 151643, 151643, 151643, 151643, 151643, 151643, 151643, 151643, 151643, 151643, 151643, 151643, 151643, 151643, 151643, 151643, 151643, 151643, 151643, 151643, 151643, 151643, 151643, 151643, 151643, 151643, 151643, 151643, 151643, 151643, 151643, 151643, 151643, 151643, 151643, 151643, 151643, 151643, 151643, 151643, 151643, 151643, 151643, 151643, 151643, 151643, 151643, 151643, 151643, 151643, 151643, 151643, 151643, 151643, 151643, 151643, 151643, 151643, 151643, 151643, 151643, 151643, 151643, 151643, 151643, 151643, 151643, 151643, 151643, 151643, 151643, 151643, 151643, 151643, 151643, 151643, 151643, 151643, 151643, 151643, 151643, 151643, 151643, 151643, 151643, 151643, 151643, 151643, 151643, 151643, 151643, 151643, 151643, 151643, 151643, 151643, 151643, 151643, 151643, 151643, 151643, 151643, 151643, 151643, 151643, 151643, 151643, 151643, 151643, 151643, 151643, 151643, 151643, 151643, 151643, 151643, 151643, 151643, 151643, 151643, 151643, 151643, 151643, 151643, 151643, 151643, 151643, 151643, 151643, 151643, 151643, 151643, 151643, 151643, 151643, 151643, 151643, 151643, 151643, 151643, 151643, 151643, 151643, 151643, 151643, 151643, 151643, 151643, 151643, 151643, 151643, 151643, 151643, 151643, 151643, 151643, 151643, 151643, 151643, 151643, 151643, 151643, 151643, 151643, 151643, 151643, 151643, 151643, 151643, 151643, 151643, 151643, 151643, 151643, 151643, 151643, 151643, 151643, 151643, 151643, 151643, 151643, 151643, 151643, 151643, 151643, 151643, 151643, 151643, 151643, 151643, 151643, 151643, 151643, 151643, 151643, 151643, 151643, 151643, 151643, 151643, 151643, 151643, 151643, 151643, 151643, 151643, 151643, 151643, 151643, 151643, 151643, 151643, 151643, 151643, 151643, 151643, 151643, 151643, 151643, 151643, 151643, 151643, 151643, 151643, 151643, 151643, 151643, 151643, 151643, 151643, 151643, 151643, 151643, 151643, 151643, 151643, 151643, 151643, 151643, 151643, 151643, 151643, 151643, 151643, 151643, 151643, 151643, 151643, 151643, 151643, 151643, 151643, 151643, 151643, 151643, 151643, 151643, 151643, 151643, 151643, 151643, 151643, 151643, 151643, 151643, 151643, 151643, 151643, 151643, 151643, 151643, 151643, 151643, 151643, 151643, 151643, 151643, 151643, 151643, 151643, 151643, 151643, 151643, 151643, 151643, 151643, 151643, 151643, 151643, 151643, 151643, 151643, 151643, 151643, 151643, 151643, 151643, 151643, 151643, 151643, 151643, 151643, 151643, 151643, 151643, 151643, 151643, 151643, 151643, 151643, 151643, 151643, 151643, 151643, 151643, 151643, 151643, 151643, 151643, 151643, 151643, 151643, 151643, 151643, 151643, 151643, 151643, 151643, 151643, 151643, 151643, 151643, 151643, 151643, 151643, 151643, 151643, 151643, 151643, 151643, 151643, 151643, 151643, 151643, 151643, 151643, 151643, 151643, 151643, 151643, 151643, 151643, 151643, 151643, 151643, 151643, 151643, 151643, 151643, 151643, 151643, 151643, 151643, 151643, 151643, 151643, 151643, 151643, 151643, 151643, 151643, 151643, 151643, 151643, 151643, 151643, 151643, 151643, 151643, 151644, 8948, 198, 2610, 525, 1207, 16948, 11, 3465, 553, 54364, 14817, 13, 1446, 525, 264, 10950, 17847, 13, 151645, 198, 151644, 872, 198, 16141, 279, 2701, 5248, 5754, 3405, 13, 576, 1537, 1555, 315, 697, 2033, 1265, 387, 315, 279, 2701, 3561, 25, 364, 16141, 25, 400, 20756, 4198, 6, 320, 28996, 17194, 8, 1380, 44428, 374, 825, 315, 19360, 35, 13, 21149, 3019, 553, 3019, 1573, 35764, 382, 1654, 614, 264, 3460, 39026, 315, 220, 16, 15, 13, 15, 15, 15, 320, 1960, 16183, 8, 19516, 5942, 13, 8886, 1849, 702, 264, 18790, 429, 525, 279, 1852, 323, 1212, 279, 1852, 4682, 13, 8886, 18790, 646, 3271, 3156, 3156, 264, 13705, 320, 1782, 856, 35321, 5106, 4292, 1654, 1414, 504, 31787, 33479, 429, 279, 12060, 729, 320, 1499, 5016, 23505, 5137, 23606, 8, 315, 1817, 18790, 11, 304, 264, 949, 315, 3550, 1380, 432, 646, 3000, 11, 646, 387, 7481, 438, 510, 7, 264, 608, 17946, 7, 16, 488, 856, 8, 873, 481, 220, 15, 13, 20, 23019, 26, 1380, 1036, 72, 854, 374, 279, 9334, 3704, 315, 481, 16, 11, 323, 1036, 26888, 368, 854, 3363, 279, 9334, 3704, 315, 624, 4498, 28990, 279, 2309, 315, 279, 18730, 11, 6857, 1033, 1730, 518, 856, 27, 16, 323, 856, 29, 18, 320, 3243, 304, 1948, 856, 28, 16, 323, 856, 28, 18, 4292, 3838, 374, 279, 34776, 897, 315, 1036, 64, 854, 1939, 32, 8, 220, 16, 13, 16, 198, 33, 8, 220, 15, 13, 21, 198, 34, 8, 220, 15, 13, 18, 20, 198, 35, 8, 220, 15, 13, 23, 20, 151645, 198, 151644, 77091, 198]",,269,576,845,0.0,0.0
c514bf6a-5e62-47c7-828a-e9aa0d86d3c3,7,94,"[151643, 151643, 151643, 151643, 151643, 151643, 151643, 151643, 151643, 151643, 151643, 151643, 151643, 151643, 151643, 151643, 151643, 151643, 151643, 151643, 151643, 151643, 151643, 151643, 151643, 151643, 151643, 151643, 151643, 151643, 151643, 151643, 151643, 151643, 151643, 151643, 151643, 151643, 151643, 151643, 151643, 151643, 151643, 151643, 151643, 151643, 151643, 151643, 151643, 151643, 151643, 151643, 151643, 151643, 151643, 151643, 151643, 151643, 151643, 151643, 151643, 151643, 151643, 151643, 151643, 151643, 151643, 151643, 151643, 151643, 151643, 151643, 151643, 151643, 151643, 151643, 151643, 151643, 151643, 151643, 151643, 151643, 151643, 151643, 151643, 151643, 151643, 151643, 151643, 151643, 151643, 151643, 151643, 151643, 151643, 151643, 151643, 151643, 151643, 151643, 151643, 151643, 151643, 151643, 151643, 151643, 151643, 151643, 151643, 151643, 151643, 151643, 151643, 151643, 151643, 151643, 151643, 151643, 151643, 151643, 151643, 151643, 151643, 151643, 151643, 151643, 151643, 151643, 151643, 151643, 151643, 151643, 151643, 151643, 151643, 151643, 151643, 151643, 151643, 151643, 151643, 151643, 151643, 151643, 151643, 151643, 151643, 151643, 151643, 151643, 151643, 151643, 151643, 151643, 151643, 151643, 151643, 151643, 151643, 151643, 151643, 151643, 151643, 151643, 151643, 151643, 151643, 151643, 151643, 151643, 151643, 151643, 151643, 151643, 151643, 151643, 151643, 151643, 151643, 151643, 151643, 151643, 151643, 151643, 151643, 151643, 151643, 151643, 151643, 151643, 151643, 151643, 151643, 151643, 151643, 151643, 151643, 151643, 151643, 151643, 151643, 151643, 151643, 151643, 151643, 151643, 151643, 151643, 151643, 151643, 151643, 151643, 151643, 151643, 151643, 151643, 151643, 151643, 151643, 151643, 151643, 151643, 151643, 151643, 151643, 151643, 151643, 151643, 151643, 151643, 151643, 151643, 151643, 151643, 151643, 151643, 151643, 151643, 151643, 151643, 151643, 151643, 151643, 151643, 151643, 151643, 151643, 151643, 151643, 151643, 151643, 151643, 151643, 151643, 151643, 151643, 151643, 151643, 151643, 151643, 151643, 151643, 151643, 151643, 151643, 151643, 151643, 151643, 151643, 151643, 151643, 151643, 151643, 151643, 151643, 151643, 151643, 151643, 151643, 151643, 151643, 151643, 151643, 151643, 151643, 151643, 151643, 151643, 151643, 151643, 151643, 151643, 151643, 151643, 151643, 151643, 151643, 151643, 151643, 151643, 151643, 151643, 151643, 151643, 151643, 151643, 151643, 151643, 151643, 151643, 151643, 151643, 151643, 151643, 151643, 151643, 151643, 151643, 151643, 151643, 151643, 151643, 151643, 151643, 151643, 151643, 151643, 151643, 151643, 151643, 151643, 151643, 151643, 151643, 151643, 151643, 151643, 151643, 151643, 151643, 151643, 151643, 151643, 151643, 151643, 151643, 151643, 151643, 151643, 151643, 151643, 151643, 151643, 151643, 151643, 151643, 151643, 151643, 151643, 151643, 151643, 151643, 151643, 151643, 151643, 151643, 151643, 151643, 151643, 151643, 151643, 151643, 151643, 151643, 151643, 151643, 151643, 151643, 151643, 151643, 151643, 151643, 151643, 151643, 151643, 151643, 151643, 151643, 151643, 151643, 151643, 151643, 151643, 151643, 151643, 151643, 151643, 151643, 151643, 151643, 151643, 151643, 151643, 151643, 151643, 151643, 151643, 151643, 151643, 151643, 151643, 151643, 151643, 151643, 151643, 151643, 151643, 151643, 151643, 151643, 151643, 151643, 151643, 151643, 151643, 151643, 151643, 151643, 151643, 151643, 151643, 151643, 151643, 151643, 151643, 151643, 151643, 151643, 151643, 151643, 151643, 151643, 151643, 151643, 151643, 151643, 151643, 151643, 151643, 151643, 151643, 151643, 151643, 151643, 151643, 151643, 151643, 151643, 151643, 151643, 151643, 151643, 151643, 151643, 151643, 151643, 151643, 151643, 151643, 151643, 151643, 151643, 151643, 151643, 151643, 151643, 151643, 151643, 151643, 151643, 151643, 151643, 151643, 151643, 151643, 151643, 151643, 151643, 151643, 151643, 151643, 151643, 151643, 151643, 151643, 151643, 151643, 151643, 151643, 151643, 151643, 151643, 151643, 151643, 151643, 151643, 151643, 151643, 151643, 151643, 151643, 151643, 151643, 151643, 151643, 151643, 151643, 151643, 151643, 151643, 151643, 151643, 151643, 151643, 151643, 151643, 151643, 151643, 151643, 151643, 151643, 151643, 151643, 151643, 151643, 151643, 151643, 151643, 151643, 151643, 151643, 151643, 151643, 151643, 151643, 151643, 151643, 151643, 151643, 151643, 151643, 151643, 151643, 151643, 151643, 151643, 151643, 151643, 151643, 151643, 151643, 151643, 151643, 151643, 151643, 151643, 151643, 151643, 151643, 151643, 151643, 151643, 151643, 151643, 151643, 151643, 151643, 151643, 151643, 151643, 151643, 151643, 151643, 151643, 151643, 151643, 151643, 151643, 151643, 151643, 151643, 151643, 151643, 151643, 151643, 151643, 151643, 151643, 151643, 151643, 151643, 151643, 151643, 151643, 151643, 151643, 151643, 151643, 151643, 151643, 151643, 151643, 151643, 151643, 151643, 151643, 151643, 151643, 151643, 151643, 151643, 151643, 151643, 151643, 151643, 151643, 151643, 151643, 151643, 151643, 151643, 151643, 151643, 151643, 151643, 151643, 151643, 151643, 151643, 151643, 151643, 151643, 151643, 151643, 151643, 151643, 151643, 151643, 151643, 151643, 151643, 151643, 151643, 151643, 151643, 151643, 151643, 151643, 151643, 151643, 151643, 151643, 151643, 151643, 151643, 151643, 151643, 151643, 151643, 151643, 151643, 151643, 151643, 151643, 151643, 151643, 151643, 151643, 151643, 151643, 151643, 151643, 151643, 151643, 151643, 151643, 151643, 151643, 151643, 151643, 151643, 151643, 151643, 151643, 151643, 151643, 151643, 151643, 151643, 151643, 151643, 151643, 151643, 151643, 151643, 151643, 151643, 151643, 151643, 151643, 151643, 151643, 151643, 151643, 151643, 151643, 151643, 151643, 151643, 151643, 151643, 151643, 151643, 151643, 151643, 151643, 151643, 151643, 151643, 151643, 151643, 151643, 151643, 151643, 151643, 151643, 151643, 151643, 151643, 151643, 151643, 151643, 151643, 151643, 151643, 151643, 151643, 151643, 151643, 151643, 151643, 151643, 151643, 151644, 8948, 198, 2610, 525, 1207, 16948, 11, 3465, 553, 54364, 14817, 13, 1446, 525, 264, 10950, 17847, 13, 151645, 198, 151644, 872, 198, 16141, 279, 2701, 5248, 5754, 3405, 13, 576, 1537, 1555, 315, 697, 2033, 1265, 387, 315, 279, 2701, 3561, 25, 364, 16141, 25, 400, 20756, 4198, 6, 320, 28996, 17194, 8, 1380, 44428, 374, 825, 315, 19360, 35, 13, 21149, 3019, 553, 3019, 1573, 35764, 382, 11613, 9759, 320, 12699, 62, 16, 323, 7679, 62, 17, 8, 1817, 614, 31638, 220, 16, 13, 20, 323, 220, 16, 13, 17, 3039, 429, 315, 1039, 8059, 11, 15576, 13, 63964, 51398, 323, 1667, 279, 62995, 1714, 11, 86787, 614, 10838, 279, 61135, 22509, 3020, 315, 1493, 1378, 9759, 25, 508, 21999, 14, 6123, 60, 62, 16, 284, 220, 15, 13, 18, 79901, 11, 508, 44, 70, 11374, 72, 60, 62, 17, 284, 220, 15, 13, 18, 79901, 11, 508, 6123, 23354, 60, 62, 16, 284, 220, 15, 79901, 11, 323, 508, 44, 70, 23354, 60, 62, 17, 284, 220, 15, 79901, 13, 21144, 279, 2701, 7249, 32249, 18037, 369, 279, 8059, 25, 220, 16, 17, 488, 1487, 16, 15, 1445, 6123, 9612, 39, 8, 284, 220, 22, 13, 20, 323, 220, 16, 17, 488, 1487, 16, 15, 1445, 44, 70, 9612, 39, 8, 284, 220, 22, 13, 20517, 279, 11341, 315, 50592, 32199, 304, 279, 7249, 64633, 315, 7679, 62, 16, 323, 7679, 62, 17, 382, 32, 8, 3968, 16, 17, 13, 21, 198, 33, 8, 3968, 18, 13, 24, 198, 34, 8, 3968, 15, 13, 23, 198, 35, 8, 3968, 16, 13, 17, 151645, 198, 151644, 77091, 198]",,271,869,1140,1.0,1.0
52b6e43e-59cb-474f-867d-27f6753e0e78,7,95,"[151643, 151643, 151643, 151643, 151643, 151643, 151643, 151643, 151643, 151643, 151643, 151643, 151643, 151643, 151643, 151643, 151643, 151643, 151643, 151643, 151643, 151643, 151643, 151643, 151643, 151643, 151643, 151643, 151643, 151643, 151643, 151643, 151643, 151643, 151643, 151643, 151643, 151643, 151643, 151643, 151643, 151643, 151643, 151643, 151643, 151643, 151643, 151643, 151643, 151643, 151643, 151643, 151643, 151643, 151643, 151643, 151643, 151643, 151643, 151643, 151643, 151643, 151643, 151643, 151643, 151643, 151643, 151643, 151643, 151643, 151643, 151643, 151643, 151643, 151643, 151643, 151643, 151643, 151643, 151643, 151643, 151643, 151643, 151643, 151643, 151643, 151643, 151643, 151643, 151643, 151643, 151643, 151643, 151643, 151643, 151643, 151643, 151643, 151643, 151643, 151643, 151643, 151643, 151643, 151643, 151643, 151643, 151643, 151643, 151643, 151643, 151643, 151643, 151643, 151643, 151643, 151643, 151643, 151643, 151643, 151643, 151643, 151643, 151643, 151643, 151643, 151643, 151643, 151643, 151643, 151643, 151643, 151643, 151643, 151643, 151643, 151643, 151643, 151643, 151643, 151643, 151643, 151643, 151643, 151643, 151643, 151643, 151643, 151643, 151643, 151643, 151643, 151643, 151643, 151643, 151643, 151643, 151643, 151643, 151643, 151643, 151643, 151643, 151643, 151643, 151643, 151643, 151643, 151643, 151643, 151643, 151643, 151643, 151643, 151643, 151643, 151643, 151643, 151643, 151643, 151643, 151643, 151643, 151643, 151643, 151643, 151643, 151643, 151643, 151643, 151643, 151643, 151643, 151643, 151643, 151643, 151643, 151643, 151643, 151643, 151643, 151643, 151643, 151643, 151643, 151643, 151643, 151643, 151643, 151643, 151643, 151643, 151643, 151643, 151643, 151643, 151643, 151643, 151643, 151643, 151643, 151643, 151643, 151643, 151643, 151643, 151643, 151643, 151643, 151643, 151643, 151643, 151643, 151643, 151643, 151643, 151643, 151643, 151643, 151643, 151643, 151643, 151643, 151643, 151643, 151643, 151643, 151643, 151643, 151643, 151643, 151643, 151643, 151643, 151643, 151643, 151643, 151643, 151643, 151643, 151643, 151643, 151643, 151643, 151643, 151643, 151643, 151643, 151643, 151643, 151643, 151643, 151643, 151643, 151643, 151643, 151643, 151643, 151643, 151643, 151643, 151643, 151643, 151643, 151643, 151643, 151643, 151643, 151643, 151643, 151643, 151643, 151643, 151643, 151643, 151643, 151643, 151643, 151643, 151643, 151643, 151643, 151643, 151643, 151643, 151643, 151643, 151643, 151643, 151643, 151643, 151643, 151643, 151643, 151643, 151643, 151643, 151643, 151643, 151643, 151643, 151643, 151643, 151643, 151643, 151643, 151643, 151643, 151643, 151643, 151643, 151643, 151643, 151643, 151643, 151643, 151643, 151643, 151643, 151643, 151643, 151643, 151643, 151643, 151643, 151643, 151643, 151643, 151643, 151643, 151643, 151643, 151643, 151643, 151643, 151643, 151643, 151643, 151643, 151643, 151643, 151643, 151643, 151643, 151643, 151643, 151643, 151643, 151643, 151643, 151643, 151643, 151643, 151643, 151643, 151643, 151643, 151643, 151643, 151643, 151643, 151643, 151643, 151643, 151643, 151643, 151643, 151643, 151643, 151643, 151643, 151643, 151643, 151643, 151643, 151643, 151643, 151643, 151643, 151643, 151643, 151643, 151643, 151643, 151643, 151643, 151643, 151643, 151643, 151643, 151643, 151643, 151643, 151643, 151643, 151643, 151643, 151643, 151643, 151643, 151643, 151643, 151643, 151643, 151643, 151643, 151643, 151643, 151643, 151643, 151643, 151643, 151643, 151643, 151643, 151643, 151643, 151643, 151643, 151643, 151643, 151643, 151643, 151643, 151643, 151643, 151643, 151643, 151643, 151643, 151643, 151643, 151643, 151643, 151643, 151643, 151643, 151643, 151643, 151643, 151643, 151643, 151643, 151643, 151643, 151643, 151643, 151643, 151643, 151643, 151643, 151643, 151643, 151643, 151643, 151643, 151643, 151643, 151643, 151643, 151643, 151643, 151643, 151643, 151643, 151643, 151643, 151643, 151643, 151643, 151643, 151643, 151643, 151643, 151643, 151643, 151643, 151643, 151643, 151643, 151643, 151643, 151643, 151643, 151643, 151643, 151643, 151643, 151643, 151643, 151643, 151643, 151643, 151643, 151643, 151643, 151643, 151643, 151643, 151643, 151643, 151643, 151643, 151643, 151643, 151643, 151643, 151643, 151643, 151643, 151643, 151643, 151643, 151643, 151643, 151643, 151643, 151643, 151643, 151643, 151643, 151643, 151643, 151643, 151643, 151643, 151643, 151643, 151643, 151643, 151643, 151643, 151643, 151643, 151643, 151643, 151643, 151643, 151643, 151643, 151643, 151643, 151643, 151643, 151643, 151643, 151643, 151643, 151643, 151643, 151643, 151643, 151643, 151643, 151643, 151643, 151643, 151643, 151643, 151643, 151643, 151643, 151643, 151643, 151643, 151643, 151643, 151643, 151643, 151643, 151643, 151643, 151643, 151643, 151643, 151643, 151643, 151643, 151643, 151643, 151643, 151643, 151643, 151643, 151643, 151643, 151643, 151643, 151643, 151643, 151643, 151643, 151643, 151643, 151643, 151643, 151643, 151643, 151643, 151643, 151643, 151643, 151643, 151643, 151643, 151643, 151643, 151643, 151643, 151643, 151643, 151643, 151643, 151643, 151643, 151643, 151643, 151643, 151643, 151643, 151643, 151643, 151643, 151643, 151643, 151643, 151643, 151643, 151643, 151643, 151643, 151643, 151643, 151643, 151643, 151643, 151643, 151643, 151643, 151643, 151643, 151643, 151643, 151643, 151643, 151643, 151643, 151643, 151643, 151643, 151643, 151643, 151643, 151643, 151643, 151643, 151643, 151643, 151643, 151643, 151643, 151643, 151643, 151643, 151643, 151643, 151643, 151643, 151643, 151643, 151643, 151643, 151643, 151643, 151643, 151643, 151643, 151643, 151643, 151643, 151643, 151643, 151643, 151643, 151643, 151643, 151643, 151643, 151643, 151643, 151643, 151643, 151643, 151643, 151643, 151643, 151643, 151643, 151643, 151643, 151643, 151643, 151643, 151643, 151643, 151643, 151643, 151643, 151643, 151643, 151643, 151643, 151643, 151643, 151643, 151643, 151643, 151643, 151643, 151643, 151643, 151643, 151643, 151643, 151643, 151643, 151643, 151643, 151643, 151643, 151643, 151643, 151643, 151643, 151643, 151643, 151643, 151643, 151643, 151643, 151643, 151643, 151643, 151643, 151643, 151643, 151643, 151643, 151643, 151643, 151643, 151643, 151643, 151643, 151643, 151643, 151643, 151643, 151643, 151643, 151643, 151643, 151643, 151643, 151643, 151643, 151643, 151643, 151643, 151643, 151643, 151643, 151643, 151643, 151643, 151643, 151643, 151643, 151643, 151643, 151643, 151643, 151643, 151643, 151643, 151643, 151643, 151643, 151643, 151643, 151643, 151643, 151643, 151643, 151643, 151643, 151643, 151643, 151643, 151643, 151643, 151643, 151643, 151643, 151644, 8948, 198, 2610, 525, 1207, 16948, 11, 3465, 553, 54364, 14817, 13, 1446, 525, 264, 10950, 17847, 13, 151645, 198, 151644, 872, 198, 16141, 279, 2701, 5248, 5754, 3405, 13, 576, 1537, 1555, 315, 697, 2033, 1265, 387, 315, 279, 2701, 3561, 25, 364, 16141, 25, 400, 20756, 4198, 6, 320, 28996, 17194, 8, 1380, 44428, 374, 825, 315, 19360, 35, 13, 21149, 3019, 553, 3019, 1573, 35764, 382, 9885, 11090, 315, 1985, 18730, 304, 345, 34767, 7, 36197, 284, 11834, 7, 36197, 488, 10908, 198, 6739, 20636, 7, 36197, 374, 52635, 624, 12416, 3072, 315, 20636, 7, 36197, 609, 220, 11834, 7, 36197, 374, 220, 16, 18, 24, 13, 21, 2157, 53, 609, 220, 16, 15, 20, 13, 22, 2157, 53, 15576, 382, 32, 8, 220, 19, 13, 16, 17, 2157, 53, 11, 220, 17, 24, 13, 23, 2157, 53, 198, 33, 8, 220, 18, 13, 20, 17, 2157, 53, 11, 220, 17, 15, 13, 23, 2157, 53, 198, 34, 8, 220, 17, 13, 23, 19, 2157, 53, 11, 220, 17, 21, 13, 23, 2157, 53, 198, 35, 8, 220, 22, 13, 17, 2157, 53, 11, 220, 18, 17, 13, 23, 2157, 53, 151645, 198, 151644, 77091, 198]",,200,590,790,1.0,1.0
8e9168e3-4221-4917-b5cb-f4f321364981,7,96,"[151643, 151643, 151643, 151643, 151643, 151643, 151643, 151643, 151643, 151643, 151643, 151643, 151643, 151643, 151643, 151643, 151643, 151643, 151643, 151643, 151643, 151643, 151643, 151643, 151643, 151643, 151643, 151643, 151643, 151643, 151643, 151643, 151643, 151643, 151643, 151643, 151643, 151643, 151643, 151643, 151643, 151643, 151643, 151643, 151643, 151643, 151643, 151643, 151643, 151643, 151643, 151643, 151643, 151643, 151643, 151643, 151643, 151643, 151643, 151643, 151643, 151643, 151643, 151643, 151643, 151643, 151643, 151643, 151643, 151643, 151643, 151643, 151643, 151643, 151643, 151643, 151643, 151643, 151643, 151643, 151643, 151643, 151643, 151643, 151643, 151643, 151643, 151643, 151643, 151643, 151643, 151643, 151643, 151643, 151643, 151643, 151643, 151643, 151643, 151643, 151643, 151643, 151643, 151643, 151643, 151643, 151643, 151643, 151643, 151643, 151643, 151643, 151643, 151643, 151643, 151643, 151643, 151643, 151643, 151643, 151643, 151643, 151643, 151643, 151643, 151643, 151643, 151643, 151643, 151643, 151643, 151643, 151643, 151643, 151643, 151643, 151643, 151643, 151643, 151643, 151643, 151643, 151643, 151643, 151643, 151643, 151643, 151643, 151643, 151643, 151643, 151643, 151643, 151643, 151643, 151643, 151643, 151643, 151643, 151643, 151643, 151643, 151643, 151643, 151643, 151643, 151643, 151643, 151643, 151643, 151643, 151643, 151643, 151643, 151643, 151643, 151643, 151643, 151643, 151643, 151643, 151643, 151643, 151643, 151643, 151643, 151643, 151643, 151643, 151643, 151643, 151643, 151643, 151643, 151643, 151643, 151643, 151643, 151643, 151643, 151643, 151643, 151643, 151643, 151643, 151643, 151643, 151643, 151643, 151643, 151643, 151643, 151643, 151643, 151643, 151643, 151643, 151643, 151643, 151643, 151643, 151643, 151643, 151643, 151643, 151643, 151643, 151643, 151643, 151643, 151643, 151643, 151643, 151643, 151643, 151643, 151643, 151643, 151643, 151643, 151643, 151643, 151643, 151643, 151643, 151643, 151643, 151643, 151643, 151643, 151643, 151643, 151643, 151643, 151643, 151643, 151643, 151643, 151643, 151643, 151643, 151643, 151643, 151643, 151643, 151643, 151643, 151643, 151643, 151643, 151643, 151643, 151643, 151643, 151643, 151643, 151643, 151643, 151643, 151643, 151643, 151643, 151643, 151643, 151643, 151643, 151643, 151643, 151643, 151643, 151643, 151643, 151643, 151643, 151643, 151643, 151643, 151643, 151643, 151643, 151643, 151643, 151643, 151643, 151643, 151643, 151643, 151643, 151643, 151643, 151643, 151643, 151643, 151643, 151643, 151643, 151643, 151643, 151643, 151643, 151643, 151643, 151643, 151643, 151643, 151643, 151643, 151643, 151643, 151643, 151643, 151643, 151643, 151643, 151643, 151643, 151643, 151643, 151643, 151643, 151643, 151643, 151643, 151643, 151643, 151643, 151643, 151643, 151643, 151643, 151643, 151643, 151643, 151643, 151643, 151643, 151643, 151643, 151643, 151643, 151643, 151643, 151643, 151643, 151643, 151643, 151643, 151643, 151643, 151643, 151643, 151643, 151643, 151643, 151643, 151643, 151643, 151643, 151643, 151643, 151643, 151643, 151643, 151643, 151643, 151643, 151643, 151643, 151643, 151643, 151643, 151643, 151643, 151643, 151643, 151643, 151643, 151643, 151643, 151643, 151643, 151643, 151643, 151643, 151643, 151643, 151643, 151643, 151643, 151643, 151643, 151643, 151643, 151643, 151643, 151643, 151643, 151643, 151643, 151643, 151643, 151643, 151643, 151643, 151643, 151643, 151643, 151643, 151643, 151643, 151643, 151643, 151643, 151643, 151643, 151643, 151643, 151643, 151643, 151643, 151643, 151643, 151643, 151643, 151643, 151643, 151643, 151643, 151643, 151643, 151643, 151643, 151643, 151643, 151643, 151643, 151643, 151643, 151643, 151643, 151643, 151643, 151643, 151643, 151643, 151643, 151643, 151643, 151643, 151643, 151643, 151643, 151643, 151643, 151643, 151643, 151643, 151643, 151643, 151643, 151643, 151643, 151643, 151643, 151643, 151643, 151643, 151643, 151643, 151643, 151643, 151643, 151643, 151643, 151643, 151643, 151643, 151643, 151643, 151643, 151643, 151643, 151643, 151643, 151643, 151643, 151643, 151643, 151643, 151643, 151643, 151643, 151643, 151643, 151643, 151643, 151643, 151643, 151643, 151643, 151643, 151643, 151643, 151643, 151643, 151643, 151643, 151643, 151643, 151643, 151643, 151643, 151643, 151643, 151643, 151643, 151643, 151643, 151643, 151643, 151643, 151643, 151643, 151643, 151643, 151643, 151643, 151643, 151643, 151643, 151643, 151643, 151643, 151643, 151643, 151643, 151643, 151643, 151643, 151643, 151643, 151643, 151643, 151643, 151643, 151643, 151643, 151643, 151643, 151643, 151643, 151643, 151643, 151643, 151643, 151643, 151643, 151643, 151643, 151643, 151643, 151643, 151643, 151643, 151643, 151643, 151643, 151643, 151643, 151643, 151643, 151643, 151643, 151643, 151643, 151643, 151643, 151643, 151643, 151643, 151643, 151643, 151643, 151643, 151643, 151643, 151643, 151643, 151643, 151643, 151643, 151643, 151643, 151643, 151643, 151643, 151643, 151643, 151643, 151643, 151643, 151643, 151643, 151643, 151643, 151643, 151643, 151643, 151643, 151643, 151643, 151643, 151643, 151643, 151643, 151643, 151643, 151643, 151643, 151643, 151643, 151643, 151643, 151643, 151643, 151643, 151643, 151643, 151643, 151643, 151643, 151643, 151643, 151643, 151643, 151643, 151643, 151643, 151643, 151643, 151643, 151643, 151643, 151643, 151643, 151643, 151643, 151643, 151643, 151643, 151643, 151643, 151643, 151643, 151643, 151643, 151643, 151643, 151643, 151643, 151643, 151643, 151643, 151643, 151643, 151643, 151643, 151643, 151643, 151643, 151643, 151643, 151643, 151643, 151643, 151643, 151643, 151643, 151643, 151643, 151643, 151643, 151643, 151643, 151643, 151643, 151643, 151643, 151643, 151643, 151643, 151643, 151643, 151643, 151643, 151643, 151643, 151643, 151643, 151643, 151643, 151643, 151643, 151643, 151643, 151643, 151643, 151643, 151643, 151643, 151643, 151643, 151643, 151643, 151643, 151643, 151643, 151643, 151643, 151643, 151643, 151643, 151643, 151643, 151643, 151643, 151643, 151643, 151643, 151643, 151643, 151643, 151643, 151643, 151643, 151643, 151643, 151643, 151643, 151643, 151643, 151643, 151643, 151643, 151643, 151643, 151643, 151643, 151643, 151643, 151643, 151643, 151643, 151643, 151643, 151643, 151643, 151643, 151643, 151643, 151643, 151643, 151643, 151643, 151643, 151643, 151643, 151643, 151643, 151643, 151643, 151643, 151643, 151643, 151643, 151643, 151643, 151643, 151643, 151643, 151643, 151643, 151643, 151643, 151643, 151643, 151643, 151643, 151643, 151643, 151643, 151643, 151643, 151643, 151643, 151643, 151643, 151643, 151643, 151643, 151643, 151643, 151643, 151643, 151643, 151643, 151643, 151643, 151643, 151644, 8948, 198, 2610, 525, 1207, 16948, 11, 3465, 553, 54364, 14817, 13, 1446, 525, 264, 10950, 17847, 13, 151645, 198, 151644, 872, 198, 16141, 279, 2701, 5248, 5754, 3405, 13, 576, 1537, 1555, 315, 697, 2033, 1265, 387, 315, 279, 2701, 3561, 25, 364, 16141, 25, 400, 20756, 4198, 6, 320, 28996, 17194, 8, 1380, 44428, 374, 825, 315, 19360, 35, 13, 21149, 3019, 553, 3019, 1573, 35764, 382, 1654, 1366, 311, 22986, 264, 30715, 315, 264, 3175, 19124, 320, 6618, 61507, 568, 1084, 374, 3204, 311, 6851, 419, 19124, 320, 68, 1302, 2572, 504, 264, 13440, 30715, 315, 2441, 19124, 8, 323, 1191, 16558, 1290, 3123, 13, 1205, 1414, 504, 3681, 21204, 429, 279, 30715, 18927, 315, 419, 19124, 374, 220, 18, 17, 4, 2878, 220, 16, 15, 15, 4420, 624, 4416, 3041, 11, 220, 20, 15, 4420, 614, 5823, 323, 279, 19124, 702, 537, 30715, 291, 13, 3555, 374, 279, 18927, 432, 686, 30715, 304, 279, 1790, 220, 16, 20, 15, 4420, 1939, 32, 8, 220, 19, 23, 13744, 33, 8, 220, 20, 17, 13744, 34, 8, 220, 19, 15, 13744, 35, 8, 220, 19, 19, 4, 151645, 198, 151644, 77091, 198]",,195,653,848,0.0,0.0
ab98bc8e-8174-4599-a9b2-f46c5db32236,7,97,"[151643, 151643, 151643, 151643, 151643, 151643, 151643, 151643, 151643, 151643, 151643, 151643, 151643, 151643, 151643, 151643, 151643, 151643, 151643, 151643, 151643, 151643, 151643, 151643, 151643, 151643, 151643, 151643, 151643, 151643, 151643, 151643, 151643, 151643, 151643, 151643, 151643, 151643, 151643, 151643, 151643, 151643, 151643, 151643, 151643, 151643, 151643, 151643, 151643, 151643, 151643, 151643, 151643, 151643, 151643, 151643, 151643, 151643, 151643, 151643, 151643, 151643, 151643, 151643, 151643, 151643, 151643, 151643, 151643, 151643, 151643, 151643, 151643, 151643, 151643, 151643, 151643, 151643, 151643, 151643, 151643, 151643, 151643, 151643, 151643, 151643, 151643, 151643, 151643, 151643, 151643, 151643, 151643, 151643, 151643, 151643, 151643, 151643, 151643, 151643, 151643, 151643, 151643, 151643, 151643, 151643, 151643, 151643, 151643, 151643, 151643, 151643, 151643, 151643, 151643, 151643, 151643, 151643, 151643, 151643, 151643, 151643, 151643, 151643, 151643, 151643, 151643, 151643, 151643, 151643, 151643, 151643, 151643, 151643, 151643, 151643, 151643, 151643, 151643, 151643, 151643, 151643, 151643, 151643, 151643, 151643, 151643, 151643, 151643, 151643, 151643, 151643, 151643, 151643, 151643, 151643, 151643, 151643, 151643, 151643, 151643, 151643, 151643, 151643, 151643, 151643, 151643, 151643, 151643, 151643, 151643, 151643, 151643, 151643, 151643, 151643, 151643, 151643, 151643, 151643, 151643, 151643, 151643, 151643, 151643, 151643, 151643, 151643, 151643, 151643, 151643, 151643, 151643, 151643, 151643, 151643, 151643, 151643, 151643, 151643, 151643, 151643, 151643, 151643, 151643, 151643, 151643, 151643, 151643, 151643, 151643, 151643, 151643, 151643, 151643, 151643, 151643, 151643, 151643, 151643, 151643, 151643, 151643, 151643, 151643, 151643, 151643, 151643, 151643, 151643, 151643, 151643, 151643, 151643, 151643, 151643, 151643, 151643, 151643, 151643, 151643, 151643, 151643, 151643, 151643, 151643, 151643, 151643, 151643, 151643, 151643, 151643, 151643, 151643, 151643, 151643, 151643, 151643, 151643, 151643, 151643, 151643, 151643, 151643, 151643, 151643, 151643, 151643, 151643, 151643, 151643, 151643, 151643, 151643, 151643, 151643, 151643, 151643, 151643, 151643, 151643, 151643, 151643, 151643, 151643, 151643, 151643, 151643, 151643, 151643, 151643, 151643, 151643, 151643, 151643, 151643, 151643, 151643, 151643, 151643, 151643, 151643, 151643, 151643, 151643, 151643, 151643, 151643, 151643, 151643, 151643, 151643, 151643, 151643, 151643, 151643, 151643, 151643, 151643, 151643, 151643, 151643, 151643, 151643, 151643, 151643, 151643, 151643, 151643, 151643, 151643, 151643, 151643, 151643, 151643, 151643, 151643, 151643, 151643, 151643, 151643, 151643, 151643, 151643, 151643, 151643, 151643, 151643, 151643, 151643, 151643, 151643, 151643, 151643, 151643, 151643, 151643, 151643, 151643, 151643, 151643, 151643, 151643, 151643, 151643, 151643, 151643, 151643, 151643, 151643, 151643, 151643, 151643, 151643, 151643, 151643, 151643, 151643, 151643, 151643, 151643, 151643, 151643, 151643, 151643, 151643, 151643, 151643, 151643, 151643, 151643, 151643, 151643, 151643, 151643, 151643, 151643, 151643, 151643, 151643, 151643, 151643, 151643, 151643, 151643, 151643, 151643, 151643, 151643, 151643, 151643, 151643, 151643, 151643, 151643, 151643, 151643, 151643, 151643, 151643, 151643, 151643, 151643, 151643, 151643, 151643, 151643, 151643, 151643, 151643, 151643, 151643, 151643, 151643, 151643, 151643, 151643, 151643, 151643, 151643, 151643, 151643, 151643, 151643, 151643, 151643, 151643, 151643, 151643, 151643, 151643, 151643, 151643, 151643, 151643, 151643, 151643, 151643, 151643, 151643, 151643, 151643, 151643, 151643, 151643, 151643, 151643, 151643, 151643, 151643, 151643, 151643, 151643, 151643, 151643, 151643, 151643, 151643, 151643, 151643, 151643, 151643, 151643, 151643, 151643, 151643, 151643, 151643, 151643, 151643, 151643, 151643, 151643, 151643, 151643, 151643, 151643, 151643, 151643, 151643, 151643, 151643, 151643, 151643, 151643, 151643, 151643, 151643, 151643, 151643, 151643, 151643, 151643, 151643, 151643, 151643, 151643, 151643, 151643, 151643, 151643, 151643, 151643, 151643, 151643, 151643, 151643, 151643, 151643, 151643, 151643, 151643, 151643, 151643, 151643, 151643, 151643, 151643, 151643, 151643, 151643, 151643, 151643, 151643, 151643, 151643, 151643, 151643, 151643, 151643, 151643, 151643, 151643, 151643, 151643, 151643, 151643, 151643, 151643, 151643, 151643, 151643, 151643, 151643, 151643, 151643, 151643, 151643, 151643, 151643, 151643, 151643, 151643, 151643, 151643, 151643, 151643, 151643, 151643, 151643, 151643, 151643, 151643, 151643, 151643, 151643, 151643, 151643, 151643, 151643, 151643, 151643, 151643, 151643, 151643, 151643, 151643, 151643, 151643, 151643, 151643, 151643, 151643, 151643, 151643, 151643, 151643, 151643, 151643, 151643, 151643, 151643, 151643, 151643, 151643, 151643, 151643, 151643, 151643, 151643, 151643, 151643, 151643, 151643, 151643, 151643, 151643, 151643, 151643, 151643, 151643, 151643, 151643, 151643, 151643, 151643, 151643, 151643, 151643, 151643, 151643, 151643, 151643, 151643, 151643, 151643, 151643, 151643, 151643, 151643, 151643, 151643, 151643, 151643, 151643, 151643, 151643, 151643, 151643, 151643, 151643, 151643, 151643, 151643, 151643, 151643, 151643, 151643, 151643, 151643, 151643, 151643, 151643, 151643, 151643, 151643, 151643, 151643, 151643, 151643, 151643, 151643, 151643, 151643, 151643, 151643, 151643, 151643, 151643, 151643, 151643, 151643, 151643, 151643, 151643, 151643, 151643, 151643, 151643, 151643, 151643, 151643, 151643, 151643, 151643, 151643, 151643, 151643, 151643, 151643, 151643, 151643, 151643, 151643, 151643, 151643, 151643, 151643, 151643, 151643, 151643, 151643, 151643, 151643, 151643, 151643, 151643, 151643, 151643, 151643, 151643, 151643, 151643, 151643, 151643, 151643, 151643, 151643, 151643, 151643, 151643, 151643, 151643, 151643, 151643, 151643, 151643, 151643, 151643, 151643, 151643, 151643, 151643, 151643, 151643, 151643, 151643, 151643, 151643, 151643, 151643, 151643, 151643, 151643, 151643, 151643, 151643, 151643, 151643, 151643, 151643, 151643, 151643, 151643, 151643, 151643, 151643, 151643, 151643, 151643, 151643, 151643, 151643, 151643, 151643, 151643, 151643, 151643, 151643, 151643, 151643, 151643, 151643, 151643, 151643, 151643, 151643, 151643, 151643, 151643, 151643, 151643, 151643, 151643, 151643, 151643, 151643, 151643, 151643, 151643, 151643, 151643, 151643, 151643, 151643, 151643, 151643, 151643, 151643, 151643, 151643, 151643, 151643, 151643, 151643, 151643, 151643, 151643, 151643, 151643, 151643, 151643, 151643, 151643, 151643, 151644, 8948, 198, 2610, 525, 1207, 16948, 11, 3465, 553, 54364, 14817, 13, 1446, 525, 264, 10950, 17847, 13, 151645, 198, 151644, 872, 198, 16141, 279, 2701, 5248, 5754, 3405, 13, 576, 1537, 1555, 315, 697, 2033, 1265, 387, 315, 279, 2701, 3561, 25, 364, 16141, 25, 400, 20756, 4198, 6, 320, 28996, 17194, 8, 1380, 44428, 374, 825, 315, 19360, 35, 13, 21149, 3019, 553, 3019, 1573, 35764, 382, 28301, 1437, 279, 1372, 315, 220, 16, 18, 34, 11250, 18446, 17289, 8947, 553, 279, 1590, 1985, 11, 3371, 9253, 438, 468, 11, 12942, 504, 279, 4013, 315, 24473, 6839, 3685, 624, 2008, 3914, 85736, 488, 47923, 608, 50504, 18, 69726, 362, 198, 32, 488, 27227, 45421, 69726, 425, 198, 33, 488, 64598, 78, 769, 2145, 69726, 356, 198, 34, 488, 472, 70, 5066, 17, 608, 472, 17, 46, 608, 472, 10, 69726, 422, 198, 35, 488, 393, 3357, 18, 608, 220, 18, 1455, 441, 453, 306, 2145, 608, 27227, 45421, 69726, 468, 271, 32, 8, 220, 18, 198, 33, 8, 220, 16, 16, 198, 34, 8, 220, 23, 198, 35, 8, 220, 21, 151645, 198, 151644, 77091, 198]",,189,449,638,0.0,0.0
cd826d81-b76d-4a32-ba21-b575dda9af75,7,98,"[151643, 151643, 151643, 151643, 151643, 151643, 151643, 151643, 151643, 151643, 151643, 151643, 151643, 151643, 151643, 151643, 151643, 151643, 151643, 151643, 151643, 151643, 151643, 151643, 151643, 151643, 151643, 151643, 151643, 151643, 151643, 151643, 151643, 151643, 151643, 151643, 151643, 151643, 151643, 151643, 151643, 151643, 151643, 151643, 151643, 151643, 151643, 151643, 151643, 151643, 151643, 151643, 151643, 151643, 151643, 151643, 151643, 151643, 151643, 151643, 151643, 151643, 151643, 151643, 151643, 151643, 151643, 151643, 151643, 151643, 151643, 151643, 151643, 151643, 151643, 151643, 151643, 151643, 151643, 151643, 151643, 151643, 151643, 151643, 151643, 151643, 151643, 151643, 151643, 151643, 151643, 151643, 151643, 151643, 151643, 151643, 151643, 151643, 151643, 151643, 151643, 151643, 151643, 151643, 151643, 151643, 151643, 151643, 151643, 151643, 151643, 151643, 151643, 151643, 151643, 151643, 151643, 151643, 151643, 151643, 151643, 151643, 151643, 151643, 151643, 151643, 151643, 151643, 151643, 151643, 151643, 151643, 151643, 151643, 151643, 151643, 151643, 151643, 151643, 151643, 151643, 151643, 151643, 151643, 151643, 151643, 151643, 151643, 151643, 151643, 151643, 151643, 151643, 151643, 151643, 151643, 151643, 151643, 151643, 151643, 151643, 151643, 151643, 151643, 151643, 151643, 151643, 151643, 151643, 151643, 151643, 151643, 151643, 151643, 151643, 151643, 151643, 151643, 151643, 151643, 151643, 151643, 151643, 151643, 151643, 151643, 151643, 151643, 151643, 151643, 151643, 151643, 151643, 151643, 151643, 151643, 151643, 151643, 151643, 151643, 151643, 151643, 151643, 151643, 151643, 151643, 151643, 151643, 151643, 151643, 151643, 151643, 151643, 151643, 151643, 151643, 151643, 151643, 151643, 151643, 151643, 151643, 151643, 151643, 151643, 151643, 151643, 151643, 151643, 151643, 151643, 151643, 151643, 151643, 151643, 151643, 151643, 151643, 151643, 151643, 151643, 151643, 151643, 151643, 151643, 151643, 151643, 151643, 151643, 151643, 151643, 151643, 151643, 151643, 151643, 151643, 151643, 151643, 151643, 151643, 151643, 151643, 151643, 151643, 151643, 151643, 151643, 151643, 151643, 151643, 151643, 151643, 151643, 151643, 151643, 151643, 151643, 151643, 151643, 151643, 151643, 151643, 151643, 151643, 151643, 151643, 151643, 151643, 151643, 151643, 151643, 151643, 151643, 151643, 151643, 151643, 151643, 151643, 151643, 151643, 151643, 151643, 151643, 151643, 151643, 151643, 151643, 151643, 151643, 151643, 151643, 151643, 151643, 151643, 151643, 151643, 151643, 151643, 151643, 151643, 151643, 151643, 151643, 151643, 151643, 151643, 151643, 151643, 151643, 151643, 151643, 151643, 151643, 151643, 151643, 151643, 151643, 151643, 151643, 151643, 151643, 151643, 151643, 151643, 151643, 151643, 151643, 151643, 151643, 151643, 151643, 151643, 151643, 151643, 151643, 151643, 151643, 151643, 151643, 151643, 151643, 151643, 151643, 151643, 151643, 151643, 151643, 151643, 151643, 151643, 151643, 151643, 151643, 151643, 151643, 151643, 151643, 151643, 151643, 151643, 151643, 151643, 151643, 151643, 151643, 151643, 151643, 151643, 151643, 151643, 151643, 151643, 151643, 151643, 151643, 151643, 151643, 151643, 151643, 151643, 151643, 151643, 151643, 151643, 151643, 151643, 151643, 151643, 151643, 151643, 151643, 151643, 151643, 151643, 151643, 151643, 151643, 151643, 151643, 151643, 151643, 151643, 151643, 151643, 151643, 151643, 151643, 151643, 151643, 151643, 151643, 151643, 151643, 151643, 151643, 151643, 151643, 151643, 151643, 151643, 151643, 151643, 151643, 151643, 151643, 151643, 151643, 151643, 151643, 151643, 151643, 151643, 151643, 151643, 151643, 151643, 151643, 151643, 151643, 151643, 151643, 151643, 151643, 151643, 151643, 151643, 151643, 151643, 151643, 151643, 151643, 151643, 151643, 151643, 151643, 151643, 151643, 151643, 151643, 151643, 151643, 151643, 151643, 151643, 151643, 151643, 151643, 151643, 151643, 151643, 151643, 151643, 151643, 151643, 151643, 151643, 151643, 151643, 151643, 151643, 151643, 151643, 151643, 151643, 151643, 151643, 151643, 151643, 151643, 151643, 151643, 151643, 151643, 151643, 151643, 151643, 151643, 151643, 151643, 151643, 151643, 151643, 151643, 151643, 151643, 151643, 151643, 151643, 151643, 151643, 151643, 151643, 151643, 151643, 151643, 151643, 151643, 151643, 151643, 151643, 151643, 151643, 151643, 151643, 151643, 151643, 151643, 151643, 151643, 151643, 151643, 151643, 151643, 151643, 151643, 151643, 151643, 151643, 151643, 151643, 151643, 151643, 151643, 151643, 151643, 151643, 151643, 151643, 151643, 151643, 151643, 151643, 151643, 151643, 151643, 151643, 151643, 151643, 151643, 151643, 151643, 151643, 151643, 151643, 151643, 151643, 151643, 151643, 151643, 151643, 151643, 151643, 151643, 151643, 151643, 151643, 151643, 151643, 151643, 151643, 151643, 151643, 151643, 151643, 151643, 151643, 151643, 151643, 151643, 151643, 151643, 151643, 151643, 151643, 151643, 151643, 151643, 151643, 151643, 151643, 151643, 151643, 151643, 151643, 151643, 151643, 151643, 151643, 151643, 151643, 151643, 151643, 151643, 151643, 151643, 151643, 151643, 151643, 151643, 151643, 151643, 151643, 151643, 151643, 151643, 151643, 151643, 151643, 151643, 151643, 151643, 151643, 151643, 151643, 151643, 151643, 151643, 151643, 151643, 151643, 151643, 151643, 151643, 151643, 151643, 151643, 151643, 151643, 151643, 151643, 151643, 151643, 151643, 151643, 151643, 151643, 151643, 151643, 151643, 151643, 151643, 151643, 151643, 151643, 151643, 151643, 151643, 151643, 151643, 151643, 151643, 151643, 151643, 151643, 151643, 151643, 151643, 151643, 151643, 151643, 151643, 151643, 151643, 151643, 151643, 151643, 151643, 151643, 151643, 151643, 151643, 151643, 151643, 151643, 151643, 151643, 151643, 151643, 151643, 151643, 151643, 151643, 151643, 151643, 151643, 151643, 151643, 151643, 151643, 151643, 151643, 151643, 151643, 151643, 151643, 151643, 151643, 151643, 151643, 151643, 151643, 151643, 151643, 151643, 151643, 151643, 151643, 151643, 151643, 151643, 151643, 151643, 151643, 151643, 151643, 151643, 151643, 151643, 151643, 151643, 151643, 151643, 151643, 151643, 151643, 151643, 151643, 151643, 151643, 151643, 151643, 151643, 151643, 151643, 151643, 151643, 151643, 151643, 151643, 151643, 151643, 151643, 151643, 151643, 151643, 151643, 151643, 151643, 151643, 151643, 151643, 151643, 151643, 151643, 151643, 151643, 151643, 151643, 151643, 151643, 151643, 151643, 151643, 151643, 151643, 151643, 151643, 151643, 151643, 151643, 151643, 151643, 151643, 151643, 151643, 151643, 151643, 151643, 151643, 151643, 151643, 151643, 151643, 151643, 151643, 151643, 151643, 151643, 151643, 151643, 151643, 151643, 151643, 151643, 151643, 151643, 151643, 151643, 151643, 151643, 151643, 151643, 151643, 151643, 151643, 151643, 151643, 151644, 8948, 198, 2610, 525, 1207, 16948, 11, 3465, 553, 54364, 14817, 13, 1446, 525, 264, 10950, 17847, 13, 151645, 198, 151644, 872, 198, 16141, 279, 2701, 5248, 5754, 3405, 13, 576, 1537, 1555, 315, 697, 2033, 1265, 387, 315, 279, 2701, 3561, 25, 364, 16141, 25, 400, 20756, 4198, 6, 320, 28996, 17194, 8, 1380, 44428, 374, 825, 315, 19360, 35, 13, 21149, 3019, 553, 3019, 1573, 35764, 382, 641, 264, 15279, 15494, 1380, 264, 32197, 646, 614, 458, 24203, 4787, 476, 4882, 25026, 11, 58397, 748, 37906, 1401, 2155, 13, 1988, 11, 11689, 11, 892, 315, 1846, 37906, 525, 2155, 1939, 32, 8, 576, 825, 5435, 311, 279, 81158, 315, 279, 23970, 2070, 624, 33, 8, 576, 825, 5435, 311, 279, 34755, 315, 279, 23970, 2070, 323, 279, 30305, 315, 279, 9072, 2070, 624, 34, 8, 576, 6174, 5435, 311, 279, 34755, 315, 279, 9072, 2070, 323, 279, 81158, 315, 279, 23970, 2070, 624, 35, 8, 576, 6174, 5435, 311, 279, 81158, 323, 279, 13957, 315, 279, 23970, 2070, 13, 151645, 198, 151644, 77091, 198]",,177,420,597,0.0,0.0
be83b48c-7be8-4d04-8da9-3f43a6648429,7,99,"[151643, 151643, 151643, 151643, 151643, 151643, 151643, 151643, 151643, 151643, 151643, 151643, 151643, 151643, 151643, 151643, 151643, 151643, 151643, 151643, 151643, 151643, 151643, 151643, 151643, 151643, 151643, 151643, 151643, 151643, 151643, 151643, 151643, 151643, 151643, 151643, 151643, 151643, 151643, 151643, 151643, 151643, 151643, 151643, 151643, 151643, 151643, 151643, 151643, 151643, 151643, 151643, 151643, 151643, 151643, 151643, 151643, 151643, 151643, 151643, 151643, 151643, 151643, 151643, 151643, 151643, 151643, 151643, 151643, 151643, 151643, 151643, 151643, 151643, 151643, 151643, 151643, 151643, 151643, 151643, 151643, 151643, 151643, 151643, 151643, 151643, 151643, 151643, 151643, 151643, 151643, 151643, 151643, 151643, 151643, 151643, 151643, 151643, 151643, 151643, 151643, 151643, 151643, 151643, 151643, 151643, 151643, 151643, 151643, 151643, 151643, 151643, 151643, 151643, 151643, 151643, 151643, 151643, 151643, 151643, 151643, 151643, 151643, 151643, 151643, 151643, 151643, 151643, 151643, 151643, 151643, 151643, 151643, 151643, 151643, 151643, 151643, 151643, 151643, 151643, 151643, 151643, 151643, 151643, 151643, 151643, 151643, 151643, 151643, 151643, 151643, 151643, 151643, 151643, 151643, 151643, 151643, 151643, 151643, 151643, 151643, 151643, 151643, 151643, 151643, 151643, 151643, 151643, 151643, 151643, 151643, 151643, 151643, 151643, 151643, 151643, 151643, 151643, 151643, 151643, 151643, 151643, 151643, 151643, 151643, 151643, 151643, 151643, 151643, 151643, 151643, 151643, 151643, 151643, 151643, 151643, 151643, 151643, 151643, 151643, 151643, 151643, 151643, 151643, 151643, 151643, 151643, 151643, 151643, 151643, 151643, 151643, 151643, 151643, 151643, 151643, 151643, 151643, 151643, 151643, 151643, 151643, 151643, 151643, 151643, 151643, 151643, 151643, 151643, 151643, 151643, 151643, 151643, 151643, 151643, 151643, 151643, 151643, 151643, 151643, 151643, 151643, 151643, 151643, 151643, 151643, 151643, 151643, 151643, 151643, 151643, 151643, 151643, 151643, 151643, 151643, 151643, 151643, 151643, 151643, 151643, 151643, 151643, 151643, 151643, 151643, 151643, 151643, 151643, 151643, 151643, 151643, 151643, 151643, 151643, 151643, 151643, 151643, 151643, 151643, 151643, 151643, 151643, 151643, 151643, 151643, 151643, 151643, 151643, 151643, 151643, 151643, 151643, 151643, 151643, 151643, 151643, 151643, 151643, 151643, 151643, 151643, 151643, 151643, 151643, 151643, 151643, 151643, 151643, 151643, 151643, 151643, 151643, 151643, 151643, 151643, 151643, 151643, 151643, 151643, 151643, 151643, 151643, 151643, 151643, 151643, 151643, 151643, 151643, 151643, 151643, 151643, 151643, 151643, 151643, 151643, 151643, 151643, 151643, 151643, 151643, 151643, 151643, 151643, 151643, 151643, 151643, 151643, 151643, 151643, 151643, 151643, 151643, 151643, 151643, 151643, 151643, 151643, 151643, 151643, 151643, 151643, 151643, 151643, 151643, 151643, 151643, 151643, 151643, 151643, 151643, 151643, 151643, 151643, 151643, 151643, 151643, 151643, 151643, 151643, 151643, 151643, 151643, 151643, 151643, 151643, 151643, 151643, 151643, 151643, 151643, 151643, 151643, 151643, 151643, 151643, 151643, 151643, 151643, 151643, 151643, 151643, 151643, 151643, 151643, 151643, 151643, 151643, 151643, 151643, 151643, 151643, 151643, 151643, 151643, 151643, 151643, 151643, 151643, 151643, 151643, 151643, 151643, 151643, 151643, 151643, 151643, 151643, 151643, 151643, 151643, 151643, 151643, 151643, 151643, 151643, 151643, 151643, 151643, 151643, 151643, 151643, 151643, 151643, 151643, 151643, 151643, 151643, 151643, 151643, 151643, 151643, 151643, 151643, 151643, 151643, 151643, 151643, 151643, 151643, 151643, 151643, 151643, 151643, 151643, 151643, 151643, 151643, 151643, 151643, 151643, 151643, 151643, 151643, 151643, 151643, 151643, 151643, 151643, 151643, 151643, 151643, 151643, 151643, 151643, 151643, 151643, 151643, 151643, 151643, 151643, 151643, 151643, 151643, 151643, 151643, 151643, 151643, 151643, 151643, 151643, 151643, 151643, 151643, 151643, 151643, 151643, 151643, 151643, 151643, 151643, 151643, 151643, 151643, 151643, 151643, 151643, 151643, 151643, 151643, 151643, 151643, 151643, 151643, 151643, 151643, 151643, 151643, 151643, 151643, 151643, 151643, 151643, 151643, 151643, 151643, 151643, 151643, 151643, 151643, 151643, 151643, 151643, 151643, 151643, 151643, 151643, 151643, 151643, 151643, 151643, 151643, 151643, 151643, 151643, 151643, 151643, 151643, 151643, 151643, 151643, 151643, 151643, 151643, 151643, 151643, 151643, 151643, 151643, 151643, 151643, 151643, 151643, 151643, 151643, 151643, 151643, 151643, 151643, 151643, 151643, 151643, 151643, 151643, 151643, 151643, 151643, 151643, 151643, 151643, 151643, 151643, 151643, 151643, 151643, 151643, 151643, 151643, 151643, 151643, 151643, 151643, 151643, 151643, 151643, 151643, 151643, 151643, 151643, 151643, 151643, 151643, 151643, 151643, 151643, 151643, 151643, 151643, 151643, 151643, 151643, 151643, 151643, 151643, 151643, 151643, 151643, 151643, 151643, 151643, 151643, 151643, 151643, 151643, 151643, 151643, 151643, 151643, 151643, 151643, 151643, 151643, 151643, 151643, 151643, 151643, 151643, 151643, 151643, 151643, 151643, 151643, 151643, 151643, 151643, 151643, 151643, 151643, 151643, 151643, 151643, 151643, 151643, 151643, 151643, 151643, 151643, 151643, 151643, 151643, 151643, 151643, 151643, 151643, 151643, 151643, 151643, 151643, 151643, 151643, 151643, 151643, 151643, 151643, 151643, 151643, 151643, 151643, 151643, 151643, 151643, 151643, 151643, 151643, 151643, 151643, 151643, 151643, 151643, 151643, 151643, 151643, 151643, 151643, 151643, 151643, 151643, 151643, 151643, 151643, 151643, 151643, 151643, 151643, 151643, 151643, 151643, 151643, 151643, 151643, 151643, 151643, 151644, 8948, 198, 2610, 525, 1207, 16948, 11, 3465, 553, 54364, 14817, 13, 1446, 525, 264, 10950, 17847, 13, 151645, 198, 151644, 872, 198, 16141, 279, 2701, 5248, 5754, 3405, 13, 576, 1537, 1555, 315, 697, 2033, 1265, 387, 315, 279, 2701, 3561, 25, 364, 16141, 25, 400, 20756, 4198, 6, 320, 28996, 17194, 8, 1380, 44428, 374, 825, 315, 19360, 35, 13, 21149, 3019, 553, 3019, 1573, 35764, 382, 785, 386, 1716, 12010, 399, 1195, 23606, 16555, 279, 6319, 1482, 320, 41, 8, 19041, 21720, 320, 53, 8, 7709, 315, 264, 86736, 3671, 304, 279, 3550, 12, 13891, 2852, 31511, 1482, 320, 50, 3140, 34, 8, 17484, 13, 576, 23606, 646, 387, 13302, 438, 198, 3, 619, 284, 1124, 37018, 90, 24, 15170, 23, 92, 1124, 31767, 1124, 15128, 1124, 37018, 90, 53, 61, 17, 15170, 43, 61, 18, 92, 25046, 2870, 57960, 31767, 3, 374, 279, 2746, 46162, 6783, 11, 57960, 15128, 3, 374, 279, 6757, 18602, 30039, 11, 323, 444, 374, 279, 3084, 315, 279, 3671, 13, 15920, 315, 279, 2701, 12239, 374, 830, 911, 279, 31839, 315, 419, 23606, 1939, 32, 8, 576, 386, 1716, 12010, 399, 1195, 23606, 374, 2697, 369, 264, 22862, 12577, 3175, 23992, 7253, 3671, 448, 902, 18602, 25071, 22103, 323, 81702, 57330, 1482, 624, 33, 8, 576, 386, 1716, 12010, 399, 1195, 23606, 374, 2697, 369, 264, 3175, 23992, 7253, 3671, 448, 264, 5016, 1716, 7891, 3645, 323, 81702, 57330, 1482, 624, 34, 8, 576, 386, 1716, 12010, 399, 1195, 23606, 374, 2697, 369, 264, 1378, 23992, 7253, 3671, 448, 458, 8670, 21220, 3645, 323, 81702, 57330, 1482, 624, 35, 8, 576, 386, 1716, 12010, 399, 1195, 23606, 374, 2697, 369, 264, 22862, 12577, 3175, 23992, 7253, 3671, 448, 458, 8670, 21220, 3645, 323, 81702, 33638, 1482, 13, 151645, 198, 151644, 77091, 198]",,302,413,715,1.0,1.0
4d0d01cb-3af5-411d-bc8e-0d4ff373664e,7,100,"[151643, 151643, 151643, 151643, 151643, 151643, 151643, 151643, 151643, 151643, 151643, 151643, 151643, 151643, 151643, 151643, 151643, 151643, 151643, 151643, 151643, 151643, 151643, 151643, 151643, 151643, 151643, 151643, 151643, 151643, 151643, 151643, 151643, 151643, 151643, 151643, 151643, 151643, 151643, 151643, 151643, 151643, 151643, 151643, 151643, 151643, 151643, 151643, 151643, 151643, 151643, 151643, 151643, 151643, 151643, 151643, 151643, 151643, 151643, 151643, 151643, 151643, 151643, 151643, 151643, 151643, 151643, 151643, 151643, 151643, 151643, 151643, 151643, 151643, 151643, 151643, 151643, 151643, 151643, 151643, 151643, 151643, 151643, 151643, 151643, 151643, 151643, 151643, 151643, 151643, 151643, 151643, 151643, 151643, 151643, 151643, 151643, 151643, 151643, 151643, 151643, 151643, 151643, 151643, 151643, 151643, 151643, 151643, 151643, 151643, 151643, 151643, 151643, 151643, 151643, 151643, 151643, 151643, 151643, 151643, 151643, 151643, 151643, 151643, 151643, 151643, 151643, 151643, 151643, 151643, 151643, 151643, 151643, 151643, 151643, 151643, 151643, 151643, 151643, 151643, 151643, 151643, 151643, 151643, 151643, 151643, 151643, 151643, 151643, 151643, 151643, 151643, 151643, 151643, 151643, 151643, 151643, 151643, 151643, 151643, 151643, 151643, 151643, 151643, 151643, 151643, 151643, 151643, 151643, 151643, 151643, 151643, 151643, 151643, 151643, 151643, 151643, 151643, 151643, 151643, 151643, 151643, 151643, 151643, 151643, 151643, 151643, 151643, 151643, 151643, 151643, 151643, 151643, 151643, 151643, 151643, 151643, 151643, 151643, 151643, 151643, 151643, 151643, 151643, 151643, 151643, 151643, 151643, 151643, 151643, 151643, 151643, 151643, 151643, 151643, 151643, 151643, 151643, 151643, 151643, 151643, 151643, 151643, 151643, 151643, 151643, 151643, 151643, 151643, 151643, 151643, 151643, 151643, 151643, 151643, 151643, 151643, 151643, 151643, 151643, 151643, 151643, 151643, 151643, 151643, 151643, 151643, 151643, 151643, 151643, 151643, 151643, 151643, 151643, 151643, 151643, 151643, 151643, 151643, 151643, 151643, 151643, 151643, 151643, 151643, 151643, 151643, 151643, 151643, 151643, 151643, 151643, 151643, 151643, 151643, 151643, 151643, 151643, 151643, 151643, 151643, 151643, 151643, 151643, 151643, 151643, 151643, 151643, 151643, 151643, 151643, 151643, 151643, 151643, 151643, 151643, 151643, 151643, 151643, 151643, 151643, 151643, 151643, 151643, 151643, 151643, 151643, 151643, 151643, 151643, 151643, 151643, 151643, 151643, 151643, 151643, 151643, 151643, 151643, 151643, 151643, 151643, 151643, 151643, 151643, 151643, 151643, 151643, 151643, 151643, 151643, 151643, 151643, 151643, 151643, 151643, 151643, 151643, 151643, 151643, 151643, 151643, 151643, 151643, 151643, 151643, 151643, 151643, 151643, 151643, 151643, 151643, 151643, 151643, 151643, 151643, 151643, 151643, 151643, 151643, 151643, 151643, 151643, 151643, 151643, 151643, 151643, 151643, 151643, 151643, 151643, 151643, 151643, 151643, 151643, 151643, 151643, 151643, 151643, 151643, 151643, 151643, 151643, 151643, 151643, 151643, 151643, 151643, 151643, 151643, 151643, 151643, 151643, 151643, 151643, 151643, 151643, 151643, 151643, 151643, 151643, 151643, 151643, 151643, 151643, 151643, 151643, 151643, 151643, 151643, 151643, 151643, 151643, 151643, 151643, 151643, 151643, 151643, 151643, 151643, 151643, 151643, 151643, 151643, 151643, 151643, 151643, 151643, 151643, 151643, 151643, 151643, 151643, 151643, 151643, 151643, 151643, 151643, 151643, 151643, 151643, 151643, 151643, 151643, 151643, 151643, 151643, 151643, 151643, 151643, 151643, 151643, 151643, 151643, 151643, 151643, 151643, 151643, 151643, 151643, 151643, 151643, 151643, 151643, 151643, 151643, 151643, 151643, 151643, 151643, 151643, 151643, 151643, 151643, 151643, 151643, 151643, 151643, 151643, 151643, 151643, 151643, 151643, 151643, 151643, 151643, 151643, 151643, 151643, 151643, 151643, 151643, 151643, 151643, 151643, 151643, 151643, 151643, 151643, 151643, 151643, 151643, 151643, 151643, 151643, 151643, 151643, 151643, 151643, 151643, 151643, 151643, 151643, 151643, 151643, 151643, 151643, 151643, 151643, 151643, 151643, 151643, 151643, 151643, 151643, 151643, 151643, 151643, 151643, 151643, 151643, 151643, 151643, 151643, 151643, 151643, 151643, 151643, 151643, 151643, 151643, 151643, 151643, 151643, 151643, 151643, 151643, 151643, 151643, 151643, 151643, 151643, 151643, 151643, 151643, 151643, 151643, 151643, 151643, 151643, 151643, 151643, 151643, 151643, 151643, 151643, 151643, 151643, 151643, 151643, 151643, 151643, 151643, 151643, 151643, 151643, 151643, 151643, 151643, 151643, 151643, 151643, 151643, 151643, 151643, 151643, 151643, 151643, 151643, 151643, 151643, 151643, 151643, 151643, 151643, 151643, 151643, 151643, 151643, 151643, 151643, 151643, 151643, 151643, 151643, 151643, 151643, 151643, 151643, 151643, 151643, 151643, 151643, 151643, 151643, 151643, 151643, 151643, 151643, 151643, 151643, 151643, 151643, 151643, 151643, 151643, 151643, 151643, 151643, 151643, 151643, 151643, 151643, 151643, 151643, 151643, 151643, 151643, 151643, 151643, 151643, 151643, 151643, 151643, 151643, 151643, 151643, 151643, 151643, 151643, 151643, 151643, 151643, 151643, 151643, 151643, 151643, 151643, 151643, 151643, 151643, 151643, 151643, 151643, 151643, 151643, 151643, 151643, 151643, 151643, 151643, 151643, 151643, 151643, 151643, 151643, 151643, 151643, 151643, 151643, 151643, 151643, 151643, 151643, 151643, 151643, 151643, 151643, 151643, 151643, 151643, 151643, 151643, 151643, 151643, 151643, 151643, 151643, 151643, 151643, 151643, 151643, 151643, 151643, 151643, 151643, 151643, 151643, 151643, 151643, 151643, 151643, 151643, 151643, 151643, 151643, 151643, 151643, 151643, 151643, 151643, 151643, 151643, 151643, 151643, 151643, 151643, 151643, 151643, 151643, 151643, 151643, 151643, 151643, 151643, 151643, 151643, 151643, 151643, 151643, 151643, 151643, 151643, 151643, 151643, 151643, 151643, 151644, 8948, 198, 2610, 525, 1207, 16948, 11, 3465, 553, 54364, 14817, 13, 1446, 525, 264, 10950, 17847, 13, 151645, 198, 151644, 872, 198, 16141, 279, 2701, 5248, 5754, 3405, 13, 576, 1537, 1555, 315, 697, 2033, 1265, 387, 315, 279, 2701, 3561, 25, 364, 16141, 25, 400, 20756, 4198, 6, 320, 28996, 17194, 8, 1380, 44428, 374, 825, 315, 19360, 35, 13, 21149, 3019, 553, 3019, 1573, 35764, 382, 641, 279, 10072, 11, 264, 8424, 380, 51014, 458, 52773, 16486, 448, 264, 4158, 6437, 4766, 13, 1260, 85681, 279, 2701, 55977, 1995, 304, 1973, 311, 10542, 279, 14473, 13, 7405, 264, 13276, 23759, 23776, 369, 279, 64478, 5506, 1667, 279, 1995, 3897, 624, 25824, 25, 30106, 27672, 16162, 518, 296, 31082, 284, 220, 16, 20, 21, 320, 16, 15, 15, 4, 340, 64, 16162, 518, 296, 31082, 284, 220, 16, 20, 23, 320, 18, 17, 4, 340, 2801, 549, 7205, 16162, 504, 220, 18, 20, 15, 15, 12, 17, 22, 15, 15, 9961, 49309, 16, 11, 3746, 17232, 16162, 518, 220, 16, 22, 17, 15, 9961, 12, 16, 198, 16, 39, 451, 18446, 25, 220, 16, 16, 13, 15, 63597, 320, 82, 11, 220, 16, 39, 701, 220, 23, 13, 15, 17, 63597, 320, 67, 11, 220, 17, 39, 701, 220, 22, 13, 22, 17, 320, 67, 11, 220, 17, 39, 692, 32, 8, 220, 17, 11582, 9566, 674, 268, 12738, 292, 13621, 198, 33, 8, 220, 19, 11582, 9566, 674, 268, 12738, 292, 13621, 198, 34, 8, 220, 18, 29553, 9566, 78, 12, 17, 2832, 67007, 4130, 7964, 89, 278, 85736, 198, 35, 8, 68783, 3923, 36733, 78, 627, 349, 151645, 198, 151644, 77091, 198]",,277,600,877,1.0,1.0
271c145d-8b75-474a-b54c-e5005387087e,7,101,"[151643, 151643, 151643, 151643, 151643, 151643, 151643, 151643, 151643, 151643, 151643, 151643, 151643, 151643, 151643, 151643, 151643, 151643, 151643, 151643, 151643, 151643, 151643, 151643, 151643, 151643, 151643, 151643, 151643, 151643, 151643, 151643, 151643, 151643, 151643, 151643, 151643, 151643, 151643, 151643, 151643, 151643, 151643, 151643, 151643, 151643, 151643, 151643, 151643, 151643, 151643, 151643, 151643, 151643, 151643, 151643, 151643, 151643, 151643, 151643, 151643, 151643, 151643, 151643, 151643, 151643, 151643, 151643, 151643, 151643, 151643, 151643, 151643, 151643, 151643, 151643, 151643, 151643, 151643, 151643, 151643, 151643, 151643, 151643, 151643, 151643, 151643, 151643, 151643, 151643, 151643, 151643, 151643, 151643, 151643, 151643, 151643, 151643, 151643, 151643, 151643, 151643, 151643, 151643, 151643, 151643, 151643, 151643, 151643, 151643, 151643, 151643, 151643, 151643, 151643, 151643, 151643, 151643, 151643, 151643, 151643, 151643, 151643, 151643, 151643, 151643, 151643, 151643, 151643, 151643, 151643, 151643, 151643, 151643, 151643, 151643, 151643, 151643, 151643, 151643, 151643, 151643, 151643, 151643, 151643, 151643, 151643, 151643, 151643, 151643, 151643, 151643, 151643, 151643, 151643, 151643, 151643, 151643, 151643, 151643, 151643, 151643, 151643, 151643, 151643, 151643, 151643, 151643, 151643, 151643, 151643, 151643, 151643, 151643, 151643, 151643, 151643, 151643, 151643, 151643, 151643, 151643, 151643, 151643, 151643, 151643, 151643, 151643, 151643, 151643, 151643, 151643, 151643, 151643, 151643, 151643, 151643, 151643, 151643, 151643, 151643, 151643, 151643, 151643, 151643, 151643, 151643, 151643, 151643, 151643, 151643, 151643, 151643, 151643, 151643, 151643, 151643, 151643, 151643, 151643, 151643, 151643, 151643, 151643, 151643, 151643, 151643, 151643, 151643, 151643, 151643, 151643, 151643, 151643, 151643, 151643, 151643, 151643, 151643, 151643, 151643, 151643, 151643, 151643, 151643, 151643, 151643, 151643, 151643, 151643, 151643, 151643, 151643, 151643, 151643, 151643, 151643, 151643, 151643, 151643, 151643, 151643, 151643, 151643, 151643, 151643, 151643, 151643, 151643, 151643, 151643, 151643, 151643, 151643, 151643, 151643, 151643, 151643, 151643, 151643, 151643, 151643, 151643, 151643, 151643, 151643, 151643, 151643, 151643, 151643, 151643, 151643, 151643, 151643, 151643, 151643, 151643, 151643, 151643, 151643, 151643, 151643, 151643, 151643, 151643, 151643, 151643, 151643, 151643, 151643, 151643, 151643, 151643, 151643, 151643, 151643, 151643, 151643, 151643, 151643, 151643, 151643, 151643, 151643, 151643, 151643, 151643, 151643, 151643, 151643, 151643, 151643, 151643, 151643, 151643, 151643, 151643, 151643, 151643, 151643, 151643, 151643, 151643, 151643, 151643, 151643, 151643, 151643, 151643, 151643, 151643, 151643, 151643, 151643, 151643, 151643, 151643, 151643, 151643, 151643, 151643, 151643, 151643, 151643, 151643, 151643, 151643, 151643, 151643, 151643, 151643, 151643, 151643, 151643, 151643, 151643, 151643, 151643, 151643, 151643, 151643, 151643, 151643, 151643, 151643, 151643, 151643, 151643, 151643, 151643, 151643, 151643, 151643, 151643, 151643, 151643, 151643, 151643, 151643, 151643, 151643, 151643, 151643, 151643, 151643, 151643, 151643, 151643, 151643, 151643, 151643, 151643, 151643, 151643, 151643, 151643, 151643, 151643, 151643, 151643, 151643, 151643, 151643, 151643, 151643, 151643, 151643, 151643, 151643, 151643, 151643, 151643, 151643, 151643, 151643, 151643, 151643, 151643, 151643, 151643, 151643, 151643, 151643, 151643, 151643, 151643, 151643, 151643, 151643, 151643, 151643, 151643, 151643, 151643, 151643, 151643, 151643, 151643, 151643, 151643, 151643, 151643, 151643, 151643, 151643, 151643, 151643, 151643, 151643, 151643, 151643, 151643, 151643, 151643, 151643, 151643, 151643, 151643, 151643, 151643, 151643, 151643, 151643, 151643, 151643, 151643, 151643, 151643, 151643, 151643, 151643, 151643, 151643, 151643, 151643, 151643, 151643, 151643, 151643, 151643, 151643, 151643, 151643, 151643, 151643, 151643, 151643, 151643, 151643, 151643, 151643, 151643, 151643, 151643, 151643, 151643, 151643, 151643, 151643, 151643, 151643, 151643, 151643, 151643, 151643, 151643, 151643, 151643, 151643, 151643, 151643, 151643, 151643, 151643, 151643, 151643, 151643, 151643, 151643, 151643, 151643, 151643, 151643, 151643, 151643, 151643, 151643, 151643, 151643, 151643, 151643, 151643, 151643, 151643, 151643, 151643, 151643, 151643, 151643, 151643, 151643, 151643, 151643, 151643, 151643, 151643, 151643, 151643, 151643, 151643, 151643, 151643, 151643, 151643, 151643, 151643, 151643, 151643, 151643, 151643, 151643, 151643, 151643, 151643, 151643, 151643, 151643, 151643, 151643, 151643, 151643, 151643, 151643, 151643, 151643, 151643, 151643, 151643, 151643, 151643, 151643, 151643, 151643, 151643, 151643, 151643, 151643, 151643, 151643, 151643, 151643, 151643, 151643, 151643, 151643, 151643, 151643, 151643, 151643, 151643, 151643, 151643, 151643, 151643, 151643, 151643, 151643, 151643, 151643, 151643, 151643, 151643, 151643, 151643, 151643, 151643, 151643, 151643, 151643, 151643, 151643, 151643, 151643, 151643, 151643, 151643, 151643, 151643, 151643, 151643, 151643, 151643, 151643, 151643, 151643, 151643, 151643, 151643, 151643, 151643, 151643, 151643, 151643, 151643, 151643, 151643, 151643, 151643, 151643, 151643, 151643, 151644, 8948, 198, 2610, 525, 1207, 16948, 11, 3465, 553, 54364, 14817, 13, 1446, 525, 264, 10950, 17847, 13, 151645, 198, 151644, 872, 198, 16141, 279, 2701, 5248, 5754, 3405, 13, 576, 1537, 1555, 315, 697, 2033, 1265, 387, 315, 279, 2701, 3561, 25, 364, 16141, 25, 400, 20756, 4198, 6, 320, 28996, 17194, 8, 1380, 44428, 374, 825, 315, 19360, 35, 13, 21149, 3019, 553, 3019, 1573, 35764, 382, 50, 7287, 19, 2832, 67007, 87, 3337, 3337, 385, 17308, 12, 17, 20767, 12, 16, 18589, 374, 11758, 448, 97114, 12, 3983, 88, 507, 318, 41872, 82, 1541, 75, 81782, 323, 2406, 41872, 19991, 11, 29064, 1985, 220, 16, 382, 16, 374, 11758, 448, 2350, 17, 44819, 45421, 518, 3347, 9315, 11, 8110, 553, 70946, 3923, 93471, 577, 11, 29064, 1985, 220, 17, 382, 17, 374, 11758, 448, 444, 6352, 323, 78987, 316, 769, 2145, 518, 3347, 9315, 11, 29064, 1985, 220, 18, 382, 4816, 220, 18, 374, 4228, 67, 448, 65200, 782, 472, 5066, 11, 29064, 1590, 1985, 220, 19, 13, 1128, 374, 279, 5944, 315, 1985, 220, 19, 1939, 32, 8, 320, 17, 50, 11, 18, 50, 11, 19, 50, 7287, 17, 1455, 16597, 3923, 12, 19, 2832, 67007, 4130, 12, 17, 1448, 41872, 12, 18, 12, 14769, 3923, 66, 3337, 385, 17308, 276, 12, 16, 18589, 198, 33, 8, 320, 16, 50, 11, 17, 50, 11, 19, 50, 7287, 16, 8013, 7964, 4246, 385, 4130, 7287, 17, 1448, 41872, 12, 16, 11, 17, 11, 18, 11, 19, 2385, 295, 956, 66129, 40995, 16, 11, 16, 24293, 65, 573, 12032, 3923, 11696, 19, 12, 337, 198, 34, 8, 320, 17, 50, 11, 18, 49, 11, 19, 50, 11, 21, 50, 7287, 17, 1455, 16597, 3923, 12, 19, 2832, 67007, 4130, 12, 21, 1448, 41872, 12, 18, 12, 14769, 3923, 66, 3337, 385, 17308, 276, 12, 16, 18589, 198, 35, 8, 320, 17, 49, 11, 18, 49, 11, 19, 50, 7287, 17, 1455, 16597, 3923, 12, 19, 2832, 67007, 4130, 12, 17, 1448, 41872, 12, 18, 12, 14769, 3923, 66, 3337, 385, 17308, 276, 12, 16, 18589, 151645, 198, 151644, 77091, 198]",,353,563,916,1.0,1.0
f47d3a8a-1279-4694-8658-0a44874e6db6,7,102,"[151643, 151643, 151643, 151643, 151643, 151643, 151643, 151643, 151643, 151643, 151643, 151643, 151643, 151643, 151643, 151643, 151643, 151643, 151643, 151643, 151643, 151643, 151643, 151643, 151643, 151643, 151643, 151643, 151643, 151643, 151643, 151643, 151643, 151643, 151643, 151643, 151643, 151643, 151643, 151643, 151643, 151643, 151643, 151643, 151643, 151643, 151643, 151643, 151643, 151643, 151643, 151643, 151643, 151643, 151643, 151643, 151643, 151643, 151643, 151643, 151643, 151643, 151643, 151643, 151643, 151643, 151643, 151643, 151643, 151643, 151643, 151643, 151643, 151643, 151643, 151643, 151643, 151643, 151643, 151643, 151643, 151643, 151643, 151643, 151643, 151643, 151643, 151643, 151643, 151643, 151643, 151643, 151643, 151643, 151643, 151643, 151643, 151643, 151643, 151643, 151643, 151643, 151643, 151643, 151643, 151643, 151643, 151643, 151643, 151643, 151643, 151643, 151643, 151643, 151643, 151643, 151643, 151643, 151643, 151643, 151643, 151643, 151643, 151643, 151643, 151643, 151643, 151643, 151643, 151643, 151643, 151643, 151643, 151643, 151643, 151643, 151643, 151643, 151643, 151643, 151643, 151643, 151643, 151643, 151643, 151643, 151643, 151643, 151643, 151643, 151643, 151643, 151643, 151643, 151643, 151643, 151643, 151643, 151643, 151643, 151643, 151643, 151643, 151643, 151643, 151643, 151643, 151643, 151643, 151643, 151643, 151643, 151643, 151643, 151643, 151643, 151643, 151643, 151643, 151643, 151643, 151643, 151643, 151643, 151643, 151643, 151643, 151643, 151643, 151643, 151643, 151643, 151643, 151643, 151643, 151643, 151643, 151643, 151643, 151643, 151643, 151643, 151643, 151643, 151643, 151643, 151643, 151643, 151643, 151643, 151643, 151643, 151643, 151643, 151643, 151643, 151643, 151643, 151643, 151643, 151643, 151643, 151643, 151643, 151643, 151643, 151643, 151643, 151643, 151643, 151643, 151643, 151643, 151643, 151643, 151643, 151643, 151643, 151643, 151643, 151643, 151643, 151643, 151643, 151643, 151643, 151643, 151643, 151643, 151643, 151643, 151643, 151643, 151643, 151643, 151643, 151643, 151643, 151643, 151643, 151643, 151643, 151643, 151643, 151643, 151643, 151643, 151643, 151643, 151643, 151643, 151643, 151643, 151643, 151643, 151643, 151643, 151643, 151643, 151643, 151643, 151643, 151643, 151643, 151643, 151643, 151643, 151643, 151643, 151643, 151643, 151643, 151643, 151643, 151643, 151643, 151643, 151643, 151643, 151643, 151643, 151643, 151643, 151643, 151643, 151643, 151643, 151643, 151643, 151643, 151643, 151643, 151643, 151643, 151643, 151643, 151643, 151643, 151643, 151643, 151643, 151643, 151643, 151643, 151643, 151643, 151643, 151643, 151643, 151643, 151643, 151643, 151643, 151643, 151643, 151643, 151643, 151643, 151643, 151643, 151643, 151643, 151643, 151643, 151643, 151643, 151643, 151643, 151643, 151643, 151643, 151643, 151643, 151643, 151643, 151643, 151643, 151643, 151643, 151643, 151643, 151643, 151643, 151643, 151643, 151643, 151643, 151643, 151643, 151643, 151643, 151643, 151643, 151643, 151643, 151643, 151643, 151643, 151643, 151643, 151643, 151643, 151643, 151643, 151643, 151643, 151643, 151643, 151643, 151643, 151643, 151643, 151643, 151643, 151643, 151643, 151643, 151643, 151643, 151643, 151643, 151643, 151643, 151643, 151643, 151643, 151643, 151643, 151643, 151643, 151643, 151643, 151643, 151643, 151643, 151643, 151643, 151643, 151643, 151643, 151643, 151643, 151643, 151643, 151643, 151643, 151643, 151643, 151643, 151643, 151643, 151643, 151643, 151643, 151643, 151643, 151643, 151643, 151643, 151643, 151643, 151643, 151643, 151643, 151643, 151643, 151643, 151643, 151643, 151643, 151643, 151643, 151643, 151643, 151643, 151643, 151643, 151643, 151643, 151643, 151643, 151643, 151643, 151643, 151643, 151643, 151643, 151643, 151643, 151643, 151643, 151643, 151643, 151643, 151643, 151643, 151643, 151643, 151643, 151643, 151643, 151643, 151643, 151643, 151643, 151643, 151643, 151643, 151643, 151643, 151643, 151643, 151643, 151643, 151643, 151643, 151643, 151643, 151643, 151643, 151643, 151643, 151643, 151643, 151643, 151643, 151643, 151643, 151643, 151643, 151643, 151643, 151643, 151643, 151643, 151643, 151643, 151643, 151643, 151643, 151643, 151643, 151643, 151643, 151643, 151643, 151643, 151643, 151643, 151643, 151643, 151643, 151643, 151643, 151643, 151643, 151643, 151643, 151643, 151643, 151643, 151643, 151643, 151643, 151643, 151643, 151643, 151643, 151643, 151643, 151643, 151643, 151643, 151643, 151643, 151643, 151643, 151643, 151643, 151643, 151643, 151643, 151643, 151643, 151643, 151643, 151643, 151643, 151643, 151643, 151643, 151643, 151643, 151643, 151643, 151643, 151643, 151643, 151643, 151643, 151643, 151643, 151643, 151643, 151643, 151643, 151643, 151643, 151643, 151643, 151643, 151643, 151643, 151643, 151643, 151643, 151643, 151643, 151643, 151643, 151643, 151643, 151643, 151643, 151643, 151643, 151643, 151643, 151643, 151643, 151643, 151643, 151643, 151643, 151643, 151643, 151643, 151643, 151643, 151643, 151643, 151643, 151643, 151643, 151643, 151643, 151643, 151643, 151643, 151643, 151643, 151643, 151643, 151643, 151643, 151643, 151643, 151643, 151643, 151643, 151643, 151643, 151643, 151643, 151643, 151643, 151643, 151643, 151643, 151643, 151643, 151643, 151643, 151643, 151643, 151643, 151643, 151643, 151643, 151643, 151643, 151643, 151643, 151643, 151643, 151643, 151643, 151643, 151643, 151643, 151643, 151643, 151643, 151643, 151643, 151643, 151643, 151643, 151643, 151643, 151643, 151643, 151643, 151643, 151643, 151643, 151643, 151643, 151643, 151643, 151643, 151643, 151643, 151643, 151643, 151643, 151643, 151643, 151643, 151643, 151643, 151643, 151643, 151643, 151643, 151643, 151643, 151643, 151643, 151643, 151643, 151643, 151643, 151643, 151643, 151643, 151643, 151643, 151643, 151643, 151643, 151643, 151643, 151643, 151643, 151643, 151643, 151643, 151643, 151643, 151643, 151643, 151643, 151643, 151643, 151643, 151643, 151643, 151643, 151643, 151643, 151643, 151643, 151643, 151643, 151643, 151643, 151643, 151643, 151643, 151643, 151643, 151643, 151643, 151643, 151643, 151643, 151643, 151643, 151643, 151643, 151643, 151643, 151643, 151643, 151643, 151643, 151643, 151643, 151643, 151643, 151643, 151643, 151643, 151643, 151643, 151643, 151643, 151643, 151643, 151643, 151643, 151643, 151643, 151643, 151643, 151643, 151643, 151643, 151643, 151643, 151643, 151643, 151643, 151643, 151643, 151643, 151643, 151643, 151643, 151643, 151643, 151643, 151643, 151643, 151643, 151643, 151643, 151643, 151643, 151643, 151643, 151643, 151643, 151643, 151643, 151643, 151643, 151643, 151643, 151643, 151643, 151643, 151643, 151643, 151643, 151643, 151643, 151643, 151643, 151643, 151643, 151643, 151643, 151643, 151643, 151643, 151643, 151643, 151643, 151643, 151643, 151643, 151643, 151643, 151643, 151643, 151643, 151643, 151643, 151643, 151643, 151643, 151643, 151643, 151643, 151643, 151643, 151643, 151643, 151643, 151644, 8948, 198, 2610, 525, 1207, 16948, 11, 3465, 553, 54364, 14817, 13, 1446, 525, 264, 10950, 17847, 13, 151645, 198, 151644, 872, 198, 16141, 279, 2701, 5248, 5754, 3405, 13, 576, 1537, 1555, 315, 697, 2033, 1265, 387, 315, 279, 2701, 3561, 25, 364, 16141, 25, 400, 20756, 4198, 6, 320, 28996, 17194, 8, 1380, 44428, 374, 825, 315, 19360, 35, 13, 21149, 3019, 553, 3019, 1573, 35764, 382, 32, 5458, 67925, 429, 566, 11052, 32073, 2337, 264, 30578, 304, 24394, 51655, 11, 12880, 279, 2701, 32143, 5114, 304, 264, 1273, 510, 1001, 4195, 71831, 2673, 11, 23552, 374, 264, 4593, 1940, 35072, 517, 304, 6770, 9904, 13, 730, 29876, 2673, 11, 23552, 68845, 4593, 1940, 304, 83803, 9904, 624, 23085, 10601, 315, 42283, 14, 4519, 261, 323, 10596, 2687, 14772, 374, 4396, 1939, 32, 8, 16245, 1365, 28393, 198, 33, 8, 42283, 481, 28393, 198, 34, 8, 42283, 1365, 10596, 198, 35, 8, 16245, 1365, 10596, 151645, 198, 151644, 77091, 198]",,163,188,351,0.0,0.0
fb87ef6b-412b-4a14-88e3-9177a6c40aaf,7,103,"[151643, 151643, 151643, 151643, 151643, 151643, 151643, 151643, 151643, 151643, 151643, 151643, 151643, 151643, 151643, 151643, 151643, 151643, 151643, 151643, 151643, 151643, 151643, 151643, 151643, 151643, 151643, 151643, 151643, 151643, 151643, 151643, 151643, 151643, 151643, 151643, 151643, 151643, 151643, 151643, 151643, 151643, 151643, 151643, 151643, 151643, 151643, 151643, 151643, 151643, 151643, 151643, 151643, 151643, 151643, 151643, 151643, 151643, 151643, 151643, 151643, 151643, 151643, 151643, 151643, 151643, 151643, 151643, 151643, 151643, 151643, 151643, 151643, 151643, 151643, 151643, 151643, 151643, 151643, 151643, 151643, 151643, 151643, 151643, 151643, 151643, 151643, 151643, 151643, 151643, 151643, 151643, 151643, 151643, 151643, 151643, 151643, 151643, 151643, 151643, 151643, 151643, 151643, 151643, 151643, 151643, 151643, 151643, 151643, 151643, 151643, 151643, 151643, 151643, 151643, 151643, 151643, 151643, 151643, 151643, 151643, 151643, 151643, 151643, 151643, 151643, 151643, 151643, 151643, 151643, 151643, 151643, 151643, 151643, 151643, 151643, 151643, 151643, 151643, 151643, 151643, 151643, 151643, 151643, 151643, 151643, 151643, 151643, 151643, 151643, 151643, 151643, 151643, 151643, 151643, 151643, 151643, 151643, 151643, 151643, 151643, 151643, 151643, 151643, 151643, 151643, 151643, 151643, 151643, 151643, 151643, 151643, 151643, 151643, 151643, 151643, 151643, 151643, 151643, 151643, 151643, 151643, 151643, 151643, 151643, 151643, 151643, 151643, 151643, 151643, 151643, 151643, 151643, 151643, 151643, 151643, 151643, 151643, 151643, 151643, 151643, 151643, 151643, 151643, 151643, 151643, 151643, 151643, 151643, 151643, 151643, 151643, 151643, 151643, 151643, 151643, 151643, 151643, 151643, 151643, 151643, 151643, 151643, 151643, 151643, 151643, 151643, 151643, 151643, 151643, 151643, 151643, 151643, 151643, 151643, 151643, 151643, 151643, 151643, 151643, 151643, 151643, 151643, 151643, 151643, 151643, 151643, 151643, 151643, 151643, 151643, 151643, 151643, 151643, 151643, 151643, 151643, 151643, 151643, 151643, 151643, 151643, 151643, 151643, 151643, 151643, 151643, 151643, 151643, 151643, 151643, 151643, 151643, 151643, 151643, 151643, 151643, 151643, 151643, 151643, 151643, 151643, 151643, 151643, 151643, 151643, 151643, 151643, 151643, 151643, 151643, 151643, 151643, 151643, 151643, 151643, 151643, 151643, 151643, 151643, 151643, 151643, 151643, 151643, 151643, 151643, 151643, 151643, 151643, 151643, 151643, 151643, 151643, 151643, 151643, 151643, 151643, 151643, 151643, 151643, 151643, 151643, 151643, 151643, 151643, 151643, 151643, 151643, 151643, 151643, 151643, 151643, 151643, 151643, 151643, 151643, 151643, 151643, 151643, 151643, 151643, 151643, 151643, 151643, 151643, 151643, 151643, 151643, 151643, 151643, 151643, 151643, 151643, 151643, 151643, 151643, 151643, 151643, 151643, 151643, 151643, 151643, 151643, 151643, 151643, 151643, 151643, 151643, 151643, 151643, 151643, 151643, 151643, 151643, 151643, 151643, 151643, 151643, 151643, 151643, 151643, 151643, 151643, 151643, 151643, 151643, 151643, 151643, 151643, 151643, 151643, 151643, 151643, 151643, 151643, 151643, 151643, 151643, 151643, 151643, 151643, 151643, 151643, 151643, 151643, 151643, 151643, 151643, 151643, 151643, 151643, 151643, 151643, 151643, 151643, 151643, 151643, 151643, 151643, 151643, 151643, 151643, 151643, 151643, 151643, 151643, 151643, 151643, 151643, 151643, 151643, 151643, 151643, 151643, 151643, 151643, 151643, 151643, 151643, 151643, 151643, 151643, 151643, 151643, 151643, 151643, 151643, 151643, 151643, 151643, 151643, 151643, 151643, 151643, 151643, 151643, 151643, 151643, 151643, 151643, 151643, 151643, 151643, 151643, 151643, 151643, 151643, 151643, 151643, 151643, 151643, 151643, 151643, 151643, 151643, 151643, 151643, 151643, 151643, 151643, 151643, 151643, 151643, 151643, 151643, 151643, 151643, 151643, 151643, 151643, 151643, 151643, 151643, 151643, 151643, 151643, 151643, 151643, 151643, 151643, 151643, 151643, 151643, 151643, 151643, 151643, 151643, 151643, 151643, 151643, 151643, 151643, 151643, 151643, 151643, 151643, 151643, 151643, 151643, 151643, 151643, 151643, 151643, 151643, 151643, 151643, 151643, 151643, 151643, 151643, 151643, 151643, 151643, 151643, 151643, 151643, 151643, 151643, 151643, 151643, 151643, 151643, 151643, 151643, 151643, 151643, 151643, 151643, 151643, 151643, 151643, 151643, 151643, 151643, 151643, 151643, 151643, 151643, 151643, 151643, 151643, 151643, 151643, 151643, 151643, 151643, 151643, 151643, 151643, 151643, 151643, 151643, 151643, 151643, 151643, 151643, 151643, 151643, 151643, 151643, 151643, 151643, 151643, 151643, 151643, 151643, 151643, 151643, 151643, 151643, 151643, 151643, 151643, 151643, 151643, 151643, 151643, 151643, 151643, 151643, 151643, 151643, 151643, 151643, 151643, 151643, 151643, 151643, 151643, 151643, 151643, 151643, 151643, 151643, 151643, 151643, 151643, 151643, 151643, 151643, 151643, 151643, 151643, 151643, 151643, 151643, 151643, 151643, 151643, 151643, 151643, 151643, 151643, 151643, 151643, 151643, 151643, 151643, 151643, 151643, 151643, 151643, 151643, 151643, 151643, 151643, 151643, 151643, 151643, 151643, 151643, 151643, 151643, 151643, 151643, 151643, 151643, 151643, 151643, 151643, 151643, 151643, 151643, 151643, 151643, 151643, 151643, 151643, 151643, 151643, 151643, 151643, 151643, 151643, 151643, 151643, 151643, 151643, 151643, 151643, 151643, 151643, 151643, 151643, 151643, 151643, 151643, 151643, 151643, 151643, 151643, 151643, 151643, 151643, 151643, 151643, 151643, 151643, 151643, 151643, 151643, 151643, 151643, 151643, 151643, 151643, 151643, 151643, 151643, 151643, 151643, 151643, 151643, 151643, 151643, 151643, 151643, 151643, 151643, 151643, 151643, 151643, 151643, 151643, 151643, 151643, 151643, 151643, 151643, 151643, 151643, 151643, 151643, 151643, 151643, 151643, 151643, 151643, 151643, 151643, 151643, 151643, 151643, 151643, 151643, 151643, 151643, 151643, 151643, 151643, 151643, 151643, 151643, 151643, 151643, 151643, 151643, 151643, 151643, 151643, 151643, 151643, 151643, 151643, 151643, 151643, 151643, 151643, 151643, 151643, 151643, 151643, 151643, 151643, 151643, 151643, 151643, 151643, 151643, 151643, 151643, 151643, 151643, 151643, 151643, 151643, 151643, 151643, 151643, 151643, 151643, 151643, 151643, 151643, 151643, 151643, 151643, 151643, 151643, 151643, 151644, 8948, 198, 2610, 525, 1207, 16948, 11, 3465, 553, 54364, 14817, 13, 1446, 525, 264, 10950, 17847, 13, 151645, 198, 151644, 872, 198, 16141, 279, 2701, 5248, 5754, 3405, 13, 576, 1537, 1555, 315, 697, 2033, 1265, 387, 315, 279, 2701, 3561, 25, 364, 16141, 25, 400, 20756, 4198, 6, 320, 28996, 17194, 8, 1380, 44428, 374, 825, 315, 19360, 35, 13, 21149, 3019, 553, 3019, 1573, 35764, 382, 1654, 614, 264, 6291, 8482, 3539, 7, 5543, 8, 64025, 323, 61328, 509, 8339, 349, 11, 1380, 279, 2790, 33828, 3145, 19950, 374, 272, 3025, 78, 8, 284, 220, 16, 15, 49309, 17, 386, 323, 279, 508, 3540, 45, 12, 60, 19950, 374, 220, 15, 13, 16, 386, 13, 576, 19753, 18021, 315, 279, 33828, 3145, 7, 5543, 8, 61328, 509, 8339, 4330, 68025, 525, 33218, 16, 28, 24, 11, 33218, 17, 28, 19, 15, 11, 33218, 18, 28, 21, 18, 323, 33218, 19, 28, 16, 21, 13, 3555, 686, 387, 279, 11414, 315, 279, 6303, 294, 410, 73352, 8339, 4330, 33828, 3145, 7, 5543, 8, 68025, 4221, 678, 33828, 3145, 8482, 9419, 304, 279, 6291, 1939, 32, 8, 220, 19, 17, 13, 18, 13744, 33, 8, 220, 18, 23, 13, 16, 13744, 34, 8, 220, 16, 21, 13, 24, 13744, 35, 8, 220, 17, 20, 13, 21, 4, 151645, 198, 151644, 77091, 198]",,224,1314,1538,0.0,0.0
eaac347d-2efe-473f-adc5-169fea27fca1,7,104,"[151643, 151643, 151643, 151643, 151643, 151643, 151643, 151643, 151643, 151643, 151643, 151643, 151643, 151643, 151643, 151643, 151643, 151643, 151643, 151643, 151643, 151643, 151643, 151643, 151643, 151643, 151643, 151643, 151643, 151643, 151643, 151643, 151643, 151643, 151643, 151643, 151643, 151643, 151643, 151643, 151643, 151643, 151643, 151643, 151643, 151643, 151643, 151643, 151643, 151643, 151643, 151643, 151643, 151643, 151643, 151643, 151643, 151643, 151643, 151643, 151643, 151643, 151643, 151643, 151643, 151643, 151643, 151643, 151643, 151643, 151643, 151643, 151643, 151643, 151643, 151643, 151643, 151643, 151643, 151643, 151643, 151643, 151643, 151643, 151643, 151643, 151643, 151643, 151643, 151643, 151643, 151643, 151643, 151643, 151643, 151643, 151643, 151643, 151643, 151643, 151643, 151643, 151643, 151643, 151643, 151643, 151643, 151643, 151643, 151643, 151643, 151643, 151643, 151643, 151643, 151643, 151643, 151643, 151643, 151643, 151643, 151643, 151643, 151643, 151643, 151643, 151643, 151643, 151643, 151643, 151643, 151643, 151643, 151643, 151643, 151643, 151643, 151643, 151643, 151643, 151643, 151643, 151643, 151643, 151643, 151643, 151643, 151643, 151643, 151643, 151643, 151643, 151643, 151643, 151643, 151643, 151643, 151643, 151643, 151643, 151643, 151643, 151643, 151643, 151643, 151643, 151643, 151643, 151643, 151643, 151643, 151643, 151643, 151643, 151643, 151643, 151643, 151643, 151643, 151643, 151643, 151643, 151643, 151643, 151643, 151643, 151643, 151643, 151643, 151643, 151643, 151643, 151643, 151643, 151643, 151643, 151643, 151643, 151643, 151643, 151643, 151643, 151643, 151643, 151643, 151643, 151643, 151643, 151643, 151643, 151643, 151643, 151643, 151643, 151643, 151643, 151643, 151643, 151643, 151643, 151643, 151643, 151643, 151643, 151643, 151643, 151643, 151643, 151643, 151643, 151643, 151643, 151643, 151643, 151643, 151643, 151643, 151643, 151643, 151643, 151643, 151643, 151643, 151643, 151643, 151643, 151643, 151643, 151643, 151643, 151643, 151643, 151643, 151643, 151643, 151643, 151643, 151643, 151643, 151643, 151643, 151643, 151643, 151643, 151643, 151643, 151643, 151643, 151643, 151643, 151643, 151643, 151643, 151643, 151643, 151643, 151643, 151643, 151643, 151643, 151643, 151643, 151643, 151643, 151643, 151643, 151643, 151643, 151643, 151643, 151643, 151643, 151643, 151643, 151643, 151643, 151643, 151643, 151643, 151643, 151643, 151643, 151643, 151643, 151643, 151643, 151643, 151643, 151643, 151643, 151643, 151643, 151643, 151643, 151643, 151643, 151643, 151643, 151643, 151643, 151643, 151643, 151643, 151643, 151643, 151643, 151643, 151643, 151643, 151643, 151643, 151643, 151643, 151643, 151643, 151643, 151643, 151643, 151643, 151643, 151643, 151643, 151643, 151643, 151643, 151643, 151643, 151643, 151643, 151643, 151643, 151643, 151643, 151643, 151643, 151643, 151643, 151643, 151643, 151643, 151643, 151643, 151643, 151643, 151643, 151643, 151643, 151643, 151643, 151643, 151643, 151643, 151643, 151643, 151643, 151643, 151643, 151643, 151643, 151643, 151643, 151643, 151643, 151643, 151643, 151643, 151643, 151643, 151643, 151643, 151643, 151643, 151643, 151643, 151643, 151643, 151643, 151643, 151643, 151643, 151643, 151643, 151643, 151643, 151643, 151643, 151643, 151643, 151643, 151643, 151643, 151643, 151643, 151643, 151643, 151643, 151643, 151643, 151643, 151643, 151643, 151643, 151643, 151643, 151643, 151643, 151643, 151643, 151643, 151643, 151643, 151643, 151643, 151643, 151643, 151643, 151643, 151643, 151643, 151643, 151643, 151643, 151643, 151643, 151643, 151643, 151643, 151643, 151643, 151643, 151643, 151643, 151643, 151643, 151643, 151643, 151643, 151643, 151643, 151643, 151643, 151643, 151643, 151643, 151643, 151643, 151643, 151643, 151643, 151643, 151643, 151643, 151643, 151643, 151643, 151643, 151643, 151643, 151643, 151643, 151643, 151643, 151643, 151643, 151643, 151643, 151643, 151643, 151643, 151643, 151643, 151643, 151643, 151643, 151643, 151643, 151643, 151643, 151643, 151643, 151643, 151643, 151643, 151643, 151643, 151643, 151643, 151643, 151643, 151643, 151643, 151643, 151643, 151643, 151643, 151643, 151643, 151643, 151643, 151643, 151643, 151643, 151643, 151643, 151643, 151643, 151643, 151643, 151643, 151643, 151643, 151643, 151643, 151643, 151643, 151643, 151643, 151643, 151643, 151643, 151643, 151643, 151643, 151643, 151643, 151643, 151643, 151643, 151643, 151643, 151643, 151643, 151643, 151643, 151643, 151643, 151643, 151643, 151643, 151643, 151643, 151643, 151643, 151643, 151643, 151643, 151643, 151643, 151643, 151643, 151643, 151643, 151643, 151643, 151643, 151643, 151643, 151643, 151643, 151643, 151643, 151643, 151643, 151643, 151643, 151643, 151643, 151643, 151643, 151643, 151643, 151643, 151643, 151643, 151643, 151643, 151643, 151643, 151643, 151643, 151643, 151643, 151643, 151643, 151643, 151643, 151643, 151643, 151643, 151643, 151643, 151643, 151643, 151643, 151643, 151643, 151643, 151643, 151643, 151643, 151643, 151643, 151643, 151643, 151643, 151643, 151643, 151643, 151643, 151643, 151643, 151643, 151643, 151643, 151643, 151643, 151643, 151643, 151643, 151643, 151643, 151643, 151643, 151643, 151643, 151643, 151643, 151643, 151643, 151643, 151643, 151643, 151643, 151643, 151643, 151643, 151643, 151643, 151643, 151643, 151643, 151643, 151643, 151643, 151643, 151643, 151643, 151643, 151643, 151643, 151643, 151643, 151643, 151643, 151643, 151643, 151643, 151643, 151643, 151643, 151643, 151643, 151643, 151643, 151643, 151643, 151643, 151643, 151643, 151643, 151643, 151643, 151643, 151643, 151643, 151643, 151643, 151643, 151643, 151643, 151643, 151643, 151643, 151643, 151643, 151643, 151643, 151643, 151643, 151643, 151643, 151643, 151643, 151643, 151643, 151643, 151643, 151643, 151643, 151643, 151643, 151643, 151643, 151643, 151643, 151643, 151643, 151643, 151643, 151643, 151643, 151643, 151643, 151643, 151643, 151643, 151643, 151643, 151643, 151643, 151643, 151643, 151643, 151643, 151643, 151643, 151643, 151643, 151643, 151643, 151643, 151643, 151643, 151643, 151643, 151643, 151643, 151643, 151643, 151643, 151643, 151643, 151643, 151643, 151643, 151643, 151643, 151643, 151643, 151643, 151643, 151643, 151643, 151643, 151643, 151643, 151643, 151643, 151643, 151643, 151643, 151643, 151643, 151643, 151643, 151643, 151643, 151643, 151643, 151643, 151643, 151643, 151643, 151643, 151643, 151643, 151643, 151643, 151643, 151643, 151643, 151643, 151643, 151643, 151643, 151643, 151643, 151643, 151643, 151643, 151643, 151643, 151643, 151643, 151643, 151643, 151643, 151643, 151643, 151643, 151643, 151643, 151643, 151643, 151643, 151643, 151643, 151643, 151643, 151643, 151643, 151643, 151643, 151643, 151643, 151643, 151643, 151643, 151643, 151643, 151643, 151643, 151643, 151643, 151643, 151643, 151643, 151643, 151643, 151643, 151643, 151643, 151643, 151643, 151643, 151643, 151643, 151643, 151643, 151643, 151643, 151643, 151643, 151643, 151643, 151643, 151643, 151643, 151643, 151643, 151643, 151643, 151643, 151643, 151643, 151643, 151644, 8948, 198, 2610, 525, 1207, 16948, 11, 3465, 553, 54364, 14817, 13, 1446, 525, 264, 10950, 17847, 13, 151645, 198, 151644, 872, 198, 16141, 279, 2701, 5248, 5754, 3405, 13, 576, 1537, 1555, 315, 697, 2033, 1265, 387, 315, 279, 2701, 3561, 25, 364, 16141, 25, 400, 20756, 4198, 6, 320, 28996, 17194, 8, 1380, 44428, 374, 825, 315, 19360, 35, 13, 21149, 3019, 553, 3019, 1573, 35764, 382, 10061, 601, 9658, 9759, 525, 77809, 4237, 304, 279, 12884, 13, 758, 419, 15048, 11, 1246, 279, 1372, 315, 9759, 817, 4982, 2088, 315, 1346, 44168, 320, 78854, 8, 4344, 448, 625, 87, 1939, 32, 8, 3968, 220, 16, 11255, 87, 61, 17, 198, 33, 8, 3968, 220, 16, 11255, 87, 61, 19, 198, 34, 8, 3968, 220, 16, 11255, 87, 61, 16, 198, 35, 8, 3968, 220, 16, 11255, 87, 61, 18, 151645, 198, 151644, 77091, 198]",,148,342,490,1.0,1.0
20ffaf76-9a8a-4c37-969e-85ec42bb3889,7,105,"[151643, 151643, 151643, 151643, 151643, 151643, 151643, 151643, 151643, 151643, 151643, 151643, 151643, 151643, 151643, 151643, 151643, 151643, 151643, 151643, 151643, 151643, 151643, 151643, 151643, 151643, 151643, 151643, 151643, 151643, 151643, 151643, 151643, 151643, 151643, 151643, 151643, 151643, 151643, 151643, 151643, 151643, 151643, 151643, 151643, 151643, 151643, 151643, 151643, 151643, 151643, 151643, 151643, 151643, 151643, 151643, 151643, 151643, 151643, 151643, 151643, 151643, 151643, 151643, 151643, 151643, 151643, 151643, 151643, 151643, 151643, 151643, 151643, 151643, 151643, 151643, 151643, 151643, 151643, 151643, 151643, 151643, 151643, 151643, 151643, 151643, 151643, 151643, 151643, 151643, 151643, 151643, 151643, 151643, 151643, 151643, 151643, 151643, 151643, 151643, 151643, 151643, 151643, 151643, 151643, 151643, 151643, 151643, 151643, 151643, 151643, 151643, 151643, 151643, 151643, 151643, 151643, 151643, 151643, 151643, 151643, 151643, 151643, 151643, 151643, 151643, 151643, 151643, 151643, 151643, 151643, 151643, 151643, 151643, 151643, 151643, 151643, 151643, 151643, 151643, 151643, 151643, 151643, 151643, 151643, 151643, 151643, 151643, 151643, 151643, 151643, 151643, 151643, 151643, 151643, 151643, 151643, 151643, 151643, 151643, 151643, 151643, 151643, 151643, 151643, 151643, 151643, 151643, 151643, 151643, 151643, 151643, 151643, 151643, 151643, 151643, 151643, 151643, 151643, 151643, 151643, 151643, 151643, 151643, 151643, 151643, 151643, 151643, 151643, 151643, 151643, 151643, 151643, 151643, 151643, 151643, 151643, 151643, 151643, 151643, 151643, 151643, 151643, 151643, 151643, 151643, 151643, 151643, 151643, 151643, 151643, 151643, 151643, 151643, 151643, 151643, 151643, 151643, 151643, 151643, 151643, 151643, 151643, 151643, 151643, 151643, 151643, 151643, 151643, 151643, 151643, 151643, 151643, 151643, 151643, 151643, 151643, 151643, 151643, 151643, 151643, 151643, 151643, 151643, 151643, 151643, 151643, 151643, 151643, 151643, 151643, 151643, 151643, 151643, 151643, 151643, 151643, 151643, 151643, 151643, 151643, 151643, 151643, 151643, 151643, 151643, 151643, 151643, 151643, 151643, 151643, 151643, 151643, 151643, 151643, 151643, 151643, 151643, 151643, 151643, 151643, 151643, 151643, 151643, 151643, 151643, 151643, 151643, 151643, 151643, 151643, 151643, 151643, 151643, 151643, 151643, 151643, 151643, 151643, 151643, 151643, 151643, 151643, 151643, 151643, 151643, 151643, 151643, 151643, 151643, 151643, 151643, 151643, 151643, 151643, 151643, 151643, 151643, 151643, 151643, 151643, 151643, 151643, 151643, 151643, 151643, 151643, 151643, 151643, 151643, 151643, 151643, 151643, 151643, 151643, 151643, 151643, 151643, 151643, 151643, 151643, 151643, 151643, 151643, 151643, 151643, 151643, 151643, 151643, 151643, 151643, 151643, 151643, 151643, 151643, 151643, 151643, 151643, 151643, 151643, 151643, 151643, 151643, 151643, 151643, 151643, 151643, 151643, 151643, 151643, 151643, 151643, 151643, 151643, 151643, 151643, 151643, 151643, 151643, 151643, 151643, 151643, 151643, 151643, 151643, 151643, 151643, 151643, 151643, 151643, 151643, 151643, 151643, 151643, 151643, 151643, 151643, 151643, 151643, 151643, 151643, 151643, 151643, 151643, 151643, 151643, 151643, 151643, 151643, 151643, 151643, 151643, 151643, 151643, 151643, 151643, 151643, 151643, 151643, 151643, 151643, 151643, 151643, 151643, 151643, 151643, 151643, 151643, 151643, 151643, 151643, 151643, 151643, 151643, 151643, 151643, 151643, 151643, 151643, 151643, 151643, 151643, 151643, 151643, 151643, 151643, 151643, 151643, 151643, 151643, 151643, 151643, 151643, 151643, 151643, 151644, 8948, 198, 2610, 525, 1207, 16948, 11, 3465, 553, 54364, 14817, 13, 1446, 525, 264, 10950, 17847, 13, 151645, 198, 151644, 872, 198, 16141, 279, 2701, 5248, 5754, 3405, 13, 576, 1537, 1555, 315, 697, 2033, 1265, 387, 315, 279, 2701, 3561, 25, 364, 16141, 25, 400, 20756, 4198, 6, 320, 28996, 17194, 8, 1380, 44428, 374, 825, 315, 19360, 35, 13, 21149, 3019, 553, 3019, 1573, 35764, 382, 785, 7937, 12720, 374, 264, 11483, 1882, 304, 17356, 29803, 1380, 264, 30384, 67446, 11367, 311, 264, 41930, 8482, 264, 3151, 12499, 23992, 5970, 1990, 10815, 320, 34, 40917, 8, 23942, 311, 264, 34772, 3549, 75, 1874, 320, 34, 28, 46, 568, 1096, 12720, 7586, 264, 501, 12499, 23992, 5970, 10815, 11, 12942, 304, 279, 5256, 315, 279, 30384, 67446, 311, 279, 41930, 13, 1084, 594, 13570, 1483, 369, 4752, 6351, 17356, 31146, 448, 3151, 15629, 5203, 323, 37952, 51655, 11, 9271, 8357, 304, 34310, 82, 11, 5810, 1985, 38875, 11, 323, 11483, 38875, 624, 785, 1590, 3871, 315, 279, 2701, 24473, 525, 510, 76, 41872, 220, 17, 12, 5131, 509, 3337, 385, 17308, 2145, 12, 16, 23992, 2011, 3923, 349, 488, 320, 16193, 46, 31860, 11, 4434, 37, 11, 220, 17, 11, 19, 1737, 318, 41872, 12, 16, 8013, 9603, 3923, 82, 360, 5472, 3923, 8, 7964, 89, 1952, 8, 69726, 362, 198, 41872, 220, 17, 12, 41872, 8088, 5652, 349, 488, 320, 16193, 39, 11, 4434, 37, 11, 78474, 220, 17, 1786, 3337, 22288, 306, 3923, 307, 1952, 12, 17, 12, 14769, 3923, 67223, 349, 8, 69726, 425, 271, 32, 8, 362, 284, 78474, 220, 18, 8013, 17, 12, 1188, 17, 11, 19, 1737, 318, 41872, 14769, 3923, 16466, 360, 5472, 3923, 8, 41872, 7287, 17, 12, 5131, 509, 3337, 385, 17308, 2145, 12, 16, 23992, 2011, 3923, 349, 11, 425, 284, 220, 19, 12, 41872, 220, 16, 1448, 41872, 220, 17, 1786, 3337, 22288, 306, 3923, 12, 18, 11, 18, 50289, 41872, 12, 17, 12, 14769, 3923, 64441, 3277, 198, 33, 8, 362, 284, 78474, 220, 16, 8013, 17, 12, 1188, 17, 11, 19, 1737, 318, 41872, 14769, 3923, 16466, 360, 5472, 3923, 8, 41872, 7287, 17, 12, 5131, 509, 3337, 385, 17308, 2145, 12, 16, 23992, 2011, 3923, 349, 11, 425, 284, 220, 19, 12, 41872, 220, 16, 1448, 41872, 220, 17, 1786, 3337, 22288, 306, 3923, 12, 18, 11, 18, 50289, 41872, 12, 17, 12, 14769, 3923, 64441, 3277, 198, 34, 8, 362, 284, 78474, 220, 18, 8013, 17, 12, 1188, 17, 11, 19, 1737, 318, 41872, 14769, 3923, 16466, 360, 5472, 3923, 8, 41872, 7287, 17, 12, 5131, 509, 3337, 385, 17308, 2145, 12, 16, 23992, 2011, 3923, 349, 11, 425, 284, 8372, 3923, 220, 17, 12, 41872, 12, 17, 8013, 16, 8013, 17, 1448, 769, 60163, 12, 17, 12, 5131, 78, 12, 16, 12, 14769, 967, 339, 3923, 46986, 3337, 22288, 306, 3923, 8, 8088, 5652, 349, 198, 35, 8, 362, 284, 78474, 220, 16, 8013, 17, 12, 1188, 17, 11, 19, 1737, 318, 41872, 14769, 3923, 16466, 360, 5472, 3923, 8, 41872, 7287, 17, 12, 5131, 509, 3337, 385, 17308, 2145, 12, 16, 23992, 2011, 3923, 349, 11, 425, 284, 8372, 3923, 220, 17, 12, 41872, 12, 17, 8013, 16, 8013, 17, 1448, 769, 60163, 12, 17, 12, 5131, 78, 12, 16, 12, 14769, 967, 339, 3923, 46986, 3337, 22288, 306, 3923, 8, 8088, 5652, 349, 151645, 198, 151644, 77091, 198]",,569,514,1083,0.0,0.0
30fc710d-548c-4fac-96ab-adda22f0a303,7,106,"[151643, 151643, 151643, 151643, 151643, 151643, 151643, 151643, 151643, 151643, 151643, 151643, 151643, 151643, 151643, 151643, 151643, 151643, 151643, 151643, 151643, 151643, 151643, 151643, 151643, 151643, 151643, 151643, 151643, 151643, 151643, 151643, 151643, 151643, 151643, 151643, 151643, 151643, 151643, 151643, 151643, 151643, 151643, 151643, 151643, 151643, 151643, 151643, 151643, 151643, 151643, 151643, 151643, 151643, 151643, 151643, 151643, 151643, 151643, 151643, 151643, 151643, 151643, 151643, 151643, 151643, 151643, 151643, 151643, 151643, 151643, 151643, 151643, 151643, 151643, 151643, 151643, 151643, 151643, 151643, 151643, 151643, 151643, 151643, 151643, 151643, 151643, 151643, 151643, 151643, 151643, 151643, 151643, 151643, 151643, 151643, 151643, 151643, 151643, 151643, 151643, 151643, 151643, 151643, 151643, 151643, 151643, 151643, 151643, 151643, 151643, 151643, 151643, 151643, 151643, 151643, 151643, 151643, 151643, 151643, 151643, 151643, 151643, 151643, 151643, 151643, 151643, 151643, 151643, 151643, 151643, 151643, 151643, 151643, 151643, 151643, 151643, 151643, 151643, 151643, 151643, 151643, 151643, 151643, 151643, 151643, 151643, 151643, 151643, 151643, 151643, 151643, 151643, 151643, 151643, 151643, 151643, 151643, 151643, 151643, 151643, 151643, 151643, 151643, 151643, 151643, 151643, 151643, 151643, 151643, 151643, 151643, 151643, 151643, 151643, 151643, 151643, 151643, 151643, 151643, 151643, 151643, 151643, 151643, 151643, 151643, 151643, 151643, 151643, 151643, 151643, 151643, 151643, 151643, 151643, 151643, 151643, 151643, 151643, 151643, 151643, 151643, 151643, 151643, 151643, 151643, 151643, 151643, 151643, 151643, 151643, 151643, 151643, 151643, 151643, 151643, 151643, 151643, 151643, 151643, 151643, 151643, 151643, 151643, 151643, 151643, 151643, 151643, 151643, 151643, 151643, 151643, 151643, 151643, 151643, 151643, 151643, 151643, 151643, 151643, 151643, 151643, 151643, 151643, 151643, 151643, 151643, 151643, 151643, 151643, 151643, 151643, 151643, 151643, 151643, 151643, 151643, 151643, 151643, 151643, 151643, 151643, 151643, 151643, 151643, 151643, 151643, 151643, 151643, 151643, 151643, 151643, 151643, 151643, 151643, 151643, 151643, 151643, 151643, 151643, 151643, 151643, 151643, 151643, 151643, 151643, 151643, 151643, 151643, 151643, 151643, 151643, 151643, 151643, 151643, 151643, 151643, 151643, 151643, 151643, 151643, 151643, 151643, 151643, 151643, 151643, 151643, 151643, 151643, 151643, 151643, 151643, 151643, 151643, 151643, 151643, 151643, 151643, 151643, 151643, 151643, 151643, 151643, 151643, 151643, 151643, 151643, 151643, 151643, 151643, 151643, 151643, 151643, 151643, 151643, 151643, 151643, 151643, 151643, 151643, 151643, 151643, 151643, 151643, 151643, 151643, 151643, 151643, 151643, 151643, 151643, 151643, 151643, 151643, 151643, 151643, 151643, 151643, 151643, 151643, 151643, 151643, 151643, 151643, 151643, 151643, 151643, 151643, 151643, 151643, 151643, 151643, 151643, 151643, 151643, 151643, 151643, 151643, 151643, 151643, 151643, 151643, 151643, 151643, 151643, 151643, 151643, 151643, 151643, 151643, 151643, 151643, 151643, 151643, 151643, 151643, 151643, 151643, 151643, 151643, 151643, 151643, 151643, 151643, 151643, 151643, 151643, 151643, 151643, 151643, 151643, 151643, 151643, 151643, 151643, 151643, 151643, 151643, 151643, 151643, 151643, 151643, 151643, 151643, 151643, 151643, 151643, 151643, 151643, 151643, 151643, 151643, 151643, 151643, 151643, 151643, 151643, 151643, 151643, 151643, 151643, 151643, 151643, 151643, 151643, 151643, 151643, 151643, 151643, 151643, 151643, 151643, 151643, 151643, 151643, 151643, 151643, 151643, 151643, 151643, 151643, 151643, 151643, 151643, 151643, 151643, 151643, 151643, 151643, 151643, 151643, 151643, 151643, 151643, 151643, 151643, 151643, 151643, 151643, 151643, 151643, 151643, 151643, 151643, 151643, 151643, 151643, 151643, 151643, 151643, 151643, 151643, 151643, 151643, 151643, 151643, 151643, 151643, 151643, 151643, 151643, 151643, 151643, 151643, 151643, 151643, 151643, 151643, 151643, 151643, 151643, 151643, 151643, 151643, 151643, 151643, 151643, 151643, 151643, 151643, 151643, 151643, 151643, 151643, 151643, 151643, 151643, 151643, 151643, 151643, 151643, 151643, 151643, 151643, 151643, 151643, 151643, 151643, 151643, 151643, 151643, 151643, 151643, 151643, 151643, 151643, 151643, 151643, 151643, 151643, 151643, 151643, 151643, 151643, 151643, 151643, 151643, 151643, 151643, 151643, 151643, 151643, 151643, 151643, 151643, 151643, 151643, 151643, 151643, 151643, 151643, 151643, 151643, 151643, 151643, 151643, 151643, 151643, 151643, 151643, 151643, 151643, 151643, 151643, 151643, 151643, 151643, 151643, 151643, 151643, 151643, 151643, 151643, 151643, 151643, 151643, 151643, 151643, 151643, 151643, 151643, 151643, 151643, 151643, 151643, 151643, 151643, 151643, 151643, 151643, 151643, 151643, 151643, 151643, 151643, 151643, 151643, 151643, 151643, 151643, 151643, 151643, 151643, 151643, 151643, 151643, 151643, 151643, 151643, 151643, 151643, 151643, 151643, 151643, 151643, 151643, 151643, 151643, 151643, 151643, 151643, 151643, 151643, 151643, 151643, 151643, 151643, 151643, 151643, 151643, 151643, 151643, 151643, 151643, 151643, 151643, 151643, 151643, 151643, 151643, 151643, 151643, 151643, 151643, 151643, 151643, 151643, 151643, 151643, 151643, 151643, 151643, 151643, 151643, 151643, 151643, 151643, 151643, 151643, 151643, 151643, 151643, 151643, 151643, 151643, 151643, 151643, 151643, 151643, 151643, 151643, 151643, 151643, 151643, 151643, 151643, 151643, 151643, 151643, 151643, 151643, 151643, 151643, 151643, 151643, 151643, 151643, 151643, 151643, 151643, 151643, 151643, 151643, 151643, 151643, 151643, 151643, 151643, 151643, 151643, 151643, 151643, 151643, 151643, 151643, 151643, 151643, 151643, 151643, 151643, 151643, 151643, 151643, 151643, 151643, 151643, 151643, 151643, 151643, 151643, 151643, 151643, 151643, 151643, 151643, 151643, 151643, 151643, 151643, 151644, 8948, 198, 2610, 525, 1207, 16948, 11, 3465, 553, 54364, 14817, 13, 1446, 525, 264, 10950, 17847, 13, 151645, 198, 151644, 872, 198, 16141, 279, 2701, 5248, 5754, 3405, 13, 576, 1537, 1555, 315, 697, 2033, 1265, 387, 315, 279, 2701, 3561, 25, 364, 16141, 25, 400, 20756, 4198, 6, 320, 28996, 17194, 8, 1380, 44428, 374, 825, 315, 19360, 35, 13, 21149, 3019, 553, 3019, 1573, 35764, 382, 28301, 1437, 279, 4396, 8500, 315, 312, 54875, 369, 279, 38875, 315, 508, 16, 11, 16, 24293, 8221, 1337, 3337, 22288, 306, 3923, 307, 1952, 7252, 12, 17, 18589, 5916, 504, 220, 16, 11, 20, 1737, 713, 9566, 453, 306, 2145, 382, 32, 8, 220, 16, 13, 1863, 77, 11, 50050, 198, 17, 13, 2435, 17, 7530, 85, 198, 18, 13, 362, 80, 13, 37512, 39, 198, 19, 13, 5355, 1869, 482, 488, 4553, 46, 18, 488, 472, 5066, 198, 20, 13, 362, 80, 13, 12812, 46761, 198, 33, 8, 220, 16, 13, 1863, 77, 11, 50050, 198, 17, 13, 472, 5066, 198, 18, 13, 362, 80, 13, 37512, 39, 198, 19, 13, 5355, 1869, 482, 198, 20, 13, 362, 80, 13, 12812, 46761, 198, 34, 8, 220, 16, 13, 12812, 11, 50050, 198, 17, 13, 2435, 17, 7530, 85, 198, 18, 13, 37512, 39, 11, 18888, 46761, 198, 19, 13, 14511, 2101, 39, 19, 198, 20, 13, 34831, 19, 46761, 198, 35, 8, 220, 16, 13, 12812, 11, 50050, 198, 17, 13, 2435, 17, 7530, 85, 198, 18, 13, 362, 80, 13, 37512, 39, 198, 19, 13, 55776, 77, 46, 19, 11, 8628, 198, 20, 13, 32178, 39, 17, 151645, 198, 151644, 77091, 198]",,275,704,979,0.0,0.0
c52bb4b3-b56d-4b7c-ba6c-d578d6369461,7,107,"[151643, 151643, 151643, 151643, 151643, 151643, 151643, 151643, 151643, 151643, 151643, 151643, 151643, 151643, 151643, 151643, 151643, 151643, 151643, 151643, 151643, 151643, 151643, 151643, 151643, 151643, 151643, 151643, 151643, 151643, 151643, 151643, 151643, 151643, 151643, 151643, 151643, 151643, 151643, 151643, 151643, 151643, 151643, 151643, 151643, 151643, 151643, 151643, 151643, 151643, 151643, 151643, 151643, 151643, 151643, 151643, 151643, 151643, 151643, 151643, 151643, 151643, 151643, 151643, 151643, 151643, 151643, 151643, 151643, 151643, 151643, 151643, 151643, 151643, 151643, 151643, 151643, 151643, 151643, 151643, 151643, 151643, 151643, 151643, 151643, 151643, 151643, 151643, 151643, 151643, 151643, 151643, 151643, 151643, 151643, 151643, 151643, 151643, 151643, 151643, 151643, 151643, 151643, 151643, 151643, 151643, 151643, 151643, 151643, 151643, 151643, 151643, 151643, 151643, 151643, 151643, 151643, 151643, 151643, 151643, 151643, 151643, 151643, 151643, 151643, 151643, 151643, 151643, 151643, 151643, 151643, 151643, 151643, 151643, 151643, 151643, 151643, 151643, 151643, 151643, 151643, 151643, 151643, 151643, 151643, 151643, 151643, 151643, 151643, 151643, 151643, 151643, 151643, 151643, 151643, 151643, 151643, 151643, 151643, 151643, 151643, 151643, 151643, 151643, 151643, 151643, 151643, 151643, 151643, 151643, 151643, 151643, 151643, 151643, 151643, 151643, 151643, 151643, 151643, 151643, 151643, 151643, 151643, 151643, 151643, 151643, 151643, 151643, 151643, 151643, 151643, 151643, 151643, 151643, 151643, 151643, 151643, 151643, 151643, 151643, 151643, 151643, 151643, 151643, 151643, 151643, 151643, 151643, 151643, 151643, 151643, 151643, 151643, 151643, 151643, 151643, 151643, 151643, 151643, 151643, 151643, 151643, 151643, 151643, 151643, 151643, 151643, 151643, 151643, 151643, 151643, 151643, 151643, 151643, 151643, 151643, 151643, 151643, 151643, 151643, 151643, 151643, 151643, 151643, 151643, 151643, 151643, 151643, 151643, 151643, 151643, 151643, 151643, 151643, 151643, 151643, 151643, 151643, 151643, 151643, 151643, 151643, 151643, 151643, 151643, 151643, 151643, 151643, 151643, 151643, 151643, 151643, 151643, 151643, 151643, 151643, 151643, 151643, 151643, 151643, 151643, 151643, 151643, 151643, 151643, 151643, 151643, 151643, 151643, 151643, 151643, 151643, 151643, 151643, 151643, 151643, 151643, 151643, 151643, 151643, 151643, 151643, 151643, 151643, 151643, 151643, 151643, 151643, 151643, 151643, 151643, 151643, 151643, 151643, 151643, 151643, 151643, 151643, 151643, 151643, 151643, 151643, 151643, 151643, 151643, 151643, 151643, 151643, 151643, 151643, 151643, 151643, 151643, 151643, 151643, 151643, 151643, 151643, 151643, 151643, 151643, 151643, 151643, 151643, 151643, 151643, 151643, 151643, 151643, 151643, 151643, 151643, 151643, 151643, 151643, 151643, 151643, 151643, 151643, 151643, 151643, 151643, 151643, 151643, 151643, 151643, 151643, 151643, 151643, 151643, 151643, 151643, 151643, 151643, 151643, 151643, 151643, 151643, 151643, 151643, 151643, 151643, 151643, 151643, 151643, 151643, 151643, 151643, 151643, 151643, 151643, 151643, 151643, 151643, 151643, 151643, 151643, 151643, 151643, 151643, 151643, 151643, 151643, 151643, 151643, 151643, 151643, 151643, 151643, 151643, 151643, 151643, 151643, 151643, 151643, 151643, 151643, 151643, 151643, 151643, 151643, 151643, 151643, 151643, 151643, 151643, 151643, 151643, 151643, 151643, 151643, 151643, 151643, 151643, 151643, 151643, 151643, 151643, 151643, 151643, 151643, 151643, 151643, 151643, 151643, 151643, 151643, 151643, 151643, 151643, 151643, 151643, 151643, 151643, 151643, 151643, 151643, 151643, 151643, 151643, 151643, 151643, 151643, 151643, 151643, 151643, 151643, 151643, 151643, 151643, 151643, 151643, 151643, 151643, 151643, 151643, 151643, 151643, 151643, 151643, 151643, 151643, 151643, 151643, 151643, 151643, 151643, 151643, 151643, 151643, 151643, 151643, 151643, 151643, 151643, 151643, 151643, 151643, 151643, 151643, 151643, 151643, 151643, 151643, 151643, 151643, 151643, 151643, 151643, 151643, 151643, 151643, 151643, 151643, 151643, 151643, 151643, 151643, 151643, 151643, 151643, 151643, 151643, 151643, 151643, 151643, 151643, 151643, 151643, 151643, 151643, 151643, 151643, 151643, 151643, 151643, 151643, 151643, 151643, 151643, 151643, 151643, 151643, 151643, 151643, 151643, 151643, 151643, 151643, 151643, 151643, 151643, 151643, 151643, 151643, 151643, 151643, 151643, 151643, 151643, 151643, 151643, 151643, 151643, 151643, 151643, 151643, 151643, 151643, 151643, 151643, 151643, 151643, 151643, 151643, 151643, 151643, 151643, 151643, 151643, 151643, 151643, 151643, 151643, 151643, 151643, 151643, 151643, 151643, 151643, 151643, 151643, 151643, 151643, 151643, 151643, 151643, 151643, 151643, 151643, 151643, 151643, 151643, 151643, 151643, 151643, 151643, 151643, 151643, 151643, 151643, 151643, 151643, 151643, 151643, 151643, 151643, 151643, 151643, 151643, 151643, 151643, 151643, 151643, 151643, 151643, 151643, 151643, 151643, 151643, 151643, 151643, 151643, 151643, 151643, 151643, 151643, 151643, 151643, 151643, 151643, 151643, 151643, 151643, 151643, 151643, 151643, 151643, 151643, 151643, 151643, 151643, 151643, 151643, 151643, 151643, 151643, 151643, 151643, 151643, 151643, 151643, 151643, 151643, 151643, 151643, 151643, 151643, 151643, 151643, 151643, 151643, 151643, 151643, 151643, 151643, 151643, 151643, 151643, 151643, 151643, 151643, 151643, 151643, 151643, 151643, 151643, 151643, 151643, 151643, 151643, 151643, 151643, 151643, 151643, 151643, 151643, 151643, 151643, 151643, 151643, 151643, 151643, 151643, 151643, 151643, 151643, 151643, 151643, 151643, 151643, 151643, 151643, 151643, 151643, 151643, 151643, 151643, 151643, 151643, 151643, 151643, 151643, 151643, 151643, 151643, 151643, 151643, 151643, 151643, 151643, 151643, 151643, 151643, 151643, 151643, 151643, 151643, 151643, 151643, 151643, 151643, 151643, 151643, 151643, 151643, 151643, 151643, 151643, 151643, 151643, 151643, 151643, 151643, 151643, 151643, 151643, 151643, 151643, 151643, 151643, 151643, 151643, 151643, 151643, 151643, 151643, 151643, 151643, 151643, 151643, 151643, 151643, 151643, 151643, 151643, 151643, 151643, 151643, 151643, 151643, 151643, 151643, 151643, 151643, 151643, 151643, 151643, 151643, 151643, 151643, 151643, 151643, 151643, 151643, 151643, 151643, 151643, 151643, 151643, 151643, 151643, 151643, 151643, 151643, 151643, 151643, 151643, 151643, 151643, 151643, 151643, 151643, 151643, 151643, 151643, 151643, 151643, 151643, 151643, 151643, 151643, 151643, 151643, 151643, 151643, 151643, 151643, 151643, 151643, 151643, 151643, 151643, 151644, 8948, 198, 2610, 525, 1207, 16948, 11, 3465, 553, 54364, 14817, 13, 1446, 525, 264, 10950, 17847, 13, 151645, 198, 151644, 872, 198, 16141, 279, 2701, 5248, 5754, 3405, 13, 576, 1537, 1555, 315, 697, 2033, 1265, 387, 315, 279, 2701, 3561, 25, 364, 16141, 25, 400, 20756, 4198, 6, 320, 28996, 17194, 8, 1380, 44428, 374, 825, 315, 19360, 35, 13, 21149, 3019, 553, 3019, 1573, 35764, 382, 59207, 315, 6437, 362, 448, 220, 23, 85006, 315, 6819, 425, 7586, 9906, 2518, 1985, 356, 624, 4498, 356, 68845, 448, 220, 17, 85006, 315, 6819, 422, 11, 432, 18644, 279, 9016, 49924, 1985, 468, 624, 34, 68845, 448, 3015, 311, 14836, 362, 5519, 1378, 2155, 32869, 434, 323, 479, 13, 434, 374, 264, 3746, 13621, 1393, 479, 374, 264, 7469, 13621, 624, 35, 68845, 448, 425, 304, 264, 220, 16, 25, 16, 11341, 311, 1352, 472, 11, 892, 374, 1483, 438, 264, 68896, 382, 12555, 374, 279, 30106, 45120, 1874, 315, 468, 1939, 32, 8, 356, 17, 198, 33, 8, 422, 144677, 71, 198, 34, 8, 356, 17, 85, 198, 35, 8, 422, 19, 71, 151645, 198, 151644, 77091, 198]",,191,474,665,0.0,0.0
84ebd83f-3480-453e-8768-0bd0d14664d6,7,108,"[151643, 151643, 151643, 151643, 151643, 151643, 151643, 151643, 151643, 151643, 151643, 151643, 151643, 151643, 151643, 151643, 151643, 151643, 151643, 151643, 151643, 151643, 151643, 151643, 151643, 151643, 151643, 151643, 151643, 151643, 151643, 151643, 151643, 151643, 151643, 151643, 151643, 151643, 151643, 151643, 151643, 151643, 151643, 151643, 151643, 151643, 151643, 151643, 151643, 151643, 151643, 151643, 151643, 151643, 151643, 151643, 151643, 151643, 151643, 151643, 151643, 151643, 151643, 151643, 151643, 151643, 151643, 151643, 151643, 151643, 151643, 151643, 151643, 151643, 151643, 151643, 151643, 151643, 151643, 151643, 151643, 151643, 151643, 151643, 151643, 151643, 151643, 151643, 151643, 151643, 151643, 151643, 151643, 151643, 151643, 151643, 151643, 151643, 151643, 151643, 151643, 151643, 151643, 151643, 151643, 151643, 151643, 151643, 151643, 151643, 151643, 151643, 151643, 151643, 151643, 151643, 151643, 151643, 151643, 151643, 151643, 151643, 151643, 151643, 151643, 151643, 151643, 151643, 151643, 151643, 151643, 151643, 151643, 151643, 151643, 151643, 151643, 151643, 151643, 151643, 151643, 151643, 151643, 151643, 151643, 151643, 151643, 151643, 151643, 151643, 151643, 151643, 151643, 151643, 151643, 151643, 151643, 151643, 151643, 151643, 151643, 151643, 151643, 151643, 151643, 151643, 151643, 151643, 151643, 151643, 151643, 151643, 151643, 151643, 151643, 151643, 151643, 151643, 151643, 151643, 151643, 151643, 151643, 151643, 151643, 151643, 151643, 151643, 151643, 151643, 151643, 151643, 151643, 151643, 151643, 151643, 151643, 151643, 151643, 151643, 151643, 151643, 151643, 151643, 151643, 151643, 151643, 151643, 151643, 151643, 151643, 151643, 151643, 151643, 151643, 151643, 151643, 151643, 151643, 151643, 151643, 151643, 151643, 151643, 151643, 151643, 151643, 151643, 151643, 151643, 151643, 151643, 151643, 151643, 151643, 151643, 151643, 151643, 151643, 151643, 151643, 151643, 151643, 151643, 151643, 151643, 151643, 151643, 151643, 151643, 151643, 151643, 151643, 151643, 151643, 151643, 151643, 151643, 151643, 151643, 151643, 151643, 151643, 151643, 151643, 151643, 151643, 151643, 151643, 151643, 151643, 151643, 151643, 151643, 151643, 151643, 151643, 151643, 151643, 151643, 151643, 151643, 151643, 151643, 151643, 151643, 151643, 151643, 151643, 151643, 151643, 151643, 151643, 151643, 151643, 151643, 151643, 151643, 151643, 151643, 151643, 151643, 151643, 151643, 151643, 151643, 151643, 151643, 151643, 151643, 151643, 151643, 151643, 151643, 151643, 151643, 151643, 151643, 151643, 151643, 151643, 151643, 151643, 151643, 151643, 151643, 151643, 151643, 151643, 151643, 151643, 151643, 151643, 151643, 151643, 151643, 151643, 151643, 151643, 151643, 151643, 151643, 151643, 151643, 151643, 151643, 151643, 151643, 151643, 151643, 151643, 151643, 151643, 151643, 151643, 151643, 151643, 151643, 151643, 151643, 151643, 151643, 151643, 151643, 151643, 151643, 151643, 151643, 151643, 151643, 151643, 151643, 151643, 151643, 151643, 151643, 151643, 151643, 151643, 151643, 151643, 151643, 151643, 151643, 151643, 151643, 151643, 151643, 151643, 151643, 151643, 151643, 151643, 151643, 151643, 151643, 151643, 151643, 151643, 151643, 151643, 151643, 151643, 151643, 151643, 151643, 151643, 151643, 151643, 151643, 151643, 151643, 151643, 151643, 151643, 151643, 151643, 151643, 151643, 151643, 151643, 151643, 151643, 151643, 151643, 151643, 151643, 151643, 151643, 151643, 151643, 151643, 151643, 151643, 151643, 151643, 151643, 151643, 151643, 151643, 151643, 151643, 151643, 151643, 151643, 151643, 151643, 151643, 151643, 151643, 151643, 151643, 151643, 151643, 151643, 151643, 151643, 151643, 151643, 151643, 151643, 151643, 151643, 151643, 151643, 151643, 151643, 151643, 151643, 151643, 151643, 151643, 151643, 151643, 151643, 151643, 151643, 151643, 151643, 151643, 151643, 151643, 151643, 151643, 151643, 151643, 151643, 151643, 151643, 151643, 151643, 151643, 151643, 151643, 151643, 151643, 151643, 151643, 151643, 151643, 151643, 151643, 151643, 151643, 151643, 151643, 151643, 151643, 151643, 151643, 151643, 151643, 151643, 151643, 151643, 151643, 151643, 151643, 151643, 151643, 151643, 151643, 151643, 151643, 151643, 151643, 151643, 151643, 151643, 151643, 151643, 151643, 151643, 151643, 151643, 151643, 151643, 151643, 151643, 151643, 151643, 151643, 151643, 151643, 151643, 151643, 151643, 151643, 151643, 151643, 151643, 151643, 151643, 151643, 151643, 151643, 151643, 151643, 151643, 151643, 151643, 151643, 151643, 151643, 151643, 151643, 151643, 151643, 151643, 151643, 151643, 151643, 151643, 151643, 151643, 151643, 151643, 151643, 151643, 151643, 151643, 151643, 151643, 151643, 151643, 151643, 151643, 151643, 151643, 151643, 151643, 151643, 151643, 151643, 151643, 151643, 151643, 151643, 151643, 151643, 151643, 151643, 151643, 151643, 151643, 151643, 151643, 151643, 151643, 151643, 151643, 151643, 151643, 151643, 151643, 151643, 151643, 151643, 151643, 151643, 151643, 151643, 151643, 151643, 151643, 151643, 151643, 151643, 151643, 151643, 151643, 151643, 151643, 151643, 151643, 151643, 151643, 151643, 151643, 151644, 8948, 198, 2610, 525, 1207, 16948, 11, 3465, 553, 54364, 14817, 13, 1446, 525, 264, 10950, 17847, 13, 151645, 198, 151644, 872, 198, 16141, 279, 2701, 5248, 5754, 3405, 13, 576, 1537, 1555, 315, 697, 2033, 1265, 387, 315, 279, 2701, 3561, 25, 364, 16141, 25, 400, 20756, 4198, 6, 320, 28996, 17194, 8, 1380, 44428, 374, 825, 315, 19360, 35, 13, 21149, 3019, 553, 3019, 1573, 35764, 382, 32, 21249, 277, 2011, 88, 415, 13621, 8482, 264, 66404, 12, 1692, 1952, 572, 409, 25172, 657, 311, 279, 12159, 458, 8503, 67, 1399, 13, 1096, 458, 8503, 67, 1399, 11, 892, 702, 264, 3175, 16162, 320, 22, 63597, 8, 304, 1181, 220, 16, 39, 451, 18446, 19745, 323, 1378, 38935, 320, 16, 18, 22, 63597, 11, 220, 16, 21, 20, 63597, 8, 304, 1181, 220, 16, 18, 34, 19745, 11, 572, 54741, 448, 220, 16, 11, 17, 11, 18, 11, 19, 2385, 295, 2396, 41872, 12, 16, 11, 18, 1786, 3337, 22288, 306, 2767, 1952, 311, 7540, 1378, 3871, 320, 64, 3598, 323, 264, 8922, 1985, 568, 11733, 3871, 614, 264, 30106, 14806, 315, 356, 16, 18, 39, 16, 21, 46, 18, 382, 785, 220, 17, 35, 5664, 1570, 56, 451, 18446, 62597, 315, 279, 3598, 323, 8922, 3871, 1033, 4429, 13, 362, 5312, 12, 22792, 572, 3042, 304, 279, 19745, 315, 279, 3598, 1985, 714, 27211, 320, 269, 1602, 7469, 8, 304, 19745, 315, 279, 8922, 1985, 382, 641, 279, 19745, 315, 279, 3598, 1985, 11, 892, 1378, 28180, 3020, 525, 8433, 553, 419, 5312, 12, 22792, 320, 80729, 1127, 525, 4429, 504, 279, 12159, 220, 16, 39, 451, 18446, 73530, 32, 8, 362, 220, 21, 39, 7780, 1149, 518, 3968, 16, 63597, 323, 264, 220, 16, 39, 1990, 83, 518, 3968, 16, 13, 20, 63597, 198, 33, 8, 362, 220, 21, 39, 7780, 1149, 518, 3968, 16, 63597, 323, 264, 220, 21, 39, 7780, 1149, 518, 3968, 16, 13, 22, 63597, 198, 34, 8, 362, 220, 21, 39, 7780, 1149, 518, 3968, 16, 13, 22, 63597, 323, 264, 220, 17, 39, 7780, 1149, 518, 3968, 18, 13, 20, 63597, 198, 35, 8, 362, 220, 16, 39, 1990, 83, 518, 3968, 16, 13, 20, 63597, 323, 264, 220, 17, 39, 7780, 1149, 518, 3968, 18, 13, 20, 63597, 151645, 198, 151644, 77091, 198]",,385,577,962,0.0,0.0
4b89b4ba-5cd3-4ce3-9786-34d83762037d,7,109,"[151643, 151643, 151643, 151643, 151643, 151643, 151643, 151643, 151643, 151643, 151643, 151643, 151643, 151643, 151643, 151643, 151643, 151643, 151643, 151643, 151643, 151643, 151643, 151643, 151643, 151643, 151643, 151643, 151643, 151643, 151643, 151643, 151643, 151643, 151643, 151643, 151643, 151643, 151643, 151643, 151643, 151643, 151643, 151643, 151643, 151643, 151643, 151643, 151643, 151643, 151643, 151643, 151643, 151643, 151643, 151643, 151643, 151643, 151643, 151643, 151643, 151643, 151643, 151643, 151643, 151643, 151643, 151643, 151643, 151643, 151643, 151643, 151643, 151643, 151643, 151643, 151643, 151643, 151643, 151643, 151643, 151643, 151643, 151643, 151643, 151643, 151643, 151643, 151643, 151643, 151643, 151643, 151643, 151643, 151643, 151643, 151643, 151643, 151643, 151643, 151643, 151643, 151643, 151643, 151643, 151643, 151643, 151643, 151643, 151643, 151643, 151643, 151643, 151643, 151643, 151643, 151643, 151643, 151643, 151643, 151643, 151643, 151643, 151643, 151643, 151643, 151643, 151643, 151643, 151643, 151643, 151643, 151643, 151643, 151643, 151643, 151643, 151643, 151643, 151643, 151643, 151643, 151643, 151643, 151643, 151643, 151643, 151643, 151643, 151643, 151643, 151643, 151643, 151643, 151643, 151643, 151643, 151643, 151643, 151643, 151643, 151643, 151643, 151643, 151643, 151643, 151643, 151643, 151643, 151643, 151643, 151643, 151643, 151643, 151643, 151643, 151643, 151643, 151643, 151643, 151643, 151643, 151643, 151643, 151643, 151643, 151643, 151643, 151643, 151643, 151643, 151643, 151643, 151643, 151643, 151643, 151643, 151643, 151643, 151643, 151643, 151643, 151643, 151643, 151643, 151643, 151643, 151643, 151643, 151643, 151643, 151643, 151643, 151643, 151643, 151643, 151643, 151643, 151643, 151643, 151643, 151643, 151643, 151643, 151643, 151643, 151643, 151643, 151643, 151643, 151643, 151643, 151643, 151643, 151643, 151643, 151643, 151643, 151643, 151643, 151643, 151643, 151643, 151643, 151643, 151643, 151643, 151643, 151643, 151643, 151643, 151643, 151643, 151643, 151643, 151643, 151643, 151643, 151643, 151643, 151643, 151643, 151643, 151643, 151643, 151643, 151643, 151643, 151643, 151643, 151643, 151643, 151643, 151643, 151643, 151643, 151643, 151643, 151643, 151643, 151643, 151643, 151643, 151643, 151643, 151643, 151643, 151643, 151643, 151643, 151643, 151643, 151643, 151643, 151643, 151643, 151643, 151643, 151643, 151643, 151643, 151643, 151643, 151643, 151643, 151643, 151643, 151643, 151643, 151643, 151643, 151643, 151643, 151643, 151643, 151643, 151643, 151643, 151643, 151643, 151643, 151643, 151643, 151643, 151643, 151643, 151643, 151643, 151643, 151643, 151643, 151643, 151643, 151643, 151643, 151643, 151643, 151643, 151643, 151643, 151643, 151643, 151643, 151643, 151643, 151643, 151643, 151643, 151643, 151643, 151643, 151643, 151643, 151643, 151643, 151643, 151643, 151643, 151643, 151643, 151643, 151643, 151643, 151643, 151643, 151643, 151643, 151643, 151643, 151643, 151643, 151643, 151643, 151643, 151643, 151643, 151643, 151643, 151643, 151643, 151643, 151643, 151643, 151643, 151643, 151643, 151643, 151643, 151643, 151643, 151643, 151643, 151643, 151643, 151643, 151643, 151643, 151643, 151643, 151643, 151643, 151643, 151643, 151643, 151643, 151643, 151643, 151643, 151643, 151643, 151643, 151643, 151643, 151643, 151643, 151643, 151643, 151643, 151643, 151643, 151643, 151643, 151643, 151643, 151643, 151643, 151643, 151643, 151643, 151643, 151643, 151643, 151643, 151643, 151643, 151643, 151643, 151643, 151643, 151643, 151643, 151643, 151643, 151643, 151643, 151643, 151643, 151643, 151643, 151643, 151643, 151643, 151643, 151643, 151643, 151643, 151643, 151643, 151643, 151643, 151643, 151643, 151643, 151643, 151643, 151643, 151643, 151643, 151643, 151643, 151643, 151643, 151643, 151643, 151643, 151643, 151643, 151643, 151643, 151643, 151643, 151643, 151643, 151643, 151643, 151643, 151643, 151643, 151643, 151643, 151643, 151643, 151643, 151643, 151643, 151643, 151643, 151643, 151643, 151643, 151643, 151643, 151643, 151643, 151643, 151643, 151643, 151643, 151643, 151643, 151643, 151643, 151643, 151643, 151643, 151643, 151643, 151643, 151643, 151643, 151643, 151643, 151643, 151643, 151643, 151643, 151643, 151643, 151643, 151643, 151643, 151643, 151643, 151643, 151643, 151643, 151643, 151643, 151643, 151643, 151643, 151643, 151643, 151643, 151643, 151643, 151643, 151643, 151643, 151643, 151643, 151643, 151643, 151643, 151643, 151643, 151643, 151643, 151643, 151644, 8948, 198, 2610, 525, 1207, 16948, 11, 3465, 553, 54364, 14817, 13, 1446, 525, 264, 10950, 17847, 13, 151645, 198, 151644, 872, 198, 16141, 279, 2701, 5248, 5754, 3405, 13, 576, 1537, 1555, 315, 697, 2033, 1265, 387, 315, 279, 2701, 3561, 25, 364, 16141, 25, 400, 20756, 4198, 6, 320, 28996, 17194, 8, 1380, 44428, 374, 825, 315, 19360, 35, 13, 21149, 3019, 553, 3019, 1573, 35764, 382, 2610, 10820, 264, 501, 28313, 437, 5504, 15349, 6716, 15102, 13302, 304, 279, 29728, 71924, 7761, 323, 1366, 311, 3535, 279, 46906, 24382, 315, 862, 16230, 13, 576, 34168, 374, 264, 1615, 316, 11632, 1356, 10536, 87454, 20311, 448, 8063, 8287, 11338, 1216, 11, 3040, 11482, 64341, 11338, 1216, 11, 323, 2326, 13440, 24140, 429, 1855, 264, 10970, 2747, 369, 279, 28313, 437, 13, 576, 28313, 437, 374, 264, 1062, 2181, 22471, 321, 315, 1378, 8287, 11338, 1216, 13, 1446, 1855, 264, 59731, 380, 8370, 775, 87, 7658, 265, 4621, 448, 279, 28313, 437, 2726, 37, 518, 279, 220, 20, 6, 2309, 11, 74654, 311, 296, 1143, 5400, 26, 279, 34168, 2726, 37, 374, 518, 279, 220, 18, 6, 323, 74654, 311, 279, 384, 38, 11698, 518, 279, 356, 12, 22969, 355, 13, 576, 28313, 437, 374, 1212, 279, 356, 7064, 65542, 11, 323, 41730, 315, 279, 34168, 374, 279, 358, 7012, 22515, 2392, 13, 27133, 279, 28313, 437, 2726, 37, 323, 296, 1143, 5400, 11, 1052, 374, 264, 2936, 304, 264, 775, 87, 47, 41211, 26480, 87, 47, 81258, 11, 323, 1948, 279, 34168, 323, 279, 384, 38, 11698, 11, 1052, 374, 264, 2936, 304, 279, 775, 87, 17, 17, 22, 17, 41211, 26480, 87, 17, 17, 22, 17, 81258, 13, 1446, 1030, 1083, 9226, 58754, 2348, 279, 916, 13788, 291, 27796, 323, 1431, 990, 1105, 311, 1273, 279, 9245, 7493, 389, 279, 10867, 80882, 1283, 625, 10530, 307, 1356, 13120, 311, 6028, 46704, 11130, 665, 7674, 13, 10657, 27796, 2968, 264, 8286, 54172, 311, 279, 1160, 258, 8277, 13, 1446, 5499, 27775, 264, 8644, 1614, 54413, 4246, 70, 782, 369, 697, 9245, 304, 279, 40473, 4004, 13, 1446, 5312, 432, 311, 5627, 55, 16, 15, 7658, 265, 17280, 449, 48765, 782, 23627, 26, 1283, 279, 45371, 374, 9223, 498, 50087, 1105, 1212, 279, 73764, 2335, 3683, 72657, 13, 1446, 653, 537, 22986, 264, 6176, 8286, 13, 15920, 315, 279, 11253, 3685, 14758, 279, 1429, 4363, 2874, 369, 432, 1939, 32, 8, 279, 8663, 11705, 369, 279, 28313, 437, 323, 34168, 7493, 374, 7402, 198, 33, 8, 279, 34168, 5655, 38, 11698, 9245, 374, 15700, 304, 279, 54579, 8212, 198, 34, 8, 28313, 437, 323, 279, 34168, 525, 304, 264, 1346, 580, 39001, 5025, 198, 35, 8, 279, 34168, 323, 279, 384, 38, 11698, 525, 537, 304, 279, 4034, 151645, 198, 151644, 77091, 198]",,465,344,809,1.0,1.0
b73fe0eb-5684-40df-b400-2c58081a00ef,7,110,"[151643, 151643, 151643, 151643, 151643, 151643, 151643, 151643, 151643, 151643, 151643, 151643, 151643, 151643, 151643, 151643, 151643, 151643, 151643, 151643, 151643, 151643, 151643, 151643, 151643, 151643, 151643, 151643, 151643, 151643, 151643, 151643, 151643, 151643, 151643, 151643, 151643, 151643, 151643, 151643, 151643, 151643, 151643, 151643, 151643, 151643, 151643, 151643, 151643, 151643, 151643, 151643, 151643, 151643, 151643, 151643, 151643, 151643, 151643, 151643, 151643, 151643, 151643, 151643, 151643, 151643, 151643, 151643, 151643, 151643, 151643, 151643, 151643, 151643, 151643, 151643, 151643, 151643, 151643, 151643, 151643, 151643, 151643, 151643, 151643, 151643, 151643, 151643, 151643, 151643, 151643, 151643, 151643, 151643, 151643, 151643, 151643, 151643, 151643, 151643, 151643, 151643, 151643, 151643, 151643, 151643, 151643, 151643, 151643, 151643, 151643, 151643, 151643, 151643, 151643, 151643, 151643, 151643, 151643, 151643, 151643, 151643, 151643, 151643, 151643, 151643, 151643, 151643, 151643, 151643, 151643, 151643, 151643, 151643, 151643, 151643, 151643, 151643, 151643, 151643, 151643, 151643, 151643, 151643, 151643, 151643, 151643, 151643, 151643, 151643, 151643, 151643, 151643, 151643, 151643, 151643, 151643, 151643, 151643, 151643, 151643, 151643, 151643, 151643, 151643, 151643, 151643, 151643, 151643, 151643, 151643, 151643, 151643, 151643, 151643, 151643, 151643, 151643, 151643, 151643, 151643, 151643, 151643, 151643, 151643, 151643, 151643, 151643, 151643, 151643, 151643, 151643, 151643, 151643, 151643, 151643, 151643, 151643, 151643, 151643, 151643, 151643, 151643, 151643, 151643, 151643, 151643, 151643, 151643, 151643, 151643, 151643, 151643, 151643, 151643, 151643, 151643, 151643, 151643, 151643, 151643, 151643, 151643, 151643, 151643, 151643, 151643, 151643, 151643, 151643, 151643, 151643, 151643, 151643, 151643, 151643, 151643, 151643, 151643, 151643, 151643, 151643, 151643, 151643, 151643, 151643, 151643, 151643, 151643, 151643, 151643, 151643, 151643, 151643, 151643, 151643, 151643, 151643, 151643, 151643, 151643, 151643, 151643, 151643, 151643, 151643, 151643, 151643, 151643, 151643, 151643, 151643, 151643, 151643, 151643, 151643, 151643, 151643, 151643, 151643, 151643, 151643, 151643, 151643, 151643, 151643, 151643, 151643, 151643, 151643, 151643, 151643, 151643, 151643, 151643, 151643, 151643, 151643, 151643, 151643, 151643, 151643, 151643, 151643, 151643, 151643, 151643, 151643, 151643, 151643, 151643, 151643, 151643, 151643, 151643, 151643, 151643, 151643, 151643, 151643, 151643, 151643, 151643, 151643, 151643, 151643, 151643, 151643, 151643, 151643, 151643, 151643, 151643, 151643, 151643, 151643, 151643, 151643, 151643, 151643, 151643, 151643, 151643, 151643, 151643, 151643, 151643, 151643, 151643, 151643, 151643, 151643, 151643, 151643, 151643, 151643, 151643, 151643, 151643, 151643, 151643, 151643, 151643, 151643, 151643, 151643, 151643, 151643, 151643, 151643, 151643, 151643, 151643, 151643, 151643, 151643, 151643, 151643, 151643, 151643, 151643, 151643, 151643, 151643, 151643, 151643, 151643, 151643, 151643, 151643, 151643, 151643, 151643, 151643, 151643, 151643, 151643, 151643, 151643, 151643, 151643, 151643, 151643, 151643, 151643, 151643, 151643, 151643, 151643, 151643, 151643, 151643, 151643, 151643, 151643, 151643, 151643, 151643, 151643, 151643, 151643, 151643, 151643, 151643, 151643, 151643, 151643, 151643, 151643, 151643, 151643, 151643, 151643, 151643, 151643, 151643, 151643, 151643, 151643, 151643, 151643, 151643, 151643, 151643, 151643, 151643, 151643, 151643, 151643, 151643, 151643, 151643, 151643, 151643, 151643, 151643, 151643, 151643, 151643, 151643, 151643, 151643, 151643, 151643, 151643, 151643, 151643, 151643, 151643, 151643, 151643, 151643, 151643, 151643, 151643, 151643, 151643, 151643, 151643, 151643, 151643, 151643, 151643, 151643, 151643, 151643, 151643, 151643, 151643, 151643, 151643, 151643, 151643, 151643, 151643, 151643, 151643, 151643, 151643, 151643, 151643, 151643, 151643, 151643, 151643, 151643, 151643, 151643, 151643, 151643, 151643, 151643, 151643, 151643, 151643, 151643, 151643, 151643, 151643, 151643, 151643, 151643, 151643, 151643, 151643, 151643, 151643, 151643, 151643, 151643, 151643, 151643, 151643, 151643, 151643, 151643, 151643, 151643, 151643, 151643, 151643, 151643, 151643, 151643, 151643, 151643, 151643, 151643, 151643, 151643, 151643, 151643, 151643, 151643, 151643, 151643, 151643, 151643, 151643, 151643, 151643, 151643, 151643, 151643, 151643, 151643, 151643, 151643, 151643, 151643, 151643, 151643, 151643, 151643, 151643, 151643, 151643, 151643, 151643, 151643, 151643, 151643, 151643, 151643, 151643, 151643, 151643, 151643, 151643, 151643, 151643, 151643, 151643, 151643, 151643, 151643, 151643, 151643, 151643, 151643, 151643, 151643, 151643, 151643, 151643, 151643, 151643, 151643, 151643, 151643, 151643, 151643, 151643, 151643, 151643, 151643, 151643, 151643, 151643, 151643, 151643, 151643, 151643, 151643, 151643, 151643, 151643, 151643, 151643, 151643, 151643, 151643, 151643, 151643, 151643, 151643, 151643, 151643, 151643, 151643, 151643, 151643, 151643, 151643, 151643, 151643, 151643, 151643, 151643, 151643, 151643, 151643, 151643, 151643, 151643, 151643, 151643, 151643, 151643, 151643, 151643, 151643, 151643, 151643, 151643, 151643, 151643, 151643, 151643, 151643, 151643, 151643, 151643, 151643, 151643, 151643, 151643, 151643, 151643, 151643, 151643, 151643, 151643, 151643, 151643, 151643, 151643, 151643, 151643, 151643, 151643, 151643, 151643, 151643, 151643, 151643, 151643, 151643, 151643, 151643, 151643, 151643, 151643, 151643, 151643, 151643, 151643, 151643, 151643, 151643, 151643, 151643, 151643, 151643, 151643, 151643, 151643, 151643, 151643, 151643, 151643, 151643, 151643, 151643, 151643, 151643, 151643, 151643, 151643, 151643, 151643, 151643, 151643, 151643, 151643, 151643, 151643, 151643, 151643, 151643, 151643, 151643, 151644, 8948, 198, 2610, 525, 1207, 16948, 11, 3465, 553, 54364, 14817, 13, 1446, 525, 264, 10950, 17847, 13, 151645, 198, 151644, 872, 198, 16141, 279, 2701, 5248, 5754, 3405, 13, 576, 1537, 1555, 315, 697, 2033, 1265, 387, 315, 279, 2701, 3561, 25, 364, 16141, 25, 400, 20756, 4198, 6, 320, 28996, 17194, 8, 1380, 44428, 374, 825, 315, 19360, 35, 13, 21149, 3019, 553, 3019, 1573, 35764, 382, 16, 11, 18, 1737, 579, 441, 2731, 309, 517, 2145, 374, 31713, 311, 220, 17, 19, 15, 34, 448, 458, 13623, 315, 37512, 39, 11, 6825, 264, 3100, 13753, 6437, 1985, 220, 16, 11, 3085, 220, 16, 39, 308, 20946, 19745, 25, 220, 19, 13, 22, 24, 7, 17, 39, 701, 220, 17, 13, 19, 16, 12, 17, 13, 17, 18, 7, 16, 15, 39, 701, 220, 16, 13, 24, 19, 7, 17, 39, 8, 323, 264, 28583, 34306, 681, 304, 279, 16248, 19745, 518, 220, 16, 22, 17, 15, 6226, 12, 16, 382, 1986, 1985, 572, 1221, 31713, 448, 458, 13623, 315, 24649, 374, 453, 887, 54089, 11, 29064, 1985, 220, 17, 382, 78, 8684, 572, 89612, 832, 1526, 264, 6291, 315, 220, 17, 518, 481, 22, 23, 34, 11, 8110, 553, 5256, 315, 5103, 41872, 82, 14308, 577, 11, 29064, 1985, 220, 18, 382, 258, 279, 220, 16, 39, 308, 20946, 19745, 315, 220, 18, 11, 1128, 374, 279, 57986, 5383, 315, 279, 1429, 939, 71, 816, 291, 34684, 19124, 320, 78995, 1846, 429, 686, 9289, 448, 409, 27951, 657, 68896, 73530, 32, 8, 98709, 315, 23725, 2576, 198, 33, 8, 20189, 295, 198, 34, 8, 98709, 198, 35, 8, 1990, 83, 315, 23725, 2576, 151645, 198, 151644, 77091, 198]",,282,471,753,1.0,1.0
2541017d-80f1-4dc8-9bf1-a61151c03099,7,111,"[151643, 151643, 151643, 151643, 151643, 151643, 151643, 151643, 151643, 151643, 151643, 151643, 151643, 151643, 151643, 151643, 151643, 151643, 151643, 151643, 151643, 151643, 151643, 151643, 151643, 151643, 151643, 151643, 151643, 151643, 151643, 151643, 151643, 151643, 151643, 151643, 151643, 151643, 151643, 151643, 151643, 151643, 151643, 151643, 151643, 151643, 151643, 151643, 151643, 151643, 151643, 151643, 151643, 151643, 151643, 151643, 151643, 151643, 151643, 151643, 151643, 151643, 151643, 151643, 151643, 151643, 151643, 151643, 151643, 151643, 151643, 151643, 151643, 151643, 151643, 151643, 151643, 151643, 151643, 151643, 151643, 151643, 151643, 151643, 151643, 151643, 151643, 151643, 151643, 151643, 151643, 151643, 151643, 151643, 151643, 151643, 151643, 151643, 151643, 151643, 151643, 151643, 151643, 151643, 151643, 151643, 151643, 151643, 151643, 151643, 151643, 151643, 151643, 151643, 151643, 151643, 151643, 151643, 151643, 151643, 151643, 151643, 151643, 151643, 151643, 151643, 151643, 151643, 151643, 151643, 151643, 151643, 151643, 151643, 151643, 151643, 151643, 151643, 151643, 151643, 151643, 151643, 151643, 151643, 151643, 151643, 151643, 151643, 151643, 151643, 151643, 151643, 151643, 151643, 151643, 151643, 151643, 151643, 151643, 151643, 151643, 151643, 151643, 151643, 151643, 151643, 151643, 151643, 151643, 151643, 151643, 151643, 151643, 151643, 151643, 151643, 151643, 151643, 151643, 151643, 151643, 151643, 151643, 151643, 151643, 151643, 151643, 151643, 151643, 151643, 151643, 151643, 151643, 151643, 151643, 151643, 151643, 151643, 151643, 151643, 151643, 151643, 151643, 151643, 151643, 151643, 151643, 151643, 151643, 151643, 151643, 151643, 151643, 151643, 151643, 151643, 151643, 151643, 151643, 151643, 151643, 151643, 151643, 151643, 151643, 151643, 151643, 151643, 151643, 151643, 151643, 151643, 151643, 151643, 151643, 151643, 151643, 151643, 151643, 151643, 151643, 151643, 151643, 151643, 151643, 151643, 151643, 151643, 151643, 151643, 151643, 151643, 151643, 151643, 151643, 151643, 151643, 151643, 151643, 151643, 151643, 151643, 151643, 151643, 151643, 151643, 151643, 151643, 151643, 151643, 151643, 151643, 151643, 151643, 151643, 151643, 151643, 151643, 151643, 151643, 151643, 151643, 151643, 151643, 151643, 151643, 151643, 151643, 151643, 151643, 151643, 151643, 151643, 151643, 151643, 151643, 151643, 151643, 151643, 151643, 151643, 151643, 151643, 151643, 151643, 151643, 151643, 151643, 151643, 151643, 151643, 151643, 151643, 151643, 151643, 151643, 151643, 151643, 151643, 151643, 151643, 151643, 151643, 151643, 151643, 151643, 151643, 151643, 151643, 151643, 151643, 151643, 151643, 151643, 151643, 151643, 151643, 151643, 151643, 151643, 151643, 151643, 151643, 151643, 151643, 151643, 151643, 151643, 151643, 151643, 151643, 151643, 151643, 151643, 151643, 151643, 151643, 151643, 151643, 151643, 151643, 151643, 151643, 151643, 151643, 151643, 151643, 151643, 151643, 151643, 151643, 151643, 151643, 151643, 151643, 151643, 151643, 151643, 151643, 151643, 151643, 151643, 151643, 151643, 151643, 151643, 151643, 151643, 151643, 151643, 151643, 151643, 151643, 151643, 151643, 151643, 151643, 151643, 151643, 151643, 151643, 151643, 151643, 151643, 151643, 151643, 151643, 151643, 151643, 151643, 151643, 151643, 151643, 151643, 151643, 151643, 151643, 151643, 151643, 151643, 151643, 151643, 151643, 151643, 151643, 151643, 151643, 151643, 151643, 151643, 151643, 151643, 151643, 151643, 151643, 151643, 151643, 151643, 151643, 151643, 151643, 151643, 151643, 151643, 151643, 151643, 151643, 151643, 151643, 151643, 151643, 151643, 151643, 151643, 151643, 151643, 151643, 151643, 151643, 151643, 151643, 151643, 151643, 151643, 151643, 151643, 151643, 151643, 151643, 151643, 151643, 151643, 151643, 151643, 151643, 151643, 151643, 151643, 151643, 151643, 151643, 151643, 151643, 151643, 151643, 151643, 151643, 151643, 151643, 151643, 151643, 151643, 151643, 151643, 151643, 151643, 151643, 151643, 151643, 151643, 151643, 151643, 151643, 151643, 151643, 151643, 151643, 151643, 151643, 151643, 151643, 151643, 151643, 151643, 151643, 151643, 151643, 151643, 151643, 151643, 151643, 151643, 151643, 151643, 151643, 151643, 151643, 151643, 151643, 151643, 151643, 151643, 151643, 151643, 151643, 151643, 151643, 151643, 151643, 151643, 151643, 151643, 151643, 151643, 151643, 151643, 151643, 151643, 151643, 151643, 151643, 151643, 151643, 151643, 151643, 151643, 151643, 151643, 151643, 151643, 151643, 151643, 151643, 151643, 151643, 151643, 151643, 151643, 151643, 151643, 151643, 151643, 151643, 151643, 151643, 151643, 151643, 151643, 151643, 151643, 151643, 151643, 151643, 151643, 151643, 151643, 151643, 151643, 151643, 151643, 151643, 151643, 151643, 151643, 151643, 151643, 151643, 151643, 151643, 151643, 151643, 151643, 151643, 151643, 151643, 151643, 151643, 151643, 151643, 151643, 151643, 151643, 151643, 151643, 151643, 151643, 151643, 151643, 151643, 151643, 151643, 151643, 151643, 151643, 151643, 151643, 151643, 151643, 151643, 151643, 151643, 151643, 151643, 151643, 151643, 151643, 151643, 151643, 151643, 151643, 151643, 151643, 151643, 151643, 151643, 151643, 151643, 151643, 151643, 151643, 151643, 151643, 151643, 151643, 151643, 151643, 151643, 151643, 151643, 151643, 151643, 151643, 151643, 151643, 151643, 151643, 151643, 151643, 151643, 151643, 151643, 151643, 151643, 151643, 151643, 151643, 151643, 151643, 151643, 151643, 151643, 151643, 151643, 151643, 151643, 151643, 151643, 151643, 151643, 151643, 151643, 151643, 151643, 151643, 151643, 151643, 151643, 151643, 151643, 151643, 151643, 151643, 151643, 151643, 151643, 151643, 151643, 151643, 151643, 151643, 151643, 151643, 151643, 151643, 151643, 151643, 151643, 151643, 151643, 151643, 151643, 151643, 151643, 151643, 151643, 151643, 151643, 151643, 151643, 151643, 151643, 151643, 151643, 151643, 151643, 151643, 151643, 151643, 151643, 151643, 151643, 151643, 151643, 151643, 151643, 151643, 151643, 151643, 151643, 151643, 151643, 151643, 151643, 151643, 151643, 151643, 151643, 151643, 151643, 151643, 151643, 151643, 151643, 151643, 151643, 151643, 151643, 151643, 151643, 151643, 151643, 151643, 151643, 151643, 151643, 151643, 151643, 151643, 151644, 8948, 198, 2610, 525, 1207, 16948, 11, 3465, 553, 54364, 14817, 13, 1446, 525, 264, 10950, 17847, 13, 151645, 198, 151644, 872, 198, 16141, 279, 2701, 5248, 5754, 3405, 13, 576, 1537, 1555, 315, 697, 2033, 1265, 387, 315, 279, 2701, 3561, 25, 364, 16141, 25, 400, 20756, 4198, 6, 320, 28996, 17194, 8, 1380, 44428, 374, 825, 315, 19360, 35, 13, 21149, 3019, 553, 3019, 1573, 35764, 382, 2610, 525, 20956, 264, 11249, 30715, 892, 32722, 1378, 8811, 30384, 2382, 315, 17172, 362, 311, 2441, 17172, 425, 11, 1393, 24303, 89456, 1378, 1753, 29573, 18730, 468, 323, 647, 13, 758, 2805, 11, 220, 17, 32, 1464, 220, 17, 33, 488, 220, 17, 36, 488, 220, 17, 53, 13, 1084, 374, 3881, 429, 279, 2790, 4802, 19745, 315, 279, 36698, 468, 18730, 374, 19259, 11, 448, 1045, 14887, 897, 1207, 382, 32, 11424, 315, 419, 30715, 72780, 825, 38318, 11, 3072, 1717, 18790, 386, 4518, 315, 279, 220, 17, 53, 13, 758, 419, 1142, 11, 1246, 1558, 279, 2790, 4802, 19745, 315, 279, 36698, 468, 18730, 9429, 311, 429, 315, 279, 4024, 30715, 1939, 32, 8, 576, 19745, 8458, 19259, 448, 458, 23368, 6083, 11, 323, 279, 14887, 42054, 624, 33, 8, 576, 19745, 9044, 43179, 11, 323, 279, 14887, 12703, 624, 34, 8, 576, 19745, 8458, 19259, 448, 458, 23368, 6083, 11, 323, 279, 14887, 12703, 624, 35, 8, 576, 19745, 9044, 43179, 11, 323, 279, 14887, 42054, 13, 151645, 198, 151644, 77091, 198]",,246,436,682,0.0,0.0
753bac8b-3987-4d07-8d59-e0df166fd8b2,7,112,"[151643, 151643, 151643, 151643, 151643, 151643, 151643, 151643, 151643, 151643, 151643, 151643, 151643, 151643, 151643, 151643, 151643, 151643, 151643, 151643, 151643, 151643, 151643, 151643, 151643, 151643, 151643, 151643, 151643, 151643, 151643, 151643, 151643, 151643, 151643, 151643, 151643, 151643, 151643, 151643, 151643, 151643, 151643, 151643, 151643, 151643, 151643, 151643, 151643, 151643, 151643, 151643, 151643, 151643, 151643, 151643, 151643, 151643, 151643, 151643, 151643, 151643, 151643, 151643, 151643, 151643, 151643, 151643, 151643, 151643, 151643, 151643, 151643, 151643, 151643, 151643, 151643, 151643, 151643, 151643, 151643, 151643, 151643, 151643, 151643, 151643, 151643, 151643, 151643, 151643, 151643, 151643, 151643, 151643, 151643, 151643, 151643, 151643, 151643, 151643, 151643, 151643, 151643, 151643, 151643, 151643, 151643, 151643, 151643, 151643, 151643, 151643, 151643, 151643, 151643, 151643, 151643, 151643, 151643, 151643, 151643, 151643, 151643, 151643, 151643, 151643, 151643, 151643, 151643, 151643, 151643, 151643, 151643, 151643, 151643, 151643, 151643, 151643, 151643, 151643, 151643, 151643, 151643, 151643, 151643, 151643, 151643, 151643, 151643, 151643, 151643, 151643, 151643, 151643, 151643, 151643, 151643, 151643, 151643, 151643, 151643, 151643, 151643, 151643, 151643, 151643, 151643, 151643, 151643, 151643, 151643, 151643, 151643, 151643, 151643, 151643, 151643, 151643, 151643, 151643, 151643, 151643, 151643, 151643, 151643, 151643, 151643, 151643, 151643, 151643, 151643, 151643, 151643, 151643, 151643, 151643, 151643, 151643, 151643, 151643, 151643, 151643, 151643, 151643, 151643, 151643, 151643, 151643, 151643, 151643, 151643, 151643, 151643, 151643, 151643, 151643, 151643, 151643, 151643, 151643, 151643, 151643, 151643, 151643, 151643, 151643, 151643, 151643, 151643, 151643, 151643, 151643, 151643, 151643, 151643, 151643, 151643, 151643, 151643, 151643, 151643, 151643, 151643, 151643, 151643, 151643, 151643, 151643, 151643, 151643, 151643, 151643, 151643, 151643, 151643, 151643, 151643, 151643, 151643, 151643, 151643, 151643, 151643, 151643, 151643, 151643, 151643, 151643, 151643, 151643, 151643, 151643, 151643, 151643, 151643, 151643, 151643, 151643, 151643, 151643, 151643, 151643, 151643, 151643, 151643, 151643, 151643, 151643, 151643, 151643, 151643, 151643, 151643, 151643, 151643, 151643, 151643, 151643, 151643, 151643, 151643, 151643, 151643, 151643, 151643, 151643, 151643, 151643, 151643, 151643, 151643, 151643, 151643, 151643, 151643, 151643, 151643, 151643, 151643, 151643, 151643, 151643, 151643, 151643, 151643, 151643, 151643, 151643, 151643, 151643, 151643, 151643, 151643, 151643, 151643, 151643, 151643, 151643, 151643, 151643, 151643, 151643, 151643, 151643, 151643, 151643, 151643, 151643, 151643, 151643, 151643, 151643, 151643, 151643, 151643, 151643, 151643, 151643, 151643, 151643, 151643, 151643, 151643, 151643, 151643, 151643, 151643, 151643, 151643, 151643, 151643, 151643, 151643, 151643, 151643, 151643, 151643, 151643, 151643, 151643, 151643, 151643, 151643, 151643, 151643, 151643, 151643, 151643, 151643, 151643, 151643, 151643, 151643, 151643, 151643, 151643, 151643, 151643, 151643, 151643, 151643, 151643, 151643, 151643, 151643, 151643, 151643, 151643, 151643, 151643, 151643, 151643, 151643, 151643, 151643, 151643, 151643, 151643, 151643, 151643, 151643, 151643, 151643, 151643, 151643, 151643, 151643, 151643, 151643, 151643, 151643, 151643, 151643, 151643, 151643, 151643, 151643, 151643, 151643, 151643, 151643, 151643, 151643, 151643, 151643, 151643, 151643, 151643, 151643, 151643, 151643, 151643, 151643, 151643, 151643, 151643, 151643, 151643, 151643, 151643, 151643, 151643, 151643, 151643, 151643, 151643, 151643, 151643, 151643, 151643, 151643, 151643, 151643, 151643, 151643, 151643, 151643, 151643, 151643, 151643, 151643, 151643, 151643, 151643, 151643, 151643, 151643, 151643, 151643, 151643, 151643, 151643, 151643, 151643, 151643, 151643, 151643, 151643, 151643, 151643, 151643, 151643, 151643, 151643, 151643, 151643, 151643, 151643, 151643, 151643, 151643, 151643, 151643, 151643, 151643, 151643, 151643, 151643, 151643, 151643, 151643, 151643, 151643, 151643, 151643, 151643, 151643, 151643, 151643, 151643, 151643, 151643, 151643, 151643, 151643, 151643, 151643, 151643, 151643, 151643, 151643, 151643, 151643, 151643, 151643, 151643, 151643, 151643, 151643, 151643, 151643, 151643, 151643, 151643, 151643, 151643, 151643, 151643, 151643, 151643, 151643, 151643, 151643, 151643, 151643, 151643, 151643, 151643, 151643, 151643, 151643, 151644, 8948, 198, 2610, 525, 1207, 16948, 11, 3465, 553, 54364, 14817, 13, 1446, 525, 264, 10950, 17847, 13, 151645, 198, 151644, 872, 198, 16141, 279, 2701, 5248, 5754, 3405, 13, 576, 1537, 1555, 315, 697, 2033, 1265, 387, 315, 279, 2701, 3561, 25, 364, 16141, 25, 400, 20756, 4198, 6, 320, 28996, 17194, 8, 1380, 44428, 374, 825, 315, 19360, 35, 13, 21149, 3019, 553, 3019, 1573, 35764, 382, 47246, 8470, 43936, 55327, 56633, 374, 264, 536, 315, 817, 2842, 66, 415, 24473, 13, 758, 1493, 24473, 11, 279, 15022, 8938, 10815, 9772, 973, 1119, 279, 20254, 10815, 13, 356, 2792, 323, 2435, 2782, 268, 55327, 524, 3723, 525, 1083, 20254, 21267, 292, 55327, 524, 3723, 13, 4220, 24473, 525, 5990, 29845, 71831, 2673, 45503, 13, 18608, 279, 2701, 24473, 624, 16, 11, 16, 1737, 318, 769, 60163, 769, 276, 12, 16, 12, 19991, 488, 714, 12, 18, 20767, 12, 17, 12, 337, 488, 320, 39, 10, 488, 26070, 8, 69726, 362, 198, 7, 18, 49, 11, 19, 50, 7287, 18, 11, 19, 1737, 318, 41872, 17308, 64, 12, 16, 11, 20, 1737, 16220, 811, 488, 26070, 69726, 425, 198, 17, 12, 1188, 85, 6441, 385, 4130, 46607, 41872, 8, 8088, 12, 16, 12, 1952, 488, 26070, 69726, 356, 271, 32, 8, 362, 284, 320, 57, 7287, 16, 8013, 8088, 12, 17, 20767, 12, 17, 12034, 385, 4130, 8, 769, 268, 12, 16, 12, 19991, 11, 425, 284, 320, 18, 57, 11, 19, 36, 7287, 18, 11, 19, 50289, 41872, 12487, 757, 3337, 1684, 332, 12, 16, 12, 1952, 11, 356, 284, 220, 19, 1448, 87540, 17308, 48821, 198, 33, 8, 362, 284, 320, 57, 7287, 16, 8013, 8088, 12, 17, 20767, 12, 17, 12034, 385, 4130, 8, 769, 268, 12, 16, 12, 19991, 11, 425, 284, 320, 18, 57, 11, 19, 36, 7287, 18, 11, 19, 50289, 41872, 12487, 757, 3337, 1684, 332, 12, 16, 12, 1952, 11, 356, 284, 220, 19, 1448, 87540, 17308, 276, 12, 16, 12, 337, 198, 34, 8, 362, 284, 220, 21, 1448, 41872, 12, 18, 11, 19, 1737, 6996, 67007, 12, 17, 39, 2268, 88, 6576, 12, 17, 12, 19991, 11, 425, 284, 320, 16, 57, 11, 17, 36, 7287, 16, 11, 17, 50289, 41872, 12487, 757, 3337, 1684, 332, 2145, 11, 356, 284, 220, 19, 1448, 87540, 17308, 276, 12, 16, 12, 337, 198, 35, 8, 362, 284, 220, 21, 1448, 41872, 12, 18, 11, 19, 1737, 6996, 67007, 12, 17, 39, 2268, 88, 6576, 12, 17, 12, 19991, 11, 425, 284, 320, 16, 57, 11, 17, 36, 7287, 16, 11, 17, 50289, 41872, 12487, 757, 3337, 1684, 332, 2145, 11, 356, 284, 220, 19, 1448, 87540, 17308, 48821, 151645, 198, 151644, 77091, 198]",,453,476,929,0.0,0.0
7ec42fd0-d813-4887-91aa-016e7302acc2,7,113,"[151643, 151643, 151643, 151643, 151643, 151643, 151643, 151643, 151643, 151643, 151643, 151643, 151643, 151643, 151643, 151643, 151643, 151643, 151643, 151643, 151643, 151643, 151643, 151643, 151643, 151643, 151643, 151643, 151643, 151643, 151643, 151643, 151643, 151643, 151643, 151643, 151643, 151643, 151643, 151643, 151643, 151643, 151643, 151643, 151643, 151643, 151643, 151643, 151643, 151643, 151643, 151643, 151643, 151643, 151643, 151643, 151643, 151643, 151643, 151643, 151643, 151643, 151643, 151643, 151643, 151643, 151643, 151643, 151643, 151643, 151643, 151643, 151643, 151643, 151643, 151643, 151643, 151643, 151643, 151643, 151643, 151643, 151643, 151643, 151643, 151643, 151643, 151643, 151643, 151643, 151643, 151643, 151643, 151643, 151643, 151643, 151643, 151643, 151643, 151643, 151643, 151643, 151643, 151643, 151643, 151643, 151643, 151643, 151643, 151643, 151643, 151643, 151643, 151643, 151643, 151643, 151643, 151643, 151643, 151643, 151643, 151643, 151643, 151643, 151643, 151643, 151643, 151643, 151643, 151643, 151643, 151643, 151643, 151643, 151643, 151643, 151643, 151643, 151643, 151643, 151643, 151643, 151643, 151643, 151643, 151643, 151643, 151643, 151643, 151643, 151643, 151643, 151643, 151643, 151643, 151643, 151643, 151643, 151643, 151643, 151643, 151643, 151643, 151643, 151643, 151643, 151643, 151643, 151643, 151643, 151643, 151643, 151643, 151643, 151643, 151643, 151643, 151643, 151643, 151643, 151643, 151643, 151643, 151643, 151643, 151643, 151643, 151643, 151643, 151643, 151643, 151643, 151643, 151643, 151643, 151643, 151643, 151643, 151643, 151643, 151643, 151643, 151643, 151643, 151643, 151643, 151643, 151643, 151643, 151643, 151643, 151643, 151643, 151643, 151643, 151643, 151643, 151643, 151643, 151643, 151643, 151643, 151643, 151643, 151643, 151643, 151643, 151643, 151643, 151643, 151643, 151643, 151643, 151643, 151643, 151643, 151643, 151643, 151643, 151643, 151643, 151643, 151643, 151643, 151643, 151643, 151643, 151643, 151643, 151643, 151643, 151643, 151643, 151643, 151643, 151643, 151643, 151643, 151643, 151643, 151643, 151643, 151643, 151643, 151643, 151643, 151643, 151643, 151643, 151643, 151643, 151643, 151643, 151643, 151643, 151643, 151643, 151643, 151643, 151643, 151643, 151643, 151643, 151643, 151643, 151643, 151643, 151643, 151643, 151643, 151643, 151643, 151643, 151643, 151643, 151643, 151643, 151643, 151643, 151643, 151643, 151643, 151643, 151643, 151643, 151643, 151643, 151643, 151643, 151643, 151643, 151643, 151643, 151643, 151643, 151643, 151643, 151643, 151643, 151643, 151643, 151643, 151643, 151643, 151643, 151643, 151643, 151643, 151643, 151643, 151643, 151643, 151643, 151643, 151643, 151643, 151643, 151643, 151643, 151643, 151643, 151643, 151643, 151643, 151643, 151643, 151643, 151643, 151643, 151643, 151643, 151643, 151643, 151643, 151643, 151643, 151643, 151643, 151643, 151643, 151643, 151643, 151643, 151643, 151643, 151643, 151643, 151643, 151643, 151643, 151643, 151643, 151643, 151643, 151643, 151643, 151643, 151643, 151643, 151643, 151643, 151643, 151643, 151643, 151643, 151643, 151643, 151643, 151643, 151643, 151643, 151643, 151643, 151643, 151643, 151643, 151643, 151643, 151643, 151643, 151643, 151643, 151643, 151643, 151643, 151643, 151643, 151643, 151643, 151643, 151643, 151643, 151643, 151643, 151643, 151643, 151643, 151643, 151643, 151643, 151643, 151643, 151643, 151643, 151643, 151643, 151643, 151643, 151643, 151643, 151643, 151643, 151643, 151643, 151643, 151643, 151643, 151643, 151643, 151643, 151643, 151643, 151643, 151643, 151643, 151643, 151643, 151643, 151643, 151643, 151643, 151643, 151643, 151643, 151643, 151643, 151643, 151643, 151643, 151643, 151643, 151643, 151643, 151643, 151643, 151643, 151643, 151643, 151643, 151643, 151643, 151643, 151643, 151643, 151643, 151643, 151643, 151643, 151643, 151643, 151643, 151643, 151643, 151643, 151643, 151643, 151643, 151643, 151643, 151643, 151643, 151643, 151643, 151643, 151643, 151643, 151643, 151643, 151643, 151643, 151643, 151643, 151643, 151643, 151643, 151643, 151643, 151643, 151643, 151643, 151643, 151643, 151643, 151643, 151643, 151643, 151643, 151643, 151643, 151643, 151643, 151643, 151643, 151643, 151643, 151643, 151643, 151643, 151643, 151643, 151643, 151643, 151643, 151643, 151643, 151643, 151643, 151643, 151643, 151643, 151643, 151643, 151643, 151643, 151643, 151643, 151643, 151643, 151643, 151643, 151643, 151643, 151643, 151643, 151643, 151643, 151643, 151643, 151643, 151643, 151643, 151643, 151643, 151643, 151643, 151643, 151643, 151643, 151643, 151643, 151643, 151643, 151643, 151643, 151643, 151643, 151643, 151643, 151643, 151643, 151643, 151643, 151643, 151643, 151643, 151643, 151643, 151643, 151643, 151643, 151643, 151643, 151643, 151643, 151643, 151643, 151643, 151643, 151643, 151643, 151643, 151643, 151643, 151643, 151643, 151643, 151643, 151643, 151643, 151643, 151643, 151643, 151643, 151643, 151643, 151643, 151643, 151643, 151643, 151643, 151643, 151643, 151643, 151643, 151643, 151643, 151643, 151643, 151643, 151643, 151643, 151643, 151643, 151643, 151643, 151643, 151643, 151643, 151643, 151643, 151643, 151643, 151643, 151643, 151643, 151643, 151643, 151643, 151643, 151643, 151643, 151643, 151643, 151643, 151643, 151643, 151643, 151643, 151643, 151643, 151643, 151643, 151643, 151643, 151643, 151643, 151643, 151643, 151643, 151643, 151643, 151643, 151643, 151643, 151643, 151643, 151643, 151643, 151643, 151643, 151643, 151643, 151643, 151643, 151643, 151643, 151643, 151643, 151643, 151643, 151643, 151643, 151643, 151643, 151643, 151643, 151643, 151643, 151643, 151643, 151643, 151643, 151643, 151643, 151643, 151643, 151643, 151643, 151643, 151643, 151643, 151643, 151643, 151643, 151643, 151643, 151643, 151643, 151643, 151643, 151644, 8948, 198, 2610, 525, 1207, 16948, 11, 3465, 553, 54364, 14817, 13, 1446, 525, 264, 10950, 17847, 13, 151645, 198, 151644, 872, 198, 16141, 279, 2701, 5248, 5754, 3405, 13, 576, 1537, 1555, 315, 697, 2033, 1265, 387, 315, 279, 2701, 3561, 25, 364, 16141, 25, 400, 20756, 4198, 6, 320, 28996, 17194, 8, 1380, 44428, 374, 825, 315, 19360, 35, 13, 21149, 3019, 553, 3019, 1573, 35764, 382, 641, 458, 12785, 3412, 10072, 11, 264, 27468, 26674, 8372, 63551, 46293, 2022, 448, 264, 86182, 2872, 4413, 278, 415, 50383, 1849, 11, 23163, 264, 46293, 315, 1550, 17457, 13, 1260, 43230, 311, 912, 264, 2086, 50383, 1849, 311, 19131, 5792, 23091, 304, 279, 46293, 55427, 11, 1083, 1172, 1667, 8372, 63551, 438, 279, 13767, 517, 13, 1260, 8498, 82, 264, 9990, 27468, 11, 879, 6696, 279, 2701, 12239, 13, 1036, 20706, 10856, 5942, 525, 2669, 11537, 389, 458, 12785, 5452, 304, 279, 2274, 13, 3776, 646, 990, 264, 50383, 315, 264, 1874, 29668, 64, 9142, 9317, 304, 10601, 448, 3151, 4105, 2973, 13, 45853, 5980, 4105, 2973, 653, 537, 975, 369, 279, 7565, 5107, 12720, 3019, 13, 34111, 34382, 9317, 50383, 82, 646, 387, 1483, 714, 525, 2238, 11392, 48116, 23085, 315, 1493, 3040, 12239, 374, 4396, 8826, 279, 18003, 315, 264, 46293, 448, 5792, 23091, 1667, 1172, 8372, 63551, 438, 279, 1615, 25359, 323, 264, 18579, 50383, 1849, 1939, 32, 8, 15132, 10856, 5942, 525, 2669, 11537, 389, 458, 12785, 5452, 304, 279, 2274, 624, 33, 8, 3776, 646, 990, 264, 50383, 315, 264, 1874, 29668, 64, 9142, 9317, 304, 10601, 448, 3151, 4105, 2973, 624, 34, 8, 45853, 5980, 4105, 2973, 653, 537, 975, 369, 279, 7565, 5107, 12720, 3019, 624, 35, 8, 34111, 34382, 9317, 50383, 82, 646, 387, 1483, 714, 525, 2238, 11392, 13, 151645, 198, 151644, 77091, 198]",,304,270,574,0.0,0.0
4aafbded-2153-4317-ba13-9d0b8e1c73d0,7,114,"[151643, 151643, 151643, 151643, 151643, 151643, 151643, 151643, 151643, 151643, 151643, 151643, 151643, 151643, 151643, 151643, 151643, 151643, 151643, 151643, 151643, 151643, 151643, 151643, 151643, 151643, 151643, 151643, 151643, 151643, 151643, 151643, 151643, 151643, 151643, 151643, 151643, 151643, 151643, 151643, 151643, 151643, 151643, 151643, 151643, 151643, 151643, 151643, 151643, 151643, 151643, 151643, 151643, 151643, 151643, 151643, 151643, 151643, 151643, 151643, 151643, 151643, 151643, 151643, 151643, 151643, 151643, 151643, 151643, 151643, 151643, 151643, 151643, 151643, 151643, 151643, 151643, 151643, 151643, 151643, 151643, 151643, 151643, 151643, 151643, 151643, 151643, 151643, 151643, 151643, 151643, 151643, 151643, 151643, 151643, 151643, 151643, 151643, 151643, 151643, 151643, 151643, 151643, 151643, 151643, 151643, 151643, 151643, 151643, 151643, 151643, 151643, 151643, 151643, 151643, 151643, 151643, 151643, 151643, 151643, 151643, 151643, 151643, 151643, 151643, 151643, 151643, 151643, 151643, 151643, 151643, 151643, 151643, 151643, 151643, 151643, 151643, 151643, 151643, 151643, 151643, 151643, 151643, 151643, 151643, 151643, 151643, 151643, 151643, 151643, 151643, 151643, 151643, 151643, 151643, 151643, 151643, 151643, 151643, 151643, 151643, 151643, 151643, 151643, 151643, 151643, 151643, 151643, 151643, 151643, 151643, 151643, 151643, 151643, 151643, 151643, 151643, 151643, 151643, 151643, 151643, 151643, 151643, 151643, 151643, 151643, 151643, 151643, 151643, 151643, 151643, 151643, 151643, 151643, 151643, 151643, 151643, 151643, 151643, 151643, 151643, 151643, 151643, 151643, 151643, 151643, 151643, 151643, 151643, 151643, 151643, 151643, 151643, 151643, 151643, 151643, 151643, 151643, 151643, 151643, 151643, 151643, 151643, 151643, 151643, 151643, 151643, 151643, 151643, 151643, 151643, 151643, 151643, 151643, 151643, 151643, 151643, 151643, 151643, 151643, 151643, 151643, 151643, 151643, 151643, 151643, 151643, 151643, 151643, 151643, 151643, 151643, 151643, 151643, 151643, 151643, 151643, 151643, 151643, 151643, 151643, 151643, 151643, 151643, 151643, 151643, 151643, 151643, 151643, 151643, 151643, 151643, 151643, 151643, 151643, 151643, 151643, 151643, 151643, 151643, 151643, 151643, 151643, 151643, 151643, 151643, 151643, 151643, 151643, 151643, 151643, 151643, 151643, 151643, 151643, 151643, 151643, 151643, 151643, 151643, 151643, 151643, 151643, 151643, 151643, 151643, 151643, 151643, 151643, 151643, 151643, 151643, 151643, 151643, 151643, 151643, 151643, 151643, 151643, 151643, 151643, 151643, 151643, 151643, 151643, 151643, 151643, 151643, 151643, 151643, 151643, 151643, 151643, 151643, 151643, 151643, 151643, 151643, 151643, 151643, 151643, 151643, 151643, 151643, 151643, 151643, 151643, 151643, 151643, 151643, 151643, 151643, 151643, 151643, 151643, 151643, 151643, 151643, 151643, 151643, 151643, 151643, 151643, 151643, 151643, 151643, 151643, 151643, 151643, 151643, 151643, 151643, 151643, 151643, 151643, 151643, 151643, 151643, 151643, 151643, 151643, 151643, 151643, 151643, 151643, 151643, 151643, 151643, 151643, 151643, 151643, 151643, 151643, 151643, 151643, 151643, 151643, 151643, 151643, 151643, 151643, 151643, 151643, 151643, 151643, 151643, 151643, 151643, 151643, 151643, 151643, 151643, 151643, 151643, 151643, 151643, 151643, 151643, 151643, 151643, 151643, 151643, 151643, 151643, 151643, 151643, 151643, 151643, 151643, 151643, 151643, 151643, 151643, 151643, 151643, 151643, 151643, 151643, 151643, 151643, 151643, 151643, 151643, 151643, 151643, 151643, 151643, 151643, 151643, 151643, 151643, 151643, 151643, 151643, 151643, 151643, 151643, 151643, 151643, 151643, 151643, 151643, 151643, 151643, 151643, 151643, 151643, 151643, 151643, 151643, 151643, 151643, 151643, 151643, 151643, 151643, 151643, 151643, 151643, 151643, 151643, 151643, 151643, 151643, 151643, 151643, 151643, 151643, 151643, 151643, 151643, 151643, 151643, 151643, 151643, 151643, 151643, 151643, 151643, 151643, 151643, 151643, 151643, 151643, 151643, 151643, 151643, 151643, 151643, 151643, 151643, 151643, 151643, 151643, 151643, 151643, 151643, 151643, 151643, 151643, 151643, 151643, 151643, 151643, 151643, 151643, 151643, 151643, 151643, 151643, 151643, 151643, 151643, 151643, 151643, 151643, 151643, 151643, 151643, 151643, 151643, 151643, 151643, 151643, 151643, 151643, 151643, 151643, 151643, 151643, 151643, 151643, 151643, 151643, 151643, 151643, 151643, 151643, 151643, 151643, 151643, 151643, 151643, 151643, 151643, 151643, 151643, 151643, 151643, 151643, 151643, 151643, 151643, 151643, 151643, 151643, 151643, 151643, 151643, 151643, 151643, 151643, 151643, 151643, 151643, 151643, 151643, 151643, 151643, 151643, 151643, 151643, 151643, 151643, 151643, 151643, 151643, 151643, 151643, 151643, 151643, 151643, 151643, 151643, 151643, 151643, 151643, 151643, 151643, 151643, 151643, 151643, 151643, 151643, 151643, 151643, 151643, 151643, 151643, 151643, 151643, 151643, 151643, 151643, 151643, 151643, 151643, 151643, 151643, 151643, 151643, 151643, 151643, 151643, 151643, 151643, 151643, 151643, 151643, 151643, 151643, 151643, 151643, 151643, 151643, 151643, 151643, 151643, 151643, 151643, 151643, 151643, 151643, 151643, 151643, 151643, 151643, 151643, 151643, 151643, 151643, 151643, 151643, 151643, 151643, 151643, 151643, 151643, 151643, 151643, 151643, 151643, 151643, 151643, 151643, 151643, 151643, 151643, 151643, 151643, 151643, 151643, 151643, 151643, 151643, 151643, 151643, 151643, 151643, 151643, 151643, 151643, 151644, 8948, 198, 2610, 525, 1207, 16948, 11, 3465, 553, 54364, 14817, 13, 1446, 525, 264, 10950, 17847, 13, 151645, 198, 151644, 872, 198, 16141, 279, 2701, 5248, 5754, 3405, 13, 576, 1537, 1555, 315, 697, 2033, 1265, 387, 315, 279, 2701, 3561, 25, 364, 16141, 25, 400, 20756, 4198, 6, 320, 28996, 17194, 8, 1380, 44428, 374, 825, 315, 19360, 35, 13, 21149, 3019, 553, 3019, 1573, 35764, 382, 20, 12276, 84, 269, 509, 3337, 22288, 16576, 12, 16, 11, 18, 1737, 42568, 374, 54741, 448, 8593, 292, 458, 8503, 67, 1399, 13, 3555, 374, 279, 3598, 1985, 1939, 32, 8, 320, 18, 64, 49, 11, 19, 49, 11, 22, 50, 11, 22, 64, 50, 11, 23, 81, 7287, 23, 12276, 84, 18307, 12, 18, 64, 11, 19, 11, 22, 11, 22, 64, 2385, 295, 956, 66129, 12, 19, 11, 22, 1448, 769, 5652, 285, 674, 16597, 1055, 26014, 12, 16, 11, 18, 1737, 6339, 198, 33, 8, 320, 18, 64, 49, 11, 19, 50, 11, 22, 49, 11, 22, 64, 50, 11, 23, 82, 7287, 23, 12276, 84, 18307, 12, 18, 64, 11, 19, 11, 22, 11, 22, 64, 2385, 295, 956, 66129, 12, 19, 11, 22, 1448, 769, 5652, 285, 674, 16597, 1055, 26014, 12, 16, 11, 18, 1737, 6339, 198, 34, 8, 320, 18, 64, 49, 11, 19, 50, 11, 22, 49, 11, 22, 64, 50, 11, 23, 81, 7287, 23, 12276, 84, 18307, 12, 18, 64, 11, 19, 11, 22, 11, 22, 64, 2385, 295, 956, 66129, 12, 19, 11, 22, 1448, 769, 5652, 285, 674, 16597, 1055, 26014, 12, 16, 11, 18, 1737, 6339, 198, 35, 8, 320, 18, 64, 49, 11, 19, 49, 11, 22, 50, 11, 22, 64, 50, 11, 23, 82, 7287, 23, 12276, 84, 18307, 12, 18, 64, 11, 19, 11, 22, 11, 22, 64, 2385, 295, 956, 66129, 12, 19, 11, 22, 1448, 769, 5652, 285, 674, 16597, 1055, 26014, 12, 16, 11, 18, 1737, 6339, 151645, 198, 151644, 77091, 198]",,332,416,748,1.0,1.0
7df8d92d-cc53-47a1-a7fa-d61c236a3956,7,115,"[151643, 151643, 151643, 151643, 151643, 151643, 151643, 151643, 151643, 151643, 151643, 151643, 151643, 151643, 151643, 151643, 151643, 151643, 151643, 151643, 151643, 151643, 151643, 151643, 151643, 151643, 151643, 151643, 151643, 151643, 151643, 151643, 151643, 151643, 151643, 151643, 151643, 151643, 151643, 151643, 151643, 151643, 151643, 151643, 151643, 151643, 151643, 151643, 151643, 151643, 151643, 151643, 151643, 151643, 151643, 151643, 151643, 151643, 151643, 151643, 151643, 151643, 151643, 151643, 151643, 151643, 151643, 151643, 151643, 151643, 151643, 151643, 151643, 151643, 151643, 151643, 151643, 151643, 151643, 151643, 151643, 151643, 151643, 151643, 151643, 151643, 151643, 151643, 151643, 151643, 151643, 151643, 151643, 151643, 151643, 151643, 151643, 151643, 151643, 151643, 151643, 151643, 151643, 151643, 151643, 151643, 151643, 151643, 151643, 151643, 151643, 151643, 151643, 151643, 151643, 151643, 151643, 151643, 151643, 151643, 151643, 151643, 151643, 151643, 151643, 151643, 151643, 151643, 151643, 151643, 151643, 151643, 151643, 151643, 151643, 151643, 151643, 151643, 151643, 151643, 151643, 151643, 151643, 151643, 151643, 151643, 151643, 151643, 151643, 151643, 151643, 151643, 151643, 151643, 151643, 151643, 151643, 151643, 151643, 151643, 151643, 151643, 151643, 151643, 151643, 151643, 151643, 151643, 151643, 151643, 151643, 151643, 151643, 151643, 151643, 151643, 151643, 151643, 151643, 151643, 151643, 151643, 151643, 151643, 151643, 151643, 151643, 151643, 151643, 151643, 151643, 151643, 151643, 151643, 151643, 151643, 151643, 151643, 151643, 151643, 151643, 151643, 151643, 151643, 151643, 151643, 151643, 151643, 151643, 151643, 151643, 151643, 151643, 151643, 151643, 151643, 151643, 151643, 151643, 151643, 151643, 151643, 151643, 151643, 151643, 151643, 151643, 151643, 151643, 151643, 151643, 151643, 151643, 151643, 151643, 151643, 151643, 151643, 151643, 151643, 151643, 151643, 151643, 151643, 151643, 151643, 151643, 151643, 151643, 151643, 151643, 151643, 151643, 151643, 151643, 151643, 151643, 151643, 151643, 151643, 151643, 151643, 151643, 151643, 151643, 151643, 151643, 151643, 151643, 151643, 151643, 151643, 151643, 151643, 151643, 151643, 151643, 151643, 151643, 151643, 151643, 151643, 151643, 151643, 151643, 151643, 151643, 151643, 151643, 151643, 151643, 151643, 151643, 151643, 151643, 151643, 151643, 151643, 151643, 151643, 151643, 151643, 151643, 151643, 151643, 151643, 151643, 151643, 151643, 151643, 151643, 151643, 151643, 151643, 151643, 151643, 151643, 151643, 151643, 151643, 151643, 151643, 151643, 151643, 151643, 151643, 151643, 151643, 151643, 151643, 151643, 151643, 151643, 151643, 151643, 151643, 151643, 151643, 151643, 151643, 151643, 151643, 151643, 151643, 151643, 151643, 151643, 151643, 151643, 151643, 151643, 151643, 151643, 151643, 151643, 151643, 151643, 151643, 151643, 151643, 151643, 151643, 151643, 151643, 151643, 151643, 151643, 151643, 151643, 151643, 151643, 151643, 151643, 151643, 151643, 151643, 151643, 151643, 151643, 151643, 151643, 151643, 151643, 151643, 151643, 151643, 151643, 151643, 151643, 151643, 151643, 151643, 151643, 151643, 151643, 151643, 151643, 151643, 151643, 151643, 151643, 151643, 151643, 151643, 151643, 151643, 151643, 151643, 151643, 151643, 151643, 151643, 151643, 151643, 151643, 151643, 151643, 151643, 151643, 151643, 151643, 151643, 151643, 151643, 151643, 151643, 151643, 151643, 151643, 151643, 151643, 151643, 151643, 151643, 151643, 151643, 151643, 151643, 151643, 151643, 151643, 151643, 151643, 151643, 151643, 151643, 151643, 151643, 151643, 151643, 151643, 151643, 151643, 151643, 151643, 151643, 151643, 151643, 151643, 151643, 151643, 151643, 151643, 151643, 151643, 151643, 151643, 151643, 151643, 151643, 151643, 151643, 151643, 151643, 151643, 151643, 151643, 151643, 151643, 151643, 151643, 151643, 151643, 151643, 151643, 151643, 151643, 151643, 151643, 151643, 151643, 151643, 151643, 151643, 151643, 151643, 151643, 151643, 151643, 151643, 151643, 151643, 151643, 151643, 151643, 151643, 151643, 151643, 151643, 151643, 151643, 151643, 151643, 151643, 151643, 151643, 151643, 151643, 151643, 151643, 151643, 151643, 151643, 151643, 151643, 151643, 151643, 151643, 151643, 151643, 151643, 151643, 151643, 151643, 151643, 151643, 151643, 151643, 151643, 151643, 151643, 151643, 151643, 151643, 151643, 151643, 151643, 151643, 151643, 151643, 151643, 151643, 151643, 151643, 151643, 151643, 151643, 151643, 151643, 151643, 151643, 151643, 151643, 151643, 151643, 151643, 151643, 151643, 151643, 151643, 151643, 151643, 151643, 151643, 151643, 151643, 151643, 151643, 151643, 151643, 151643, 151643, 151643, 151643, 151643, 151643, 151643, 151643, 151643, 151643, 151643, 151643, 151643, 151643, 151643, 151643, 151643, 151643, 151643, 151643, 151643, 151644, 8948, 198, 2610, 525, 1207, 16948, 11, 3465, 553, 54364, 14817, 13, 1446, 525, 264, 10950, 17847, 13, 151645, 198, 151644, 872, 198, 16141, 279, 2701, 5248, 5754, 3405, 13, 576, 1537, 1555, 315, 697, 2033, 1265, 387, 315, 279, 2701, 3561, 25, 364, 16141, 25, 400, 20756, 4198, 6, 320, 28996, 17194, 8, 1380, 44428, 374, 825, 315, 19360, 35, 13, 21149, 3019, 553, 3019, 1573, 35764, 382, 1, 50565, 380, 21538, 311, 1598, 46516, 46293, 519, 8781, 12720, 320, 80, 73156, 8, 389, 1045, 10469, 13, 1260, 1156, 6801, 311, 1281, 264, 37611, 15655, 773, 566, 3867, 6785, 2524, 448, 3881, 2975, 5109, 323, 1598, 2804, 73156, 389, 6146, 398, 79603, 6785, 2524, 2326, 10916, 28541, 973, 13, 576, 15024, 315, 2804, 73156, 572, 220, 16, 15, 15, 14360, 576, 431, 17, 572, 220, 16, 11, 323, 279, 30232, 572, 481, 18, 13, 18, 13, 5301, 3059, 1033, 438, 11017, 510, 1655, 279, 19950, 315, 220, 16, 15, 15, 15, 15, 15, 10993, 817, 62912, 75, 11, 20251, 315, 8411, 48795, 3059, 1033, 220, 18, 18, 13, 24, 11, 220, 18, 19, 13, 17, 11, 220, 18, 19, 13, 20, 624, 1655, 279, 19950, 315, 220, 16, 15, 15, 15, 15, 10993, 817, 62912, 75, 11, 20251, 315, 8411, 48795, 3059, 1033, 220, 18, 15, 13, 21, 11, 220, 18, 15, 13, 24, 11, 220, 18, 16, 13, 17, 624, 1655, 279, 19950, 315, 220, 16, 15, 15, 15, 10993, 817, 62912, 75, 11, 20251, 315, 8411, 48795, 3059, 1033, 220, 17, 22, 13, 18, 11, 220, 17, 22, 13, 21, 11, 220, 17, 22, 13, 24, 624, 1655, 279, 19950, 315, 220, 16, 15, 15, 10993, 817, 62912, 75, 11, 20251, 315, 8411, 48795, 3059, 1033, 220, 17, 19, 11, 220, 17, 19, 13, 18, 11, 220, 17, 19, 13, 21, 624, 1655, 279, 19950, 315, 220, 16, 15, 10993, 817, 62912, 75, 11, 20251, 315, 8411, 48795, 3059, 1033, 220, 17, 15, 13, 22, 11, 220, 17, 16, 11, 220, 17, 16, 13, 18, 198, 23085, 315, 279, 2701, 14758, 279, 90267, 304, 806, 3059, 1939, 32, 8, 62279, 2750, 525, 537, 304, 9128, 448, 279, 3311, 315, 2169, 30384, 292, 13621, 304, 10469, 198, 33, 8, 2804, 73156, 4157, 387, 1483, 369, 279, 10272, 2404, 315, 30384, 292, 13621, 304, 10469, 198, 34, 8, 17695, 23432, 18840, 1488, 374, 803, 1091, 220, 18, 13, 18, 24484, 198, 35, 8, 576, 37564, 374, 803, 1091, 220, 15, 13, 18, 1948, 10916, 28541, 973, 151645, 198, 151644, 77091, 198]",,423,604,1027,0.0,0.0
cfb483a5-851d-4995-8840-e4ad56ea8bde,7,116,"[151643, 151643, 151643, 151643, 151643, 151643, 151643, 151643, 151643, 151643, 151643, 151643, 151643, 151643, 151643, 151643, 151643, 151643, 151643, 151643, 151643, 151643, 151643, 151643, 151643, 151643, 151643, 151643, 151643, 151643, 151643, 151643, 151643, 151643, 151643, 151643, 151643, 151643, 151643, 151643, 151643, 151643, 151643, 151643, 151643, 151643, 151643, 151643, 151643, 151643, 151643, 151643, 151643, 151643, 151643, 151643, 151643, 151643, 151643, 151643, 151643, 151643, 151643, 151643, 151643, 151643, 151643, 151643, 151643, 151643, 151643, 151643, 151643, 151643, 151643, 151643, 151643, 151643, 151643, 151643, 151643, 151643, 151643, 151643, 151643, 151643, 151643, 151643, 151643, 151643, 151643, 151643, 151643, 151643, 151643, 151643, 151643, 151643, 151643, 151643, 151643, 151643, 151643, 151643, 151643, 151643, 151643, 151643, 151643, 151643, 151643, 151643, 151643, 151643, 151643, 151643, 151643, 151643, 151643, 151643, 151643, 151643, 151643, 151643, 151643, 151643, 151643, 151643, 151643, 151643, 151643, 151643, 151643, 151643, 151643, 151643, 151643, 151643, 151643, 151643, 151643, 151643, 151643, 151643, 151643, 151643, 151643, 151643, 151643, 151643, 151643, 151643, 151643, 151643, 151643, 151643, 151643, 151643, 151643, 151643, 151643, 151643, 151643, 151643, 151643, 151643, 151643, 151643, 151643, 151643, 151643, 151643, 151643, 151643, 151643, 151643, 151643, 151643, 151643, 151643, 151643, 151643, 151643, 151643, 151643, 151643, 151643, 151643, 151643, 151643, 151643, 151643, 151643, 151643, 151643, 151643, 151643, 151643, 151643, 151643, 151643, 151643, 151643, 151643, 151643, 151643, 151643, 151643, 151643, 151643, 151643, 151643, 151643, 151643, 151643, 151643, 151643, 151643, 151643, 151643, 151643, 151643, 151643, 151643, 151643, 151643, 151643, 151643, 151643, 151643, 151643, 151643, 151643, 151643, 151643, 151643, 151643, 151643, 151643, 151643, 151643, 151643, 151643, 151643, 151643, 151643, 151643, 151643, 151643, 151643, 151643, 151643, 151643, 151643, 151643, 151643, 151643, 151643, 151643, 151643, 151643, 151643, 151643, 151643, 151643, 151643, 151643, 151643, 151643, 151643, 151643, 151643, 151643, 151643, 151643, 151643, 151643, 151643, 151643, 151643, 151643, 151643, 151643, 151643, 151643, 151643, 151643, 151643, 151643, 151643, 151643, 151643, 151643, 151643, 151643, 151643, 151643, 151643, 151643, 151643, 151643, 151643, 151643, 151643, 151643, 151643, 151643, 151643, 151643, 151643, 151643, 151643, 151643, 151643, 151643, 151643, 151643, 151643, 151643, 151643, 151643, 151643, 151643, 151643, 151643, 151643, 151643, 151643, 151643, 151643, 151643, 151643, 151643, 151643, 151643, 151643, 151643, 151643, 151643, 151643, 151643, 151643, 151643, 151643, 151643, 151643, 151643, 151643, 151643, 151643, 151643, 151643, 151643, 151643, 151643, 151643, 151643, 151643, 151643, 151643, 151643, 151643, 151643, 151643, 151643, 151643, 151643, 151643, 151643, 151643, 151643, 151643, 151643, 151643, 151643, 151643, 151643, 151643, 151643, 151643, 151643, 151643, 151643, 151643, 151643, 151643, 151643, 151643, 151643, 151643, 151643, 151643, 151643, 151643, 151643, 151643, 151643, 151643, 151643, 151643, 151643, 151643, 151643, 151643, 151643, 151643, 151643, 151643, 151643, 151643, 151643, 151643, 151643, 151643, 151643, 151643, 151643, 151643, 151643, 151643, 151643, 151643, 151643, 151643, 151643, 151643, 151643, 151643, 151643, 151643, 151643, 151643, 151643, 151643, 151643, 151643, 151643, 151643, 151643, 151643, 151643, 151643, 151643, 151643, 151643, 151643, 151643, 151643, 151643, 151643, 151643, 151643, 151643, 151643, 151643, 151643, 151643, 151643, 151643, 151643, 151643, 151643, 151643, 151643, 151643, 151643, 151643, 151643, 151643, 151643, 151643, 151643, 151643, 151643, 151643, 151643, 151643, 151643, 151643, 151643, 151643, 151643, 151643, 151643, 151643, 151643, 151643, 151643, 151643, 151643, 151643, 151643, 151643, 151643, 151643, 151643, 151643, 151643, 151643, 151643, 151643, 151643, 151643, 151643, 151643, 151643, 151643, 151643, 151643, 151643, 151643, 151643, 151643, 151643, 151643, 151643, 151643, 151643, 151643, 151643, 151643, 151643, 151643, 151643, 151643, 151643, 151643, 151643, 151643, 151643, 151643, 151643, 151643, 151643, 151643, 151643, 151643, 151643, 151643, 151643, 151643, 151643, 151643, 151643, 151643, 151643, 151643, 151643, 151643, 151643, 151643, 151643, 151643, 151643, 151643, 151643, 151643, 151643, 151643, 151643, 151643, 151643, 151643, 151643, 151643, 151643, 151643, 151643, 151643, 151643, 151643, 151643, 151643, 151643, 151643, 151643, 151643, 151643, 151643, 151643, 151643, 151643, 151643, 151643, 151643, 151643, 151643, 151643, 151643, 151643, 151643, 151643, 151643, 151643, 151643, 151643, 151643, 151643, 151643, 151643, 151643, 151643, 151643, 151643, 151643, 151643, 151643, 151643, 151643, 151643, 151643, 151643, 151643, 151643, 151643, 151643, 151643, 151643, 151643, 151643, 151643, 151643, 151643, 151643, 151643, 151643, 151643, 151643, 151643, 151643, 151643, 151643, 151643, 151643, 151643, 151643, 151643, 151643, 151643, 151643, 151643, 151643, 151643, 151643, 151643, 151643, 151643, 151643, 151643, 151643, 151643, 151643, 151643, 151643, 151643, 151643, 151643, 151643, 151643, 151643, 151643, 151643, 151643, 151643, 151643, 151643, 151643, 151643, 151643, 151643, 151643, 151643, 151643, 151643, 151643, 151643, 151643, 151643, 151643, 151643, 151643, 151643, 151643, 151643, 151643, 151643, 151643, 151643, 151643, 151643, 151643, 151643, 151644, 8948, 198, 2610, 525, 1207, 16948, 11, 3465, 553, 54364, 14817, 13, 1446, 525, 264, 10950, 17847, 13, 151645, 198, 151644, 872, 198, 16141, 279, 2701, 5248, 5754, 3405, 13, 576, 1537, 1555, 315, 697, 2033, 1265, 387, 315, 279, 2701, 3561, 25, 364, 16141, 25, 400, 20756, 4198, 6, 320, 28996, 17194, 8, 1380, 44428, 374, 825, 315, 19360, 35, 13, 21149, 3019, 553, 3019, 1573, 35764, 382, 785, 3920, 315, 30128, 29026, 12506, 448, 264, 2696, 315, 35195, 13, 21144, 279, 2701, 35195, 13, 4710, 54, 284, 320, 15, 11, 220, 15, 11, 220, 16, 26, 220, 15, 11, 220, 16, 11, 220, 15, 26, 220, 16, 11, 220, 15, 11, 220, 15, 701, 715, 55, 284, 320, 72, 11, 481, 16, 11, 220, 17, 72, 26, 220, 16, 11, 220, 15, 11, 220, 16, 26, 220, 220, 17, 72, 11, 481, 16, 11, 481, 72, 1326, 56, 284, 320, 15, 13, 20, 11, 220, 15, 13, 16, 11, 220, 15, 13, 17, 26, 220, 15, 13, 16, 11, 220, 15, 13, 17, 20, 11, 220, 15, 13, 16, 26, 220, 15, 13, 17, 11, 220, 15, 13, 16, 11, 220, 15, 13, 17, 20, 340, 57, 481, 320, 18, 11, 220, 17, 72, 11, 220, 20, 26, 481, 17, 72, 11, 481, 17, 11, 481, 19, 72, 26, 220, 20, 11, 220, 19, 72, 11, 220, 19, 692, 9112, 13, 576, 35195, 525, 23126, 1741, 429, 1817, 2802, 315, 279, 6172, 374, 18663, 553, 264, 5234, 38517, 13, 18611, 28715, 389, 1493, 35195, 11, 5157, 279, 4396, 5114, 382, 32, 8, 1863, 323, 1599, 4009, 9282, 4788, 624, 33, 8, 320, 68, 61, 55, 4806, 56, 6599, 68, 87210, 55, 5410, 10868, 264, 30128, 1584, 624, 34, 8, 2619, 6724, 264, 4621, 311, 892, 421, 825, 7299, 7202, 384, 61, 55, 11, 279, 7465, 315, 279, 4621, 4344, 624, 35, 8, 467, 323, 1599, 4009, 279, 15379, 5675, 315, 1045, 30128, 1849, 13, 151645, 198, 151644, 77091, 198]",,332,905,1237,0.0,0.0
fc7daf84-3608-41fe-b26e-e0f37bfbcff3,7,117,"[151643, 151643, 151643, 151643, 151643, 151643, 151643, 151643, 151643, 151643, 151643, 151643, 151643, 151643, 151643, 151643, 151643, 151643, 151643, 151643, 151643, 151643, 151643, 151643, 151643, 151643, 151643, 151643, 151643, 151643, 151643, 151643, 151643, 151643, 151643, 151643, 151643, 151643, 151643, 151643, 151643, 151643, 151643, 151643, 151643, 151643, 151643, 151643, 151643, 151643, 151643, 151643, 151643, 151643, 151643, 151643, 151643, 151643, 151643, 151643, 151643, 151643, 151643, 151643, 151643, 151643, 151643, 151643, 151643, 151643, 151643, 151643, 151643, 151643, 151643, 151643, 151643, 151643, 151643, 151643, 151643, 151643, 151643, 151643, 151643, 151643, 151643, 151643, 151643, 151643, 151643, 151643, 151643, 151643, 151643, 151643, 151643, 151643, 151643, 151643, 151643, 151643, 151643, 151643, 151643, 151643, 151643, 151643, 151643, 151643, 151643, 151643, 151643, 151643, 151643, 151643, 151643, 151643, 151643, 151643, 151643, 151643, 151643, 151643, 151643, 151643, 151643, 151643, 151643, 151643, 151643, 151643, 151643, 151643, 151643, 151643, 151643, 151643, 151643, 151643, 151643, 151643, 151643, 151643, 151643, 151643, 151643, 151643, 151643, 151643, 151643, 151643, 151643, 151643, 151643, 151643, 151643, 151643, 151643, 151643, 151643, 151643, 151643, 151643, 151643, 151643, 151643, 151643, 151643, 151643, 151643, 151643, 151643, 151643, 151643, 151643, 151643, 151643, 151643, 151643, 151643, 151643, 151643, 151643, 151643, 151643, 151643, 151643, 151643, 151643, 151643, 151643, 151643, 151643, 151643, 151643, 151643, 151643, 151643, 151643, 151643, 151643, 151643, 151643, 151643, 151643, 151643, 151643, 151643, 151643, 151643, 151643, 151643, 151643, 151643, 151643, 151643, 151643, 151643, 151643, 151643, 151643, 151643, 151643, 151643, 151643, 151643, 151643, 151643, 151643, 151643, 151643, 151643, 151643, 151643, 151643, 151643, 151643, 151643, 151643, 151643, 151643, 151643, 151643, 151643, 151643, 151643, 151643, 151643, 151643, 151643, 151643, 151643, 151643, 151643, 151643, 151643, 151643, 151643, 151643, 151643, 151643, 151643, 151643, 151643, 151643, 151643, 151643, 151643, 151643, 151643, 151643, 151643, 151643, 151643, 151643, 151643, 151643, 151643, 151643, 151643, 151643, 151643, 151643, 151643, 151643, 151643, 151643, 151643, 151643, 151643, 151643, 151643, 151643, 151643, 151643, 151643, 151643, 151643, 151643, 151643, 151643, 151643, 151643, 151643, 151643, 151643, 151643, 151643, 151643, 151643, 151643, 151643, 151643, 151643, 151643, 151643, 151643, 151643, 151643, 151643, 151643, 151643, 151643, 151643, 151643, 151643, 151643, 151643, 151643, 151643, 151643, 151643, 151643, 151643, 151643, 151643, 151643, 151643, 151643, 151643, 151643, 151643, 151643, 151643, 151643, 151643, 151643, 151643, 151643, 151643, 151643, 151643, 151643, 151643, 151643, 151643, 151643, 151643, 151643, 151643, 151643, 151643, 151643, 151643, 151643, 151643, 151643, 151643, 151643, 151643, 151643, 151643, 151643, 151643, 151643, 151643, 151643, 151643, 151643, 151643, 151643, 151643, 151643, 151643, 151643, 151643, 151643, 151643, 151643, 151643, 151643, 151643, 151643, 151643, 151643, 151643, 151643, 151643, 151643, 151643, 151643, 151643, 151643, 151643, 151643, 151643, 151643, 151643, 151643, 151643, 151643, 151643, 151643, 151643, 151643, 151643, 151643, 151643, 151643, 151643, 151643, 151643, 151643, 151643, 151643, 151643, 151643, 151643, 151643, 151643, 151643, 151643, 151643, 151643, 151643, 151643, 151643, 151643, 151643, 151643, 151643, 151643, 151643, 151643, 151643, 151643, 151643, 151643, 151643, 151643, 151643, 151643, 151643, 151643, 151643, 151643, 151643, 151643, 151643, 151643, 151643, 151643, 151643, 151643, 151643, 151643, 151643, 151643, 151643, 151643, 151643, 151643, 151643, 151643, 151643, 151643, 151643, 151643, 151643, 151643, 151643, 151643, 151643, 151643, 151643, 151643, 151643, 151643, 151643, 151643, 151643, 151643, 151643, 151643, 151643, 151643, 151643, 151643, 151643, 151643, 151643, 151643, 151643, 151643, 151643, 151643, 151643, 151643, 151643, 151643, 151643, 151643, 151643, 151643, 151643, 151643, 151643, 151643, 151643, 151643, 151643, 151643, 151643, 151643, 151643, 151643, 151643, 151643, 151643, 151643, 151643, 151643, 151643, 151643, 151643, 151643, 151643, 151643, 151643, 151643, 151643, 151643, 151643, 151643, 151643, 151643, 151643, 151643, 151643, 151643, 151643, 151643, 151643, 151643, 151643, 151643, 151643, 151643, 151643, 151643, 151643, 151643, 151643, 151643, 151643, 151643, 151643, 151643, 151643, 151643, 151643, 151643, 151643, 151643, 151643, 151643, 151643, 151643, 151643, 151643, 151643, 151643, 151643, 151643, 151643, 151643, 151643, 151643, 151643, 151643, 151643, 151643, 151643, 151643, 151643, 151643, 151643, 151643, 151643, 151643, 151643, 151643, 151643, 151643, 151643, 151643, 151643, 151643, 151643, 151643, 151643, 151643, 151643, 151643, 151643, 151643, 151643, 151643, 151643, 151643, 151643, 151643, 151643, 151643, 151643, 151643, 151643, 151643, 151643, 151643, 151643, 151643, 151643, 151643, 151643, 151643, 151643, 151643, 151643, 151643, 151643, 151643, 151643, 151643, 151643, 151643, 151643, 151643, 151643, 151643, 151643, 151643, 151643, 151643, 151643, 151643, 151643, 151643, 151643, 151643, 151643, 151643, 151643, 151643, 151643, 151643, 151643, 151643, 151643, 151643, 151643, 151643, 151643, 151643, 151643, 151643, 151643, 151643, 151643, 151643, 151643, 151643, 151643, 151643, 151643, 151643, 151643, 151643, 151643, 151643, 151643, 151643, 151643, 151643, 151643, 151643, 151643, 151643, 151643, 151643, 151643, 151643, 151643, 151643, 151643, 151643, 151643, 151643, 151643, 151643, 151643, 151643, 151643, 151643, 151643, 151643, 151643, 151643, 151643, 151643, 151643, 151643, 151643, 151643, 151643, 151643, 151643, 151643, 151643, 151643, 151643, 151643, 151643, 151643, 151643, 151643, 151643, 151643, 151643, 151643, 151643, 151643, 151643, 151643, 151644, 8948, 198, 2610, 525, 1207, 16948, 11, 3465, 553, 54364, 14817, 13, 1446, 525, 264, 10950, 17847, 13, 151645, 198, 151644, 872, 198, 16141, 279, 2701, 5248, 5754, 3405, 13, 576, 1537, 1555, 315, 697, 2033, 1265, 387, 315, 279, 2701, 3561, 25, 364, 16141, 25, 400, 20756, 4198, 6, 320, 28996, 17194, 8, 1380, 44428, 374, 825, 315, 19360, 35, 13, 21149, 3019, 553, 3019, 1573, 35764, 382, 32, 23628, 448, 279, 30106, 14806, 356, 23, 39, 24, 8996, 323, 279, 2661, 451, 18446, 821, 374, 54741, 448, 279, 2701, 738, 315, 312, 54875, 1447, 16, 13, 12812, 8996, 17, 488, 472, 5066, 198, 17, 13, 472, 17, 46, 198, 18, 13, 264, 80, 13, 37512, 39, 11, 26070, 4710, 16, 39, 11250, 18446, 320, 602, 76, 1648, 220, 24, 13, 22, 17, 320, 83, 11, 220, 16, 39, 701, 220, 21, 13, 24, 23, 320, 67, 11, 220, 17, 39, 701, 220, 21, 13, 20, 16, 320, 67, 11, 220, 17, 39, 701, 220, 21, 13, 17, 22, 320, 1279, 11, 220, 17, 39, 701, 220, 18, 13, 21, 21, 320, 67, 11, 220, 17, 39, 568, 64547, 279, 1590, 1985, 382, 32, 8, 220, 18, 2832, 67007, 4130, 12, 17, 11, 19, 1455, 285, 7, 19, 2832, 67007, 4130, 14769, 3923, 8, 8088, 48821, 198, 33, 8, 220, 17, 11, 19, 1455, 285, 7, 19, 2832, 67007, 4130, 14769, 3923, 8, 8088, 12, 17, 20767, 278, 198, 34, 8, 220, 19, 8013, 19, 2832, 67007, 4130, 14769, 3923, 8, 8088, 12, 18, 20767, 278, 198, 35, 8, 220, 17, 11, 19, 1737, 573, 12032, 3923, 8088, 12, 18, 20767, 278, 151645, 198, 151644, 77091, 198]",,279,431,710,0.0,0.0
6102208d-6441-4b5a-9020-4a47c059a43a,7,118,"[151643, 151643, 151643, 151643, 151643, 151643, 151643, 151643, 151643, 151643, 151643, 151643, 151643, 151643, 151643, 151643, 151643, 151643, 151643, 151643, 151643, 151643, 151643, 151643, 151643, 151643, 151643, 151643, 151643, 151643, 151643, 151643, 151643, 151643, 151643, 151643, 151643, 151643, 151643, 151643, 151643, 151643, 151643, 151643, 151643, 151643, 151643, 151643, 151643, 151643, 151643, 151643, 151643, 151643, 151643, 151643, 151643, 151643, 151643, 151643, 151643, 151643, 151643, 151643, 151643, 151643, 151643, 151643, 151643, 151643, 151643, 151643, 151643, 151643, 151643, 151643, 151643, 151643, 151643, 151643, 151643, 151643, 151643, 151643, 151643, 151643, 151643, 151643, 151643, 151643, 151643, 151643, 151643, 151643, 151643, 151643, 151643, 151643, 151643, 151643, 151643, 151643, 151643, 151643, 151643, 151643, 151643, 151643, 151643, 151643, 151643, 151643, 151643, 151643, 151643, 151643, 151643, 151643, 151643, 151643, 151643, 151643, 151643, 151643, 151643, 151643, 151643, 151643, 151643, 151643, 151643, 151643, 151643, 151643, 151643, 151643, 151643, 151643, 151643, 151643, 151643, 151643, 151643, 151643, 151643, 151643, 151643, 151643, 151643, 151643, 151643, 151643, 151643, 151643, 151643, 151643, 151643, 151643, 151643, 151643, 151643, 151643, 151643, 151643, 151643, 151643, 151643, 151643, 151643, 151643, 151643, 151643, 151643, 151643, 151643, 151643, 151643, 151643, 151643, 151643, 151643, 151643, 151643, 151643, 151643, 151643, 151643, 151643, 151643, 151643, 151643, 151643, 151643, 151643, 151643, 151643, 151643, 151643, 151643, 151643, 151643, 151643, 151643, 151643, 151643, 151643, 151643, 151643, 151643, 151643, 151643, 151643, 151643, 151643, 151643, 151643, 151643, 151643, 151643, 151643, 151643, 151643, 151643, 151643, 151643, 151643, 151643, 151643, 151643, 151643, 151643, 151643, 151643, 151643, 151643, 151643, 151643, 151643, 151643, 151643, 151643, 151643, 151643, 151643, 151643, 151643, 151643, 151643, 151643, 151643, 151643, 151643, 151643, 151643, 151643, 151643, 151643, 151643, 151643, 151643, 151643, 151643, 151643, 151643, 151643, 151643, 151643, 151643, 151643, 151643, 151643, 151643, 151643, 151643, 151643, 151643, 151643, 151643, 151643, 151643, 151643, 151643, 151643, 151643, 151643, 151643, 151643, 151643, 151643, 151643, 151643, 151643, 151643, 151643, 151643, 151643, 151643, 151643, 151643, 151643, 151643, 151643, 151643, 151643, 151643, 151643, 151643, 151643, 151643, 151643, 151643, 151643, 151643, 151643, 151643, 151643, 151643, 151643, 151643, 151643, 151643, 151643, 151643, 151643, 151643, 151643, 151643, 151643, 151643, 151643, 151643, 151643, 151643, 151643, 151643, 151643, 151643, 151643, 151643, 151643, 151643, 151643, 151643, 151643, 151643, 151643, 151643, 151643, 151643, 151643, 151643, 151643, 151643, 151643, 151643, 151643, 151643, 151643, 151643, 151643, 151643, 151643, 151643, 151643, 151643, 151643, 151643, 151643, 151643, 151643, 151643, 151643, 151643, 151643, 151643, 151643, 151643, 151643, 151643, 151643, 151643, 151643, 151643, 151643, 151643, 151643, 151643, 151643, 151643, 151643, 151643, 151643, 151643, 151643, 151643, 151643, 151643, 151643, 151643, 151643, 151643, 151643, 151643, 151643, 151643, 151643, 151643, 151643, 151643, 151643, 151643, 151643, 151643, 151643, 151643, 151643, 151643, 151643, 151643, 151643, 151643, 151643, 151643, 151643, 151643, 151643, 151643, 151644, 8948, 198, 2610, 525, 1207, 16948, 11, 3465, 553, 54364, 14817, 13, 1446, 525, 264, 10950, 17847, 13, 151645, 198, 151644, 872, 198, 16141, 279, 2701, 5248, 5754, 3405, 13, 576, 1537, 1555, 315, 697, 2033, 1265, 387, 315, 279, 2701, 3561, 25, 364, 16141, 25, 400, 20756, 4198, 6, 320, 28996, 17194, 8, 1380, 44428, 374, 825, 315, 19360, 35, 13, 21149, 3019, 553, 3019, 1573, 35764, 382, 785, 356, 2792, 55327, 56633, 374, 264, 11483, 12720, 1380, 264, 220, 16, 11, 20, 1737, 42568, 41930, 36671, 288, 55327, 56633, 11, 12942, 304, 264, 2297, 304, 279, 9892, 315, 1181, 12499, 23992, 5970, 1990, 26363, 13, 1096, 55327, 56633, 646, 387, 32130, 553, 8628, 476, 3100, 323, 374, 15172, 369, 6825, 6351, 17356, 31146, 448, 5497, 14389, 624, 3379, 279, 3598, 3871, 504, 279, 2701, 55327, 524, 3723, 624, 6636, 18, 1448, 41872, 8088, 12, 17, 20767, 12, 16, 12, 3923, 8, 60163, 46607, 41872, 8, 7964, 89, 1952, 488, 320, 16, 13, 27227, 45421, 11, 220, 17, 13, 472, 36197, 11304, 29, 362, 198, 18, 11, 19, 11, 20, 11, 22, 11, 23, 11, 24, 2832, 41616, 41872, 12, 16, 11, 16, 16, 1737, 318, 87540, 12, 17, 11, 21, 11, 16, 15, 11, 16, 16, 11, 16, 16, 64, 11, 16, 16, 65, 2832, 327, 1466, 67007, 12, 16, 39, 1455, 268, 12738, 58, 4385, 60, 484, 11790, 58, 22, 11, 16, 12, 866, 60, 1370, 360, 1952, 488, 26070, 69726, 425, 271, 32, 8, 362, 284, 320, 57, 7287, 17, 1448, 41872, 12, 20, 12, 14769, 3923, 45125, 12, 17, 20767, 12, 16, 12, 337, 11, 425, 284, 220, 17, 11, 18, 11, 19, 11, 21, 11, 22, 11, 23, 2832, 41616, 41872, 12, 20, 11, 24, 11, 24, 64, 11, 16, 15, 11, 16, 16, 11, 16, 16, 64, 2832, 327, 1466, 67007, 12, 16, 39, 1455, 268, 12738, 58, 18, 11, 19, 60, 1370, 360, 11790, 58, 16, 11, 23, 11, 22, 11, 21, 1786, 750, 60, 26164, 460, 811, 198, 33, 8, 362, 284, 220, 19, 1448, 41872, 12, 16, 12, 14769, 3923, 45125, 12, 18, 20767, 12, 16, 12, 337, 11, 425, 284, 220, 17, 11, 18, 11, 19, 11, 21, 11, 22, 11, 23, 2832, 41616, 41872, 12, 20, 11, 24, 11, 16, 15, 11, 16, 16, 2385, 295, 956, 66129, 12, 16, 39, 1455, 268, 12738, 58, 18, 11, 19, 60, 1370, 360, 11790, 58, 16, 11, 23, 11, 22, 11, 21, 1786, 750, 60, 26164, 269, 482, 198, 34, 8, 362, 284, 220, 19, 1448, 41872, 12, 16, 12, 14769, 3923, 45125, 12, 18, 20767, 12, 16, 12, 337, 11, 425, 284, 220, 17, 11, 18, 11, 19, 11, 21, 11, 22, 11, 23, 2832, 41616, 41872, 12, 20, 11, 24, 11, 24, 64, 11, 16, 15, 11, 16, 16, 11, 16, 16, 64, 2832, 327, 1466, 67007, 12, 16, 39, 1455, 268, 12738, 58, 18, 11, 19, 60, 1370, 360, 11790, 58, 16, 11, 23, 11, 22, 11, 21, 1786, 750, 60, 26164, 460, 811, 198, 35, 8, 362, 284, 320, 57, 7287, 17, 1448, 41872, 12, 20, 12, 14769, 3923, 45125, 12, 17, 20767, 12, 16, 12, 337, 11, 425, 284, 220, 17, 11, 18, 11, 19, 11, 21, 11, 22, 11, 23, 2832, 41616, 41872, 12, 20, 11, 24, 11, 16, 15, 11, 16, 16, 2385, 295, 956, 66129, 12, 16, 39, 1455, 268, 12738, 58, 18, 11, 19, 60, 1370, 360, 11790, 58, 16, 11, 23, 11, 22, 11, 21, 1786, 750, 60, 26164, 269, 482, 151645, 198, 151644, 77091, 198]",,597,514,1111,0.0,0.0
e8a5506d-e253-4f90-b2fe-4a225cebe59b,7,119,"[151643, 151643, 151643, 151643, 151643, 151643, 151643, 151643, 151643, 151643, 151643, 151643, 151643, 151643, 151643, 151643, 151643, 151643, 151643, 151643, 151643, 151643, 151643, 151643, 151643, 151643, 151643, 151643, 151643, 151643, 151643, 151643, 151643, 151643, 151643, 151643, 151643, 151643, 151643, 151643, 151643, 151643, 151643, 151643, 151643, 151643, 151643, 151643, 151643, 151643, 151643, 151643, 151643, 151643, 151643, 151643, 151643, 151643, 151643, 151643, 151643, 151643, 151643, 151643, 151643, 151643, 151643, 151643, 151643, 151643, 151643, 151643, 151643, 151643, 151643, 151643, 151643, 151643, 151643, 151643, 151643, 151643, 151643, 151643, 151643, 151643, 151643, 151643, 151643, 151643, 151643, 151643, 151643, 151643, 151643, 151643, 151643, 151643, 151643, 151643, 151643, 151643, 151643, 151643, 151643, 151643, 151643, 151643, 151643, 151643, 151643, 151643, 151643, 151643, 151643, 151643, 151643, 151643, 151643, 151643, 151643, 151643, 151643, 151643, 151643, 151643, 151643, 151643, 151643, 151643, 151643, 151643, 151643, 151643, 151643, 151643, 151643, 151643, 151643, 151643, 151643, 151643, 151643, 151643, 151643, 151643, 151643, 151643, 151643, 151643, 151643, 151643, 151643, 151643, 151643, 151643, 151643, 151643, 151643, 151643, 151643, 151643, 151643, 151643, 151643, 151643, 151643, 151643, 151643, 151643, 151643, 151643, 151643, 151643, 151643, 151643, 151643, 151643, 151643, 151643, 151643, 151643, 151643, 151643, 151643, 151643, 151643, 151643, 151643, 151643, 151643, 151643, 151643, 151643, 151643, 151643, 151643, 151643, 151643, 151643, 151643, 151643, 151643, 151643, 151643, 151643, 151643, 151643, 151643, 151643, 151643, 151643, 151643, 151643, 151643, 151643, 151643, 151643, 151643, 151643, 151643, 151643, 151643, 151643, 151643, 151643, 151643, 151643, 151643, 151643, 151643, 151643, 151643, 151643, 151643, 151643, 151643, 151643, 151643, 151643, 151643, 151643, 151643, 151643, 151643, 151643, 151643, 151643, 151643, 151643, 151643, 151643, 151643, 151643, 151643, 151643, 151643, 151643, 151643, 151643, 151643, 151643, 151643, 151643, 151643, 151643, 151643, 151643, 151643, 151643, 151643, 151643, 151643, 151643, 151643, 151643, 151643, 151643, 151643, 151643, 151643, 151643, 151643, 151643, 151643, 151643, 151643, 151643, 151643, 151643, 151643, 151643, 151643, 151643, 151643, 151643, 151643, 151643, 151643, 151643, 151643, 151643, 151643, 151643, 151643, 151643, 151643, 151643, 151643, 151643, 151643, 151643, 151643, 151643, 151643, 151643, 151643, 151643, 151643, 151643, 151643, 151643, 151643, 151643, 151643, 151643, 151643, 151643, 151643, 151643, 151643, 151643, 151643, 151643, 151643, 151643, 151643, 151643, 151643, 151643, 151643, 151643, 151643, 151643, 151643, 151643, 151643, 151643, 151643, 151643, 151643, 151643, 151643, 151643, 151643, 151643, 151643, 151643, 151643, 151643, 151643, 151643, 151643, 151643, 151643, 151643, 151643, 151643, 151643, 151643, 151643, 151643, 151643, 151643, 151643, 151643, 151643, 151643, 151643, 151643, 151643, 151643, 151643, 151643, 151643, 151643, 151643, 151643, 151643, 151643, 151643, 151643, 151643, 151643, 151643, 151643, 151643, 151643, 151643, 151643, 151643, 151643, 151643, 151643, 151643, 151643, 151643, 151643, 151643, 151643, 151643, 151643, 151643, 151643, 151643, 151643, 151643, 151643, 151643, 151643, 151643, 151643, 151643, 151643, 151643, 151643, 151643, 151643, 151643, 151643, 151643, 151643, 151643, 151643, 151643, 151643, 151643, 151643, 151643, 151643, 151643, 151643, 151643, 151643, 151643, 151643, 151643, 151643, 151643, 151643, 151643, 151643, 151643, 151643, 151643, 151643, 151643, 151643, 151643, 151643, 151643, 151643, 151643, 151643, 151643, 151643, 151643, 151643, 151643, 151643, 151643, 151643, 151643, 151643, 151643, 151643, 151643, 151643, 151643, 151643, 151643, 151643, 151643, 151643, 151643, 151643, 151643, 151643, 151643, 151643, 151643, 151643, 151643, 151643, 151643, 151643, 151643, 151643, 151643, 151643, 151643, 151643, 151643, 151643, 151643, 151643, 151643, 151643, 151643, 151643, 151643, 151643, 151643, 151643, 151643, 151643, 151643, 151643, 151643, 151643, 151643, 151643, 151643, 151643, 151643, 151643, 151643, 151643, 151643, 151643, 151643, 151643, 151643, 151643, 151643, 151643, 151643, 151643, 151643, 151643, 151643, 151643, 151643, 151643, 151643, 151643, 151643, 151643, 151643, 151643, 151643, 151643, 151643, 151643, 151643, 151643, 151643, 151643, 151643, 151643, 151643, 151643, 151643, 151643, 151643, 151643, 151643, 151643, 151643, 151643, 151643, 151643, 151643, 151643, 151643, 151643, 151643, 151643, 151643, 151643, 151643, 151643, 151643, 151643, 151643, 151643, 151643, 151643, 151643, 151643, 151643, 151643, 151643, 151643, 151643, 151643, 151643, 151643, 151643, 151643, 151643, 151643, 151643, 151643, 151643, 151643, 151643, 151643, 151643, 151643, 151643, 151643, 151643, 151643, 151643, 151643, 151643, 151643, 151643, 151643, 151643, 151643, 151643, 151643, 151643, 151643, 151643, 151643, 151643, 151643, 151643, 151643, 151643, 151643, 151643, 151643, 151643, 151643, 151643, 151643, 151643, 151643, 151643, 151643, 151643, 151643, 151643, 151643, 151643, 151643, 151643, 151643, 151643, 151643, 151643, 151643, 151643, 151643, 151643, 151643, 151643, 151643, 151643, 151643, 151643, 151643, 151643, 151643, 151643, 151643, 151643, 151643, 151643, 151643, 151643, 151643, 151643, 151643, 151643, 151643, 151643, 151643, 151643, 151643, 151643, 151643, 151643, 151643, 151643, 151643, 151643, 151643, 151643, 151643, 151643, 151643, 151643, 151643, 151643, 151643, 151643, 151643, 151643, 151643, 151643, 151643, 151643, 151643, 151643, 151643, 151643, 151643, 151643, 151643, 151643, 151643, 151643, 151643, 151643, 151643, 151643, 151643, 151643, 151643, 151643, 151643, 151643, 151643, 151643, 151643, 151643, 151643, 151643, 151643, 151643, 151643, 151643, 151643, 151643, 151643, 151643, 151643, 151643, 151643, 151643, 151643, 151643, 151643, 151643, 151643, 151643, 151643, 151643, 151643, 151643, 151643, 151643, 151643, 151643, 151643, 151643, 151643, 151643, 151643, 151643, 151643, 151643, 151643, 151643, 151643, 151643, 151643, 151643, 151643, 151643, 151643, 151643, 151643, 151643, 151643, 151643, 151643, 151643, 151643, 151643, 151643, 151643, 151643, 151643, 151643, 151643, 151643, 151643, 151643, 151643, 151643, 151643, 151643, 151643, 151643, 151643, 151643, 151643, 151643, 151643, 151643, 151643, 151643, 151643, 151643, 151643, 151643, 151643, 151643, 151644, 8948, 198, 2610, 525, 1207, 16948, 11, 3465, 553, 54364, 14817, 13, 1446, 525, 264, 10950, 17847, 13, 151645, 198, 151644, 872, 198, 16141, 279, 2701, 5248, 5754, 3405, 13, 576, 1537, 1555, 315, 697, 2033, 1265, 387, 315, 279, 2701, 3561, 25, 364, 16141, 25, 400, 20756, 4198, 6, 320, 28996, 17194, 8, 1380, 44428, 374, 825, 315, 19360, 35, 13, 21149, 3019, 553, 3019, 1573, 35764, 382, 37175, 264, 1849, 448, 23176, 1103, 5675, 400, 39, 284, 1124, 85, 546, 59892, 1124, 4083, 35702, 24912, 92, 7110, 4083, 91362, 92, 12947, 5692, 11, 57960, 4083, 91362, 31716, 374, 458, 24168, 4982, 4621, 11, 57960, 85, 546, 59892, 400, 374, 264, 6783, 315, 12871, 4802, 11, 323, 6813, 315, 57960, 4083, 35702, 24912, 31716, 525, 279, 6898, 72, 12616, 35195, 13, 3555, 525, 279, 28724, 3661, 315, 279, 23176, 1103, 5675, 1939, 32, 8, 488, 16, 11, 481, 16, 198, 33, 8, 488, 59, 85, 546, 59892, 1124, 71, 2257, 14, 17, 11, 481, 1124, 85, 546, 59892, 1124, 71, 2257, 14, 17, 198, 34, 8, 488, 59, 71, 2257, 14, 17, 11, 481, 59, 71, 2257, 14, 17, 198, 35, 8, 488, 1124, 85, 546, 59892, 11, 481, 59, 85, 546, 59892, 151645, 198, 151644, 77091, 198]",,210,743,953,1.0,1.0
